//MAP CONVERTED BY dmm2tgm.py THIS HEADER COMMENT PREVENTS RECONVERSION, DO NOT REMOVE
"a" = (
/obj/effect/turf_decal/tile/red/half/contrasted{
	dir = 4
	},
/obj/machinery/holopad/secure,
/turf/open/floor/iron/dark,
/area/station/ai_monitored/security/armory)
"c" = (
/obj/effect/turf_decal/stripes/red/line{
	dir = 10
	},
/obj/item/kirbyplants/random,
/obj/effect/turf_decal/tile/red{
	dir = 8
	},
/obj/structure/sign/poster/official/random/directional/north,
/obj/structure/window/reinforced/spawner/directional/west,
/turf/open/floor/iron/dark,
/area/station/ai_monitored/security/armory)
"d" = (
/obj/effect/turf_decal/trimline/red/filled/line{
	dir = 4
	},
/obj/machinery/atmospherics/pipe/smart/manifold4w/scrubbers/hidden/layer2,
/obj/machinery/atmospherics/pipe/smart/manifold4w/supply/hidden/layer4,
/obj/effect/turf_decal/stripes/line{
	dir = 8
	},
/turf/open/floor/iron/dark,
/area/station/ai_monitored/security/armory)
"f" = (
/obj/effect/turf_decal/trimline/red/filled/corner{
	dir = 1
	},
/obj/machinery/atmospherics/components/unary/vent_scrubber/on/layer2{
	dir = 1
	},
/obj/effect/turf_decal/stripes/line{
	dir = 6
	},
/turf/open/floor/iron/dark,
/area/station/ai_monitored/security/armory)
"g" = (
/obj/structure/rack,
/obj/machinery/atmospherics/pipe/smart/manifold4w/scrubbers/hidden/layer2,
/obj/effect/turf_decal/stripes/red/end,
/obj/item/clothing/mask/gas/sechailer{
	pixel_y = 3
	},
/obj/item/clothing/mask/gas/sechailer,
/obj/item/clothing/mask/gas/sechailer{
	pixel_y = -2
	},
/obj/item/flashlight/seclite{
	pixel_y = -1
	},
/obj/item/flashlight/seclite{
	pixel_x = 2;
	pixel_y = -3
	},
/obj/item/flashlight/seclite{
	pixel_x = 4;
	pixel_y = -5
	},
/turf/open/floor/iron/dark,
/area/station/ai_monitored/security/armory)
"h" = (
/obj/effect/turf_decal/stripes/red/line{
	dir = 4
	},
/obj/effect/turf_decal/tile/red/half/contrasted{
	dir = 8
	},
/obj/structure/rack,
/obj/effect/spawner/armory_spawn/shotguns,
/turf/open/floor/iron/dark,
/area/station/ai_monitored/security/armory)
"i" = (
/obj/structure/rack,
/obj/effect/spawner/random/armory/bulletproof_armor,
/obj/effect/spawner/random/armory/bulletproof_helmet,
/obj/effect/turf_decal/stripes/red/line{
	dir = 1
	},
/obj/effect/turf_decal/tile/red/half/contrasted,
/obj/machinery/status_display/ai/directional/north,
/turf/open/floor/iron/dark,
/area/station/ai_monitored/security/armory)
"j" = (
/obj/machinery/flasher/portable,
/obj/effect/turf_decal/bot,
/obj/effect/turf_decal/tile/neutral/fourcorners,
/turf/open/floor/iron/dark,
/area/station/ai_monitored/security/armory)
"k" = (
/obj/machinery/atmospherics/pipe/smart/manifold4w/supply/hidden/layer4,
/obj/effect/turf_decal/trimline/red/filled/corner,
/obj/machinery/atmospherics/components/unary/vent_scrubber/on/layer2,
/obj/effect/turf_decal/stripes/line{
	dir = 9
	},
/turf/open/floor/iron/dark,
/area/station/ai_monitored/security/armory)
"l" = (
/obj/machinery/atmospherics/pipe/smart/manifold4w/supply/hidden/layer4,
/obj/effect/turf_decal/trimline/red/filled/line,
/obj/effect/turf_decal/stripes/line{
	dir = 1
	},
/turf/open/floor/iron/dark,
/area/station/ai_monitored/security/armory)
"n" = (
/obj/effect/turf_decal/stripes/red/line{
	dir = 8
	},
/obj/machinery/airalarm/directional/west,
/obj/effect/turf_decal/tile/red/half/contrasted{
	dir = 4
	},
/turf/open/floor/iron/dark,
/area/station/ai_monitored/security/armory)
"p" = (
/obj/structure/rack,
/obj/item/gun/energy/e_gun/dragnet,
/obj/item/gun/energy/e_gun/dragnet,
/obj/effect/turf_decal/stripes/red/end{
	dir = 1
	},
/turf/open/floor/iron/dark,
/area/station/ai_monitored/security/armory)
"q" = (
/obj/effect/turf_decal/stripes/red/line{
	dir = 1
	},
/obj/structure/rack,
/obj/effect/turf_decal/tile/red/half/contrasted,
/obj/item/gun/energy/ionrifle,
/obj/machinery/light/no_nightlight/directional/north,
/obj/structure/sign/poster/official/random/directional/north,
/turf/open/floor/iron/dark,
/area/station/ai_monitored/security/armory)
"r" = (
/obj/effect/turf_decal/stripes/red/line{
	dir = 4
	},
/obj/effect/turf_decal/tile/red/half/contrasted{
	dir = 8
	},
/obj/machinery/camera/motion/directional/east,
/obj/effect/spawner/random/armory/e_gun,
/obj/structure/rack,
/turf/open/floor/iron/dark,
/area/station/ai_monitored/security/armory)
"s" = (
/obj/effect/turf_decal/stripes/red/corner{
	dir = 1
	},
/obj/machinery/atmospherics/pipe/smart/manifold4w/supply/hidden/layer4,
/obj/effect/turf_decal/tile/red/half/contrasted{
	dir = 4
	},
/obj/machinery/atmospherics/pipe/smart/manifold4w/scrubbers/hidden/layer2,
/turf/open/floor/iron/dark,
/area/station/ai_monitored/security/armory)
"t" = (
/obj/effect/turf_decal/stripes/red/line{
	dir = 6
	},
/obj/effect/turf_decal/tile/red,
/obj/item/kirbyplants/random,
/obj/structure/window/reinforced/spawner/directional/east,
/turf/open/floor/iron/dark,
/area/station/ai_monitored/security/armory)
"u" = (
/obj/effect/turf_decal/stripes/red/line{
	dir = 1
	},
/obj/structure/rack,
/obj/item/clothing/suit/hooded/ablative,
/obj/effect/turf_decal/tile/red/half/contrasted,
/obj/item/gun/energy/temperature/security,
/obj/item/radio/intercom/directional/north,
/turf/open/floor/iron/dark,
/area/station/ai_monitored/security/armory)
"v" = (
/mob/living/simple_animal/bot/secbot/beepsky/armsky,
/obj/effect/turf_decal/trimline/red/filled/line{
	dir = 4
	},
/obj/machinery/atmospherics/pipe/smart/manifold4w/supply/hidden/layer4,
/obj/machinery/atmospherics/pipe/smart/manifold4w/scrubbers/hidden/layer2,
/obj/effect/turf_decal/stripes/line{
	dir = 8
	},
/turf/open/floor/iron/dark,
/area/station/ai_monitored/security/armory)
"w" = (
/obj/structure/rack,
/obj/effect/turf_decal/stripes/red/line{
	dir = 1
	},
/obj/effect/turf_decal/tile/red/half/contrasted,
/obj/effect/spawner/random/armory/riot_armor,
/obj/effect/spawner/random/armory/riot_helmet,
/obj/effect/spawner/random/armory/riot_shield,
/obj/machinery/light/no_nightlight/directional/north,
/turf/open/floor/iron/dark,
/area/station/ai_monitored/security/armory)
"x" = (
/obj/effect/turf_decal/stripes/red/end{
	dir = 1
	},
/obj/structure/closet/secure_closet/armory_kiboko,
/obj/item/ammo_box/c980grenade/riot,
/obj/item/ammo_box/c980grenade/smoke,
/turf/open/floor/iron/dark,
/area/station/ai_monitored/security/armory)
"z" = (
/obj/effect/turf_decal/stripes/red/line{
	dir = 4
	},
/obj/effect/turf_decal/tile/red/half/contrasted{
	dir = 8
	},
/obj/structure/closet/secure_closet/armory2,
/obj/effect/spawner/random/armory/rubbershot,
/turf/open/floor/iron/dark,
/area/station/ai_monitored/security/armory)
"A" = (
/obj/effect/turf_decal/caution/stand_clear,
/obj/effect/turf_decal/stripes/red/line,
/obj/effect/turf_decal/tile/red/half/contrasted{
	dir = 1
	},
/turf/open/floor/iron/dark,
/area/station/ai_monitored/security/armory)
"B" = (
/obj/effect/turf_decal/trimline/red/filled/corner{
	dir = 4
	},
/obj/machinery/atmospherics/components/unary/vent_pump/on/layer4{
	dir = 1
	},
/obj/effect/turf_decal/stripes/line{
	dir = 10
	},
/turf/open/floor/iron/dark,
/area/station/ai_monitored/security/armory)
"C" = (
/obj/effect/turf_decal/stripes/red/line,
/obj/effect/turf_decal/tile/red{
	dir = 4
	},
/obj/effect/turf_decal/box/corners{
	dir = 8
	},
/turf/open/floor/iron/dark,
/area/station/ai_monitored/security/armory)
"D" = (
/obj/item/storage/box/trackimp{
	pixel_x = -5;
	pixel_y = 9
	},
/obj/item/storage/box/chemimp{
	pixel_x = 5
	},
/obj/effect/turf_decal/tile/red/half/contrasted{
	dir = 1
	},
/obj/effect/turf_decal/stripes/red/line,
/obj/structure/table/reinforced,
/obj/machinery/airalarm/directional/east,
/turf/open/floor/iron/dark,
/area/station/ai_monitored/security/armory)
"E" = (
/obj/machinery/atmospherics/components/unary/vent_pump/on/layer4{
	dir = 8
	},
/obj/effect/turf_decal/trimline/red/filled/corner{
	dir = 8
	},
/obj/effect/turf_decal/stripes/line{
	dir = 5
	},
/turf/open/floor/iron/dark,
/area/station/ai_monitored/security/armory)
"F" = (
/obj/effect/turf_decal/stripes/red/line,
/obj/effect/turf_decal/tile/red/half/contrasted{
	dir = 1
	},
/obj/structure/table/reinforced,
/obj/machinery/light/no_nightlight/directional/south,
/obj/machinery/recharger{
	pixel_y = 4
	},
/turf/open/floor/iron/dark,
/area/station/ai_monitored/security/armory)
"G" = (
/obj/effect/turf_decal/stripes/red/line{
	dir = 4
	},
/obj/effect/turf_decal/tile/red/half/contrasted{
	dir = 8
	},
/obj/structure/rack,
/obj/effect/spawner/armory_spawn/smg,
/turf/open/floor/iron/dark,
/area/station/ai_monitored/security/armory)
"H" = (
/obj/structure/rack,
/obj/effect/turf_decal/stripes/red/line{
	dir = 1
	},
/obj/effect/turf_decal/tile/red/half/contrasted,
/obj/effect/spawner/random/armory/bulletproof_armor,
/obj/effect/spawner/random/armory/bulletproof_helmet,
/obj/item/radio/intercom/directional/north,
/turf/open/floor/iron/dark,
/area/station/ai_monitored/security/armory)
"I" = (
/obj/effect/turf_decal/trimline/red/filled/line{
	dir = 1
	},
/obj/effect/turf_decal/stripes/line,
/turf/open/floor/iron/dark,
/area/station/ai_monitored/security/armory)
"J" = (
/obj/effect/turf_decal/trimline/red/filled/corner{
	dir = 1
	},
/obj/effect/turf_decal/trimline/red/filled/corner{
	dir = 4
	},
/obj/effect/turf_decal/stripes/line,
/turf/open/floor/iron/dark,
/area/station/ai_monitored/security/armory)
"K" = (
/obj/effect/turf_decal/trimline/red/filled/line{
	dir = 8
	},
/obj/effect/turf_decal/trimline/red/filled/line{
	dir = 4
	},
/turf/open/floor/iron/dark,
/area/station/ai_monitored/security/armory)
"L" = (
/obj/structure/rack,
/obj/effect/turf_decal/stripes/red/end{
	dir = 1
	},
/obj/item/storage/box/flashbangs,
/obj/effect/spawner/random/armory/barrier_grenades/six,
/obj/item/storage/box/teargas,
/turf/open/floor/iron/dark,
/area/station/ai_monitored/security/armory)
"M" = (
/obj/effect/turf_decal/stripes/red/line{
	dir = 1
	},
/obj/effect/turf_decal/tile/red/half/contrasted,
/obj/structure/extinguisher_cabinet/directional/north,
/obj/structure/closet/secure_closet/contraband/armory,
/obj/effect/spawner/random/contraband/armory,
/obj/structure/window/reinforced/spawner/directional/east,
/obj/structure/window/reinforced/spawner/directional/west,
/turf/open/floor/iron/dark,
/area/station/ai_monitored/security/armory)
"N" = (
/obj/effect/turf_decal/stripes/red/line,
/obj/effect/turf_decal/tile/red/half/contrasted{
	dir = 1
	},
/obj/effect/turf_decal/box/corners,
/turf/open/floor/iron/dark,
/area/station/ai_monitored/security/armory)
"O" = (
/obj/effect/turf_decal/trimline/red/filled/line{
	dir = 8
	},
/obj/effect/turf_decal/trimline/red/filled/line{
	dir = 4
	},
/obj/machinery/atmospherics/pipe/smart/manifold4w/scrubbers/hidden/layer2,
/turf/open/floor/iron/dark,
/area/station/ai_monitored/security/armory)
"P" = (
/obj/structure/rack,
/obj/machinery/atmospherics/pipe/smart/manifold4w/scrubbers/hidden/layer2,
/obj/effect/turf_decal/stripes/red/end,
/turf/open/floor/iron/dark,
/area/station/ai_monitored/security/armory)
"Q" = (
/obj/effect/turf_decal/stripes/red/line{
	dir = 1
	},
/obj/structure/rack,
/obj/item/clothing/glasses/hud/security/sunglasses/gars{
	pixel_x = 3;
	pixel_y = -2
	},
/obj/item/clothing/glasses/hud/security/sunglasses/gars{
	pixel_x = 3;
	pixel_y = 2
	},
/obj/item/clothing/glasses/hud/security/sunglasses/gars,
/obj/effect/turf_decal/tile/red/half/contrasted,
/obj/machinery/status_display/evac/directional/north,
/turf/open/floor/iron/dark,
/area/station/ai_monitored/security/armory)
"R" = (
/obj/effect/turf_decal/trimline/red/filled/line{
	dir = 8
	},
/obj/machinery/atmospherics/pipe/smart/manifold4w/scrubbers/hidden/layer2,
/obj/effect/turf_decal/stripes/line{
	dir = 4
	},
/turf/open/floor/iron/dark,
/area/station/ai_monitored/security/armory)
"S" = (
/obj/structure/rack,
/obj/machinery/atmospherics/pipe/smart/manifold4w/scrubbers/hidden/layer2,
/obj/effect/turf_decal/stripes/red/end,
/obj/effect/spawner/random/armory/disablers,
/turf/open/floor/iron/dark,
/area/station/ai_monitored/security/armory)
"T" = (
/turf/closed/wall/r_wall,
/area/station/ai_monitored/security/armory)
"U" = (
/obj/effect/turf_decal/trimline/red/filled/line{
	dir = 8
	},
/obj/effect/turf_decal/stripes/line{
	dir = 4
	},
/turf/open/floor/iron/dark,
/area/station/ai_monitored/security/armory)
"V" = (
/obj/machinery/atmospherics/pipe/smart/manifold4w/supply/hidden/layer4,
/obj/effect/turf_decal/trimline/red/filled/corner{
	dir = 8
	},
/obj/effect/turf_decal/trimline/red/filled/corner,
/obj/effect/turf_decal/stripes/line{
	dir = 1
	},
/turf/open/floor/iron/dark,
/area/station/ai_monitored/security/armory)
"Y" = (
/obj/machinery/flasher/portable,
/obj/machinery/button/door/directional/south{
	id = "armory";
	name = "Armory Shutters";
	req_access = list("armory")
	},
/obj/effect/turf_decal/bot,
/obj/effect/turf_decal/tile/neutral/fourcorners,
/turf/open/floor/iron/dark,
/area/station/ai_monitored/security/armory)
"Z" = (
/obj/effect/turf_decal/stripes/red/line{
	dir = 8
	},
/obj/machinery/camera/motion/directional/west{
	c_tag = "Armory - Internal"
	},
/obj/effect/turf_decal/tile/red/half/contrasted{
	dir = 4
	},
/turf/open/floor/iron/dark,
/area/station/ai_monitored/security/armory)

(1,1,1) = {"
t
n
Z
s
a
C
"}
(2,1,1) = {"
w
k
d
v
B
A
"}
(3,1,1) = {"
H
l
p
P
I
N
"}
(4,1,1) = {"
i
V
K
O
J
Y
"}
(5,1,1) = {"
M
l
L
g
I
j
"}
(6,1,1) = {"
Q
V
K
O
J
j
"}
(7,1,1) = {"
u
l
x
S
I
F
"}
(8,1,1) = {"
q
E
U
R
f
D
"}
(9,1,1) = {"
c
G
r
h
z
T
"}
