//MAP CONVERTED BY dmm2tgm.py THIS HEADER COMMENT PREVENTS RECONVERSION, DO NOT REMOVE
"a" = (
/turf/template_noop,
/area/template_noop)
"g" = (
/mob/living/basic/carp,
/turf/template_noop,
/area/template_noop)
"i" = (
/obj/structure/closet/crate,
/obj/effect/spawner/random/bedsheet,
/obj/effect/spawner/random/bedsheet,
/obj/effect/spawner/random/bedsheet,
/obj/effect/spawner/random/bedsheet,
/obj/effect/spawner/random/bedsheet,
/obj/effect/spawner/random/bedsheet,
/obj/effect/spawner/random/bedsheet,
/obj/effect/spawner/random/bedsheet/double,
/obj/effect/spawner/random/bedsheet/double,
/obj/effect/spawner/random/bedsheet/double,
/obj/effect/spawner/random/bedsheet/double,
/turf/template_noop,
/area/template_noop)
"k" = (
/obj/structure/rack/shelf,
/turf/template_noop,
/area/template_noop)
"o" = (
/mob/living/basic/carp/mega,
/turf/template_noop,
/area/template_noop)
"p" = (
/obj/modular_map_connector,
/turf/template_noop,
/area/template_noop)
"q" = (
/obj/structure/closet/crate,
/obj/item/reagent_containers/spray/cleaner,
/obj/item/reagent_containers/spray/cleaner,
/obj/item/reagent_containers/spray/cleaner,
/obj/item/grenade/chem_grenade/cleaner,
/obj/item/grenade/chem_grenade/cleaner,
/obj/item/grenade/chem_grenade/cleaner,
/obj/item/grenade/chem_grenade/cleaner,
/obj/item/grenade/chem_grenade/cleaner,
/obj/item/grenade/chem_grenade/cleaner,
/obj/item/grenade/chem_grenade/cleaner,
/obj/item/grenade/chem_grenade/cleaner,
/obj/item/holosign_creator/janibarrier,
/turf/template_noop,
/area/template_noop)
"r" = (
/mob/living/basic/carp/passive,
/turf/template_noop,
/area/template_noop)
"x" = (
/obj/item/construction/rcd/arcd/mattermanipulator,
/obj/item/rcd_ammo/large,
/obj/item/rcd_ammo/large,
/obj/item/rcd_ammo/large,
/obj/structure/closet/crate/secure/engineering,
/turf/template_noop,
/area/template_noop)
"y" = (
/obj/structure/rack/shelf,
/obj/item/storage/fish_case/random/saltwater,
/turf/template_noop,
/area/template_noop)
"A" = (
/obj/item/pizzabox/mushroom,
/obj/item/pizzabox/meat,
/obj/item/pizzabox/margherita,
/obj/structure/closet/crate/freezer,
/obj/item/food/fishmeat/carp,
/obj/item/food/fishmeat/carp,
/obj/item/food/fishmeat/carp,
/obj/item/food/fishmeat/carp,
/obj/item/food/fishmeat/carp,
/obj/item/knife/carp,
/obj/item/knife/carp,
/turf/template_noop,
/area/template_noop)
"F" = (
/obj/structure/closet/crate/secure/science,
/obj/item/mod/construction/broken_core,
/obj/item/mod/construction/broken_core,
/obj/item/mod/construction/broken_core,
/obj/item/mod/construction/broken_core,
/obj/item/mod/construction/broken_core,
/turf/template_noop,
/area/template_noop)
"H" = (
/obj/machinery/fishing_portal_generator/emagged,
/turf/template_noop,
/area/template_noop)
"I" = (
/obj/structure/closet/crate/engineering,
/obj/item/stack/sheet/plasteel/fifty,
/obj/item/stack/sheet/rglass{
	amount = 50
	},
/obj/item/stack/sheet/mineral/plasma/thirty,
/obj/item/stack/sheet/mineral/titanium/fifty,
/turf/template_noop,
/area/template_noop)
"J" = (
/obj/item/rack_parts,
/turf/template_noop,
/area/template_noop)
"L" = (
/obj/structure/rack/shelf,
/obj/item/storage/fish_case/random/freshwater,
/turf/template_noop,
/area/template_noop)
"O" = (
/obj/structure/closet/crate/medical,
/obj/item/storage/medkit/advanced,
/obj/item/storage/medkit/brute,
/obj/item/storage/medkit/fire,
/obj/item/storage/medkit/regular,
/obj/item/storage/medkit/regular,
/turf/template_noop,
/area/template_noop)
"R" = (
/obj/structure/rack/shelf,
/obj/item/fish/baby_carp,
/obj/item/storage/fish_case,
/turf/template_noop,
/area/template_noop)
"U" = (
/obj/structure/closet/crate,
/obj/item/storage/belt/utility,
/obj/item/clothing/gloves/color/black,
/obj/item/clothing/head/utility/hardhat/orange,
/obj/item/clothing/suit/hazardvest,
/obj/item/clothing/gloves/color/yellow,
/turf/template_noop,
/area/template_noop)
"V" = (
/obj/structure/rack/shelf,
/obj/item/storage/fish_case/blackmarket,
/turf/template_noop,
/area/template_noop)
"Y" = (
/obj/structure/rack/shelf,
/obj/item/storage/fish_case/random,
/turf/template_noop,
/area/template_noop)

(1,1,1) = {"
i
q
a
p
a
a
H
"}
(2,1,1) = {"
a
a
a
a
x
a
a
"}
(3,1,1) = {"
a
r
I
g
a
a
a
"}
(4,1,1) = {"
a
a
a
a
a
a
a
"}
(5,1,1) = {"
a
a
V
y
a
a
a
"}
(6,1,1) = {"
a
a
k
J
a
o
a
"}
(7,1,1) = {"
a
a
R
L
a
a
a
"}
(8,1,1) = {"
a
a
J
Y
a
a
a
"}
(9,1,1) = {"
F
a
g
a
a
a
a
"}
(10,1,1) = {"
a
a
a
a
a
a
a
"}
(11,1,1) = {"
a
a
a
U
a
a
O
"}
(12,1,1) = {"
a
a
A
a
a
a
a
"}
