//MAP CONVERTED BY dmm2tgm.py THIS HEADER COMMENT PREVENTS RECONVERSION, DO NOT REMOVE
"a" = (
/obj/structure/rack/shelf,
/obj/item/stack/sheet/rglass{
	amount = 50
	},
/obj/item/stack/sheet/plasteel/fifty,
/obj/item/stack/sheet/mineral/titanium/fifty,
/turf/template_noop,
/area/template_noop)
"b" = (
/obj/structure/rack/shelf,
/obj/item/construction/rcd/arcd/mattermanipulator,
/turf/template_noop,
/area/template_noop)
"c" = (
/obj/item/restraints/legcuffs/bola/cult,
/turf/template_noop,
/area/template_noop)
"d" = (
/obj/structure/closet/crate/medical,
/obj/item/storage/medkit/advanced,
/obj/item/storage/medkit/brute,
/obj/item/storage/medkit/fire,
/obj/item/storage/medkit/regular,
/obj/item/storage/medkit/regular,
/turf/template_noop,
/area/template_noop)
"e" = (
/obj/structure/destructible/cult/item_dispenser/forge,
/turf/template_noop,
/area/template_noop)
"f" = (
/obj/structure/destructible/cult/item_dispenser/altar,
/turf/template_noop,
/area/template_noop)
"g" = (
/obj/item/pizzabox/margherita,
/obj/item/pizzabox/meat,
/obj/item/pizzabox/mushroom,
/obj/item/pizzabox/margherita,
/obj/item/pizzabox/meat,
/obj/item/pizzabox/mushroom,
/obj/structure/closet/crate/freezer,
/turf/template_noop,
/area/template_noop)
"h" = (
/mob/living/basic/construct/artificer/hostile,
/turf/template_noop,
/area/template_noop)
"j" = (
/obj/structure/rack/shelf,
/obj/item/clothing/suit/hazardvest,
/obj/item/clothing/gloves/color/black,
/obj/item/clothing/head/utility/hardhat/orange,
/turf/template_noop,
/area/template_noop)
"k" = (
/obj/structure/closet/crate/secure/science,
/obj/item/mod/construction/broken_core,
/obj/item/mod/construction/broken_core,
/obj/item/mod/construction/broken_core,
/obj/item/mod/construction/broken_core,
/obj/item/mod/construction/broken_core,
/turf/template_noop,
/area/template_noop)
"l" = (
/obj/structure/closet/crate,
/obj/item/reagent_containers/spray/cleaner,
/obj/item/reagent_containers/spray/cleaner,
/obj/item/reagent_containers/spray/cleaner,
/obj/item/grenade/chem_grenade/cleaner,
/obj/item/grenade/chem_grenade/cleaner,
/obj/item/grenade/chem_grenade/cleaner,
/obj/item/grenade/chem_grenade/cleaner,
/obj/item/grenade/chem_grenade/cleaner,
/obj/item/grenade/chem_grenade/cleaner,
/obj/item/grenade/chem_grenade/cleaner,
/obj/item/grenade/chem_grenade/cleaner,
/obj/item/holosign_creator/janibarrier,
/obj/modular_map_connector,
/turf/template_noop,
/area/template_noop)
"p" = (
/obj/structure/rack/shelf,
/obj/item/storage/toolbox/electrical,
/obj/item/storage/toolbox/electrical,
/turf/template_noop,
/area/template_noop)
"q" = (
/mob/living/simple_animal/hostile/cult,
/turf/template_noop,
/area/template_noop)
"r" = (
/obj/structure/rack/shelf,
/obj/item/ammo_box/magazine/c35sol_pistol/stendo/starts_empty,
/obj/item/ammo_box/magazine/c35sol_pistol/stendo/starts_empty,
/obj/item/ammo_box/magazine/c35sol_pistol/stendo/starts_empty,
/turf/template_noop,
/area/template_noop)
"u" = (
/mob/living/simple_animal/hostile/cult/magic,
/turf/template_noop,
/area/template_noop)
"B" = (
/mob/living/simple_animal/hostile/cult/horror,
/turf/template_noop,
/area/template_noop)
"C" = (
/obj/structure/rack/shelf,
/obj/item/storage/toolbox/mechanical,
/obj/item/storage/toolbox/mechanical,
/turf/template_noop,
/area/template_noop)
"D" = (
/mob/living/basic/construct/juggernaut/hostile,
/turf/template_noop,
/area/template_noop)
"G" = (
/obj/structure/rack/shelf,
/obj/effect/spawner/random/bedsheet/double,
/obj/effect/spawner/random/bedsheet/double,
/obj/effect/spawner/random/bedsheet/double,
/obj/effect/spawner/random/bedsheet/double,
/obj/effect/spawner/random/bedsheet/double,
/obj/effect/spawner/random/bedsheet/double,
/obj/effect/spawner/random/bedsheet/double,
/obj/effect/spawner/random/bedsheet/double,
/obj/effect/spawner/random/bedsheet/double,
/obj/effect/spawner/random/bedsheet/double,
/obj/effect/spawner/random/bedsheet/double,
/obj/item/bedsheet/cult/double,
/turf/template_noop,
/area/template_noop)
"J" = (
/turf/template_noop,
/area/template_noop)
"K" = (
/obj/item/stack/sheet/runed_metal/ten,
/turf/template_noop,
/area/template_noop)
"M" = (
/obj/structure/rack/shelf,
/obj/item/stack/sheet/mineral/gold{
	amount = 25
	},
/obj/item/stack/sheet/runed_metal/five,
/turf/template_noop,
/area/template_noop)
"Q" = (
/obj/structure/destructible/cult/pylon,
/turf/template_noop,
/area/template_noop)
"V" = (
/mob/living/simple_animal/hostile/cult/mannequin,
/turf/template_noop,
/area/template_noop)
"X" = (
/obj/structure/rack/shelf,
/obj/item/holosign_creator/janibarrier,
/obj/item/grenade/chem_grenade/cleaner,
/obj/item/grenade/chem_grenade/cleaner,
/obj/item/grenade/chem_grenade/cleaner,
/obj/item/grenade/chem_grenade/cleaner,
/obj/item/grenade/chem_grenade/cleaner,
/obj/item/grenade/chem_grenade/cleaner,
/obj/item/grenade/chem_grenade/cleaner,
/obj/item/grenade/chem_grenade/cleaner,
/obj/item/reagent_containers/spray/cleaner,
/obj/item/reagent_containers/spray/cleaner,
/obj/item/reagent_containers/spray/cleaner,
/turf/template_noop,
/area/template_noop)
"Y" = (
/obj/structure/rack/shelf,
/obj/effect/spawner/random/decoration/carpet,
/turf/template_noop,
/area/template_noop)
"Z" = (
/obj/item/melee/cultblade/dagger,
/turf/template_noop,
/area/template_noop)

(1,1,1) = {"
J
J
J
l
k
b
a
"}
(2,1,1) = {"
J
J
Q
J
J
B
g
"}
(3,1,1) = {"
J
q
Z
e
J
J
J
"}
(4,1,1) = {"
J
J
J
u
J
J
J
"}
(5,1,1) = {"
J
J
D
M
J
J
J
"}
(6,1,1) = {"
J
J
J
Y
J
J
J
"}
(7,1,1) = {"
J
J
J
C
J
h
J
"}
(8,1,1) = {"
J
J
q
p
J
J
J
"}
(9,1,1) = {"
J
J
J
J
J
J
J
"}
(10,1,1) = {"
J
V
K
J
Q
J
J
"}
(11,1,1) = {"
J
J
c
J
J
J
r
"}
(12,1,1) = {"
J
f
J
d
j
X
G
"}
