//MAP CONVERTED BY dmm2tgm.py THIS HEADER COMMENT PREVENTS RECONVERSION, DO NOT REMOVE
"a" = (
/obj/structure/rack/shelf,
/turf/template_noop,
/area/space/nearstation)
"b" = (
/turf/template_noop,
/area/template_noop)
"e" = (
/obj/modular_map_connector,
/turf/template_noop,
/area/space/nearstation)
"f" = (
/obj/structure/closet/crate/engineering,
/obj/item/stack/sheet/plasteel/fifty,
/obj/item/stack/sheet/rglass{
	amount = 50
	},
/obj/item/stack/sheet/mineral/plasma/thirty,
/obj/item/stack/sheet/mineral/titanium/fifty,
/turf/template_noop,
/area/space/nearstation)
"i" = (
/obj/item/pizzabox/mushroom,
/obj/item/pizzabox/meat,
/obj/item/pizzabox/margherita,
/obj/item/pizzabox/mushroom,
/obj/item/pizzabox/meat,
/obj/item/pizzabox/margherita,
/obj/structure/closet/crate/freezer,
/turf/template_noop,
/area/space/nearstation)
"q" = (
/obj/structure/rack/shelf,
/obj/item/crowbar,
/turf/template_noop,
/area/space/nearstation)
"s" = (
/obj/structure/closet/crate,
/obj/item/storage/belt/utility,
/obj/item/clothing/gloves/color/black,
/obj/item/clothing/head/utility/hardhat/orange,
/obj/item/clothing/suit/hazardvest,
/obj/item/clothing/gloves/color/yellow,
/turf/template_noop,
/area/space/nearstation)
"B" = (
/obj/structure/closet/crate,
/obj/effect/spawner/random/bedsheet,
/obj/effect/spawner/random/bedsheet,
/obj/effect/spawner/random/bedsheet,
/obj/effect/spawner/random/bedsheet,
/obj/effect/spawner/random/bedsheet,
/obj/effect/spawner/random/bedsheet,
/obj/effect/spawner/random/bedsheet,
/obj/effect/spawner/random/bedsheet/double,
/obj/effect/spawner/random/bedsheet/double,
/obj/effect/spawner/random/bedsheet/double,
/obj/effect/spawner/random/bedsheet/double,
/turf/template_noop,
/area/space/nearstation)
"D" = (
/obj/structure/closet/crate/secure/science,
/obj/item/mod/construction/broken_core,
/obj/item/mod/construction/broken_core,
/obj/item/mod/construction/broken_core,
/obj/item/mod/construction/broken_core,
/obj/item/mod/construction/broken_core,
/turf/template_noop,
/area/space/nearstation)
"F" = (
/obj/structure/rack/shelf,
/obj/effect/spawner/random/decoration/carpet,
/obj/effect/spawner/random/decoration/carpet,
/obj/effect/spawner/random/decoration/carpet,
/turf/template_noop,
/area/space/nearstation)
"H" = (
/obj/structure/closet/crate,
/obj/item/reagent_containers/spray/cleaner,
/obj/item/reagent_containers/spray/cleaner,
/obj/item/reagent_containers/spray/cleaner,
/obj/item/grenade/chem_grenade/cleaner,
/obj/item/grenade/chem_grenade/cleaner,
/obj/item/grenade/chem_grenade/cleaner,
/obj/item/grenade/chem_grenade/cleaner,
/obj/item/grenade/chem_grenade/cleaner,
/obj/item/grenade/chem_grenade/cleaner,
/obj/item/grenade/chem_grenade/cleaner,
/obj/item/grenade/chem_grenade/cleaner,
/obj/item/holosign_creator/janibarrier,
/turf/template_noop,
/area/space/nearstation)
"J" = (
/obj/item/construction/rcd/arcd/mattermanipulator,
/obj/item/rcd_ammo/large,
/obj/item/rcd_ammo/large,
/obj/item/rcd_ammo/large,
/obj/structure/closet/crate/secure/engineering,
/turf/template_noop,
/area/space/nearstation)
"S" = (
/obj/structure/closet/crate/medical,
/obj/item/storage/medkit/advanced,
/obj/item/storage/medkit/brute,
/obj/item/storage/medkit/fire,
/obj/item/storage/medkit/regular,
/obj/item/storage/medkit/regular,
/turf/template_noop,
/area/space/nearstation)

(1,1,1) = {"
f
b
b
e
b
b
F
"}
(2,1,1) = {"
b
b
b
b
b
b
a
"}
(3,1,1) = {"
b
b
b
b
b
b
b
"}
(4,1,1) = {"
b
b
b
b
i
b
b
"}
(5,1,1) = {"
b
b
D
b
b
b
b
"}
(6,1,1) = {"
b
b
b
b
b
b
b
"}
(7,1,1) = {"
s
b
b
b
b
b
b
"}
(8,1,1) = {"
b
b
b
b
b
b
b
"}
(9,1,1) = {"
b
b
J
b
b
b
b
"}
(10,1,1) = {"
b
b
b
b
b
b
b
"}
(11,1,1) = {"
b
b
b
b
b
b
q
"}
(12,1,1) = {"
B
H
b
b
S
b
a
"}
