//MAP CONVERTED BY dmm2tgm.py THIS HEADER COMMENT PREVENTS RECONVERSION, DO NOT REMOVE
"a" = (
/turf/template_noop,
/area/template_noop)
"g" = (
/mob/living/basic/carp,
/turf/template_noop,
/area/template_noop)
"i" = (
/obj/effect/decal/cleanable/glass,
/obj/item/shard,
/turf/template_noop,
/area/template_noop)
"k" = (
/obj/effect/decal/cleanable/glass,
/obj/item/shard{
	icon_state = "medium"
	},
/turf/template_noop,
/area/template_noop)
"l" = (
/obj/modular_map_connector,
/turf/template_noop,
/area/template_noop)
"o" = (
/obj/structure/window/reinforced/spawner/directional/north,
/mob/living/basic/carp/passive,
/turf/template_noop,
/area/template_noop)
"q" = (
/obj/machinery/door/window/brigdoor/right/directional/north,
/turf/template_noop,
/area/template_noop)
"s" = (
/obj/structure/window/reinforced/spawner/directional/east,
/turf/template_noop,
/area/template_noop)
"x" = (
/obj/structure/window/reinforced/spawner/directional/south,
/turf/template_noop,
/area/template_noop)
"H" = (
/obj/structure/window/reinforced/spawner/directional/north,
/turf/template_noop,
/area/template_noop)
"N" = (
/mob/living/basic/carp/mega,
/turf/template_noop,
/area/template_noop)
"T" = (
/obj/structure/window/reinforced/spawner/directional/south,
/obj/structure/window/reinforced/spawner/directional/east,
/turf/template_noop,
/area/template_noop)
"X" = (
/obj/machinery/door/window/brigdoor/right/directional/south,
/turf/template_noop,
/area/template_noop)
"Z" = (
/obj/structure/window/reinforced/spawner/directional/north,
/obj/effect/decal/cleanable/glass,
/obj/item/shard{
	icon_state = "small"
	},
/turf/template_noop,
/area/template_noop)

(1,1,1) = {"
a
a
a
a
a
"}
(2,1,1) = {"
a
a
a
a
a
"}
(3,1,1) = {"
a
x
l
H
a
"}
(4,1,1) = {"
a
x
a
H
a
"}
(5,1,1) = {"
g
X
a
q
a
"}
(6,1,1) = {"
s
T
a
k
s
"}
(7,1,1) = {"
a
i
a
Z
a
"}
(8,1,1) = {"
a
X
a
q
a
"}
(9,1,1) = {"
a
x
N
o
a
"}
(10,1,1) = {"
a
x
a
H
a
"}
