//MAP CONVERTED BY dmm2tgm.py THIS HEADER COMMENT PREVENTS RECONVERSION, DO NOT REMOVE
"a" = (
/turf/template_noop,
/area/template_noop)
"d" = (
/obj/effect/turf_decal/tile/light_peach{
	dir = 8
	},
/obj/effect/turf_decal/siding/light_peach{
	dir = 8
	},
/obj/effect/turf_decal/weather/dirt{
	dir = 1
	},
/mob/living/basic/eggbug,
/obj/effect/mapping_helpers/mob_buckler,
/obj/structure/chair/sofa/corp/right,
/turf/open/floor/iron/white,
/area/taeloth/underground)
"g" = (
/obj/effect/turf_decal/tile/magenta_red,
/obj/effect/turf_decal/siding/magenta_red{
	dir = 4
	},
/obj/effect/decal/cleanable/dirt/dust,
/turf/open/floor/iron/white,
/area/taeloth/underground)
"i" = (
/obj/effect/turf_decal/tile/magenta_red,
/obj/effect/turf_decal/siding/magenta_red{
	dir = 4
	},
/obj/effect/turf_decal/weather/dirt,
/obj/effect/decal/cleanable/dirt/dust,
/turf/open/floor/iron/white,
/area/taeloth/underground)
"r" = (
/obj/effect/turf_decal/tile/magenta_red{
	dir = 1
	},
/obj/effect/turf_decal/siding/magenta_red{
	dir = 8
	},
/obj/effect/turf_decal/weather/dirt,
/obj/structure/chair{
	dir = 8
	},
/turf/open/floor/iron/white,
/area/taeloth/underground)
"s" = (
/turf/open/misc/dirt/jungle,
/area/taeloth/underground)
"z" = (
/obj/effect/turf_decal/tile/light_peach{
	dir = 8
	},
/obj/effect/turf_decal/siding/light_peach{
	dir = 8
	},
/obj/effect/turf_decal/weather/dirt,
/obj/structure/table,
/turf/open/floor/iron/white,
/area/taeloth/underground)
"C" = (
/obj/effect/turf_decal/tile/light_peach{
	dir = 4
	},
/obj/effect/turf_decal/siding/light_peach{
	dir = 4
	},
/obj/effect/turf_decal/weather/dirt{
	dir = 1
	},
/obj/structure/chair/sofa/corp/left,
/obj/effect/decal/cleanable/dirt/dust,
/turf/open/floor/iron/white,
/area/taeloth/underground)
"E" = (
/obj/effect/turf_decal/tile/magenta_red,
/obj/effect/turf_decal/siding/magenta_red{
	dir = 4
	},
/obj/effect/turf_decal/weather/dirt{
	dir = 1
	},
/obj/item/kirbyplants/random,
/turf/open/floor/iron/white,
/area/taeloth/underground)
"G" = (
/obj/effect/turf_decal/tile/light_peach{
	dir = 4
	},
/obj/effect/turf_decal/siding/light_peach{
	dir = 4
	},
/turf/open/floor/iron/white,
/area/taeloth/underground)
"H" = (
/obj/effect/turf_decal/tile/light_peach{
	dir = 4
	},
/obj/effect/turf_decal/siding/light_peach{
	dir = 4
	},
/obj/effect/turf_decal/weather/dirt,
/obj/effect/decal/cleanable/dirt/dust,
/obj/structure/table,
/obj/item/toy/cards/deck/kotahi{
	pixel_y = 5
	},
/turf/open/floor/iron/white,
/area/taeloth/underground)
"M" = (
/obj/effect/turf_decal/tile/magenta_red{
	dir = 1
	},
/obj/effect/turf_decal/siding/magenta_red{
	dir = 8
	},
/obj/effect/turf_decal/weather/dirt{
	dir = 1
	},
/obj/effect/decal/cleanable/dirt/dust,
/obj/structure/closet/mini_fridge,
/obj/item/reagent_containers/cup/glass/bottle/beer,
/turf/open/floor/iron/white,
/area/taeloth/underground)
"N" = (
/obj/effect/turf_decal/tile/magenta_red{
	dir = 1
	},
/obj/effect/turf_decal/siding/magenta_red{
	dir = 8
	},
/obj/effect/decal/cleanable/dirt/dust,
/turf/open/floor/iron/white,
/area/taeloth/underground)
"V" = (
/obj/effect/turf_decal/tile/light_peach{
	dir = 8
	},
/obj/effect/turf_decal/siding/light_peach{
	dir = 8
	},
/obj/effect/decal/cleanable/dirt/dust,
/turf/open/floor/iron/white,
/area/taeloth/underground)

(1,1,1) = {"
s
s
a
"}
(2,1,1) = {"
s
s
s
"}
(3,1,1) = {"
d
V
z
"}
(4,1,1) = {"
C
G
H
"}
(5,1,1) = {"
M
N
r
"}
(6,1,1) = {"
E
g
i
"}
(7,1,1) = {"
s
a
s
"}
