//MAP CONVERTED BY dmm2tgm.py THIS HEADER COMMENT PREVENTS RECONVERSION, DO NOT REMOVE
"a" = (
/turf/open/misc/dirt/jungle,
/area/taeloth/underground)
"e" = (
/mob/living/basic/carp/mega,
/turf/open/misc/dirt/jungle,
/area/ruin/unpowered/deep_space_three_wreckage/research)
"g" = (
/obj/machinery/door/airlock/research,
/obj/effect/mapping_helpers/airlock/locked,
/obj/effect/turf_decal/siding/wideplating_new,
/obj/effect/turf_decal/siding/wideplating_new{
	dir = 1
	},
/turf/open/floor/iron/smooth_large,
/area/ruin/unpowered/deep_space_three_wreckage/research)
"h" = (
/obj/effect/decal/cleanable/dirt/dust,
/obj/effect/decal/cleanable/dirt,
/obj/effect/turf_decal/weather/dirt{
	dir = 6
	},
/obj/effect/turf_decal/weather/dirt{
	dir = 1
	},
/turf/open/floor/iron/dark,
/area/ruin/unpowered/deep_space_three_wreckage/research)
"i" = (
/obj/effect/spawner/structure/window/reinforced/plasma/plastitanium,
/obj/effect/mapping_helpers/damaged_window,
/turf/open/floor/plating,
/area/ruin/unpowered/deep_space_three_wreckage/research)
"j" = (
/turf/closed/wall/mineral/plastitanium/nodiagonal,
/area/ruin/unpowered/deep_space_three_wreckage/research)
"k" = (
/obj/item/stack/cable_coil,
/obj/effect/decal/cleanable/dirt/dust,
/obj/effect/turf_decal/weather/dirt{
	dir = 10
	},
/obj/effect/turf_decal/weather/dirt{
	dir = 5
	},
/turf/open/floor/iron/dark,
/area/ruin/unpowered/deep_space_three_wreckage/research)
"p" = (
/obj/effect/decal/cleanable/dirt/dust,
/obj/effect/decal/cleanable/dirt,
/obj/effect/turf_decal/weather/dirt{
	dir = 6
	},
/obj/effect/turf_decal/weather/dirt{
	dir = 9
	},
/turf/open/floor/iron/dark,
/area/ruin/unpowered/deep_space_three_wreckage/research)
"r" = (
/obj/structure/frame/machine,
/turf/open/misc/dirt/jungle,
/area/ruin/unpowered/deep_space_three_wreckage/research)
"t" = (
/turf/template_noop,
/area/template_noop)
"u" = (
/obj/structure/frame/machine,
/obj/effect/decal/cleanable/dirt/dust,
/obj/effect/decal/cleanable/dirt,
/obj/effect/turf_decal/weather/dirt,
/turf/open/floor/iron/dark,
/area/ruin/unpowered/deep_space_three_wreckage/research)
"w" = (
/obj/effect/decal/cleanable/dirt/dust,
/obj/effect/decal/cleanable/dirt,
/obj/effect/turf_decal/weather/dirt{
	dir = 6
	},
/turf/open/floor/iron/dark,
/area/ruin/unpowered/deep_space_three_wreckage/research)
"z" = (
/turf/open/misc/dirt/jungle,
/area/ruin/unpowered/deep_space_three_wreckage/research)
"B" = (
/obj/effect/decal/cleanable/dirt/dust,
/obj/effect/decal/cleanable/dirt,
/obj/effect/turf_decal/weather/dirt{
	dir = 10
	},
/obj/effect/turf_decal/weather/dirt{
	dir = 1
	},
/obj/structure/table,
/turf/open/floor/iron/dark,
/area/ruin/unpowered/deep_space_three_wreckage/research)
"F" = (
/obj/structure/closet/crate/secure/loot/luna_energy_upgrade,
/turf/open/misc/dirt/jungle,
/area/ruin/unpowered/deep_space_three_wreckage/research)
"H" = (
/obj/effect/decal/cleanable/dirt/dust,
/obj/effect/decal/cleanable/dirt,
/obj/effect/turf_decal/weather/dirt{
	dir = 10
	},
/turf/open/floor/iron/dark,
/area/ruin/unpowered/deep_space_three_wreckage/research)
"I" = (
/obj/structure/frame/computer,
/obj/effect/decal/cleanable/dirt/dust,
/obj/effect/decal/cleanable/dirt,
/obj/effect/turf_decal/weather/dirt,
/turf/open/floor/iron/dark,
/area/ruin/unpowered/deep_space_three_wreckage/research)
"K" = (
/obj/structure/girder,
/obj/effect/turf_decal/weather/dirt{
	dir = 8
	},
/obj/effect/turf_decal/weather/dirt{
	dir = 6
	},
/turf/open/floor/plating/rust,
/area/ruin/unpowered/deep_space_three_wreckage/research)
"L" = (
/obj/machinery/light/broken/directional/west,
/turf/open/misc/dirt/jungle,
/area/ruin/unpowered/deep_space_three_wreckage/research)
"O" = (
/obj/effect/spawner/random/structure/girder,
/turf/open/misc/dirt/jungle,
/area/ruin/unpowered/deep_space_three_wreckage/research)
"P" = (
/obj/effect/decal/cleanable/dirt/dust,
/obj/effect/decal/cleanable/dirt,
/obj/effect/turf_decal/weather/dirt{
	dir = 9
	},
/obj/effect/turf_decal/weather/dirt,
/turf/open/floor/iron/dark,
/area/ruin/unpowered/deep_space_three_wreckage/research)
"R" = (
/obj/structure/table,
/obj/item/storage/toolbox/mechanical,
/turf/open/misc/dirt/jungle,
/area/ruin/unpowered/deep_space_three_wreckage/research)
"U" = (
/obj/effect/decal/cleanable/dirt/dust,
/obj/effect/decal/cleanable/dirt,
/obj/effect/turf_decal/weather/dirt{
	dir = 5
	},
/obj/effect/turf_decal/weather/dirt{
	dir = 8
	},
/turf/open/floor/iron/dark,
/area/ruin/unpowered/deep_space_three_wreckage/research)
"V" = (
/obj/structure/table,
/obj/item/clothing/head/collectable/welding{
	pixel_y = 8
	},
/turf/open/misc/dirt/jungle,
/area/ruin/unpowered/deep_space_three_wreckage/research)
"X" = (
/obj/structure/table,
/obj/item/paper_bin,
/obj/item/pen,
/turf/open/misc/dirt/jungle,
/area/ruin/unpowered/deep_space_three_wreckage/research)

(1,1,1) = {"
j
j
K
z
j
j
z
z
t
"}
(2,1,1) = {"
i
I
z
r
z
L
p
z
t
"}
(3,1,1) = {"
i
u
z
k
e
r
z
z
t
"}
(4,1,1) = {"
j
w
z
X
R
B
z
P
z
"}
(5,1,1) = {"
g
z
z
V
U
w
z
h
z
"}
(6,1,1) = {"
j
j
H
z
z
F
z
z
j
"}
(7,1,1) = {"
a
j
j
O
j
j
j
a
a
"}
(8,1,1) = {"
a
a
a
t
t
a
a
a
t
"}
