//MAP CONVERTED BY dmm2tgm.py THIS HEADER COMMENT PREVENTS RECONVERSION, DO NOT REMOVE
"a" = (
/turf/open/misc/dirt/jungle,
/area/taeloth)
"e" = (
/obj/structure/light_puzzle{
	puzzle_id = "lunahpa";
	pixel_y = 32
	},
/turf/open/misc/dirt/jungle,
/area/ruin/unpowered/bloodzone)
"g" = (
/obj/effect/decal/cleanable/dirt/dust,
/obj/effect/decal/cleanable/dirt,
/obj/effect/turf_decal/weather/dirt{
	dir = 1
	},
/turf/open/floor/iron/white,
/area/ruin/unpowered/bloodzone)
"l" = (
/obj/effect/decal/cleanable/dirt/dust,
/obj/effect/decal/cleanable/dirt,
/obj/structure/rack,
/obj/item/luna_fragment/blood_beam,
/turf/open/floor/plating/rust,
/area/ruin/unpowered/bloodzone)
"p" = (
/obj/effect/decal/cleanable/dirt/dust,
/obj/effect/decal/cleanable/dirt,
/obj/effect/turf_decal/weather/dirt{
	dir = 5
	},
/turf/open/floor/iron/white,
/area/ruin/unpowered/bloodzone)
"q" = (
/obj/effect/decal/cleanable/dirt/dust,
/obj/effect/decal/cleanable/dirt,
/obj/structure/reagent_dispensers/watertank,
/turf/open/floor/iron/white,
/area/ruin/unpowered/bloodzone)
"r" = (
/obj/effect/decal/cleanable/dirt/dust,
/obj/effect/decal/cleanable/dirt,
/obj/effect/turf_decal/weather/dirt{
	dir = 10
	},
/obj/effect/turf_decal/weather/dirt{
	dir = 1
	},
/turf/open/floor/iron/white,
/area/ruin/unpowered/bloodzone)
"t" = (
/turf/template_noop,
/area/template_noop)
"v" = (
/turf/closed/wall,
/area/ruin/unpowered/bloodzone)
"x" = (
/obj/structure/door_assembly/door_assembly_med,
/turf/open/misc/dirt/jungle,
/area/ruin/unpowered/bloodzone)
"y" = (
/turf/closed/wall/r_wall/rust,
/area/ruin/unpowered/bloodzone)
"A" = (
/obj/structure/bed/medical,
/turf/open/misc/dirt/jungle,
/area/ruin/unpowered/bloodzone)
"B" = (
/turf/open/misc/dirt/jungle,
/area/ruin/unpowered/bloodzone)
"C" = (
/obj/effect/decal/cleanable/cobweb,
/obj/structure/closet/crate/freezer/blood,
/turf/open/misc/dirt/jungle,
/area/ruin/unpowered/bloodzone)
"F" = (
/obj/effect/turf_decal/siding/wideplating_new/light{
	dir = 4
	},
/obj/effect/decal/cleanable/dirt/dust,
/obj/effect/decal/cleanable/dirt,
/obj/machinery/door/puzzle/light{
	puzzle_id = "lunahpa";
	dir = 4
	},
/turf/open/floor/plating/rust,
/area/ruin/unpowered/bloodzone)
"G" = (
/turf/closed/wall/rust,
/area/ruin/unpowered/bloodzone)
"J" = (
/obj/structure/girder,
/obj/effect/turf_decal/weather/dirt,
/obj/effect/turf_decal/weather/dirt{
	dir = 1
	},
/turf/open/floor/plating/rust,
/area/ruin/unpowered/bloodzone)
"L" = (
/turf/closed/wall/r_wall,
/area/ruin/unpowered/bloodzone)
"N" = (
/obj/effect/decal/cleanable/dirt/dust,
/obj/effect/decal/cleanable/dirt,
/obj/effect/turf_decal/weather/dirt{
	dir = 6
	},
/obj/effect/turf_decal/weather/dirt{
	dir = 8
	},
/turf/open/floor/iron/white,
/area/ruin/unpowered/bloodzone)
"P" = (
/obj/effect/spawner/random/structure/girder,
/turf/open/misc/dirt/jungle,
/area/ruin/unpowered/bloodzone)
"W" = (
/obj/machinery/iv_drip,
/turf/open/misc/dirt/jungle,
/area/ruin/unpowered/bloodzone)

(1,1,1) = {"
t
t
t
L
y
L
t
"}
(2,1,1) = {"
t
v
G
y
l
L
t
"}
(3,1,1) = {"
t
G
C
y
F
y
v
"}
(4,1,1) = {"
a
v
e
B
p
q
v
"}
(5,1,1) = {"
a
v
B
B
B
p
G
"}
(6,1,1) = {"
a
J
N
A
B
B
v
"}
(7,1,1) = {"
t
G
B
r
W
B
G
"}
(8,1,1) = {"
t
a
x
g
N
B
v
"}
(9,1,1) = {"
t
t
G
G
P
v
v
"}
