//MAP CONVERTED BY dmm2tgm.py THIS HEADER COMMENT PREVENTS RECONVERSION, DO NOT REMOVE
"a" = (
/obj/item/clothing/head/helmet/old,
/turf/open/floor/iron/textured_large,
/area/taeloth)
"b" = (
/obj/effect/decal/cleanable/dirt,
/turf/open/floor/iron/terracotta/diagonal,
/area/taeloth)
"c" = (
/obj/structure/mineral_door/wood,
/turf/open/floor/iron/textured_large,
/area/ruin/unpowered/deadorgone)
"f" = (
/obj/item/stack/sheet/mineral/wood,
/obj/effect/decal/cleanable/dirt/dust,
/obj/effect/decal/cleanable/dirt,
/obj/structure/spider/stickyweb,
/turf/open/floor/wood,
/area/ruin/unpowered/deadorgone)
"g" = (
/obj/effect/decal/cleanable/dirt/dust,
/turf/open/floor/iron/textured_large,
/area/taeloth)
"i" = (
/obj/effect/decal/cleanable/dirt,
/obj/structure/spider/stickyweb,
/turf/open/floor/wood,
/area/ruin/unpowered/deadorgone)
"j" = (
/obj/item/stack/sheet/mineral/wood,
/obj/effect/decal/cleanable/dirt/dust,
/turf/open/floor/iron/textured_large,
/area/ruin/unpowered/deadorgone)
"k" = (
/obj/effect/decal/cleanable/dirt/dust,
/obj/structure/spider/stickyweb/sealed,
/turf/open/floor/iron/terracotta/diagonal,
/area/taeloth)
"l" = (
/obj/item/gun/ballistic/rifle/boltaction/pipegun,
/obj/effect/decal/cleanable/dirt/dust,
/obj/effect/decal/cleanable/dirt,
/turf/open/floor/iron/terracotta/diagonal,
/area/taeloth)
"p" = (
/obj/effect/mob_spawn/corpse/human/charredskeleton,
/obj/effect/decal/cleanable/dirt/dust,
/obj/effect/decal/cleanable/dirt,
/turf/open/floor/iron/textured_large,
/area/taeloth)
"q" = (
/obj/effect/decal/cleanable/dirt/dust,
/obj/effect/decal/cleanable/dirt,
/turf/open/floor/iron/terracotta/diagonal,
/area/taeloth)
"r" = (
/turf/closed/wall/mineral/wood/nonmetal,
/area/ruin/unpowered/deadorgone)
"t" = (
/obj/effect/decal/cleanable/dirt/dust,
/obj/structure/spider/stickyweb,
/turf/open/floor/wood,
/area/ruin/unpowered/deadorgone)
"v" = (
/obj/effect/decal/cleanable/dirt,
/obj/structure/bed/dogbed,
/turf/open/floor/wood,
/area/ruin/unpowered/deadorgone)
"w" = (
/obj/effect/decal/cleanable/dirt/dust,
/obj/structure/bed/double,
/turf/open/floor/wood,
/area/ruin/unpowered/deadorgone)
"x" = (
/obj/structure/spider/stickyweb,
/turf/open/floor/wood,
/area/ruin/unpowered/deadorgone)
"y" = (
/obj/effect/decal/cleanable/cobweb/cobweb2,
/obj/effect/decal/cleanable/dirt,
/obj/machinery/oven,
/turf/open/floor/wood,
/area/ruin/unpowered/deadorgone)
"z" = (
/obj/effect/decal/cleanable/dirt/dust,
/obj/effect/decal/cleanable/dirt,
/obj/structure/spider/stickyweb,
/turf/open/floor/wood,
/area/ruin/unpowered/deadorgone)
"A" = (
/obj/structure/chair/stool/directional/east,
/turf/open/floor/iron/terracotta/diagonal,
/area/taeloth)
"C" = (
/obj/item/stack/sheet/mineral/wood,
/obj/effect/decal/cleanable/dirt,
/turf/open/floor/wood,
/area/ruin/unpowered/deadorgone)
"D" = (
/obj/effect/decal/cleanable/dirt/dust,
/obj/effect/decal/cleanable/dirt,
/turf/open/floor/wood,
/area/ruin/unpowered/deadorgone)
"E" = (
/obj/structure/statue/sandstone/assistant,
/obj/effect/decal/cleanable/dirt/dust,
/turf/open/floor/iron/terracotta/diagonal,
/area/taeloth)
"G" = (
/obj/effect/decal/cleanable/dirt/dust,
/obj/structure/chair/stool/directional/west,
/turf/open/floor/iron/textured_large,
/area/taeloth)
"H" = (
/obj/item/stack/sheet/mineral/wood,
/obj/effect/decal/cleanable/dirt/dust,
/obj/effect/decal/cleanable/dirt,
/turf/open/floor/iron/terracotta/diagonal,
/area/taeloth)
"I" = (
/obj/effect/decal/cleanable/dirt,
/obj/structure/table_frame/wood,
/turf/open/floor/iron/textured_large,
/area/taeloth)
"J" = (
/turf/template_noop,
/area/template_noop)
"M" = (
/obj/effect/decal/cleanable/dirt,
/obj/structure/table/reinforced,
/obj/item/papercutter{
	pixel_y = 8
	},
/turf/open/floor/wood,
/area/ruin/unpowered/deadorgone)
"O" = (
/obj/effect/decal/cleanable/dirt/dust,
/obj/effect/decal/cleanable/dirt,
/turf/open/floor/iron/textured_large,
/area/taeloth)
"P" = (
/obj/effect/decal/cleanable/dirt/dust,
/obj/effect/decal/cleanable/dirt,
/obj/structure/spider/stickyweb/sealed,
/turf/open/floor/wood,
/area/ruin/unpowered/deadorgone)
"Q" = (
/obj/effect/decal/cleanable/dirt/dust,
/turf/open/floor/wood,
/area/ruin/unpowered/deadorgone)
"R" = (
/obj/structure/bonfire,
/obj/effect/decal/cleanable/dirt/dust,
/turf/open/floor/iron/terracotta/diagonal,
/area/taeloth)
"S" = (
/obj/effect/decal/cleanable/dirt,
/obj/machinery/stove,
/turf/open/floor/wood,
/area/ruin/unpowered/deadorgone)
"T" = (
/turf/open/misc/dirt/jungle,
/area/taeloth)
"U" = (
/obj/effect/decal/cleanable/dirt/dust,
/obj/item/storage/bag/tray/cafeteria,
/turf/open/floor/iron/terracotta/diagonal,
/area/taeloth)
"V" = (
/turf/open/floor/wood,
/area/ruin/unpowered/deadorgone)
"W" = (
/obj/effect/decal/cleanable/dirt,
/turf/open/floor/wood,
/area/ruin/unpowered/deadorgone)
"Y" = (
/obj/effect/decal/cleanable/dirt,
/turf/open/floor/iron/textured_large,
/area/taeloth)
"Z" = (
/obj/item/stack/sheet/mineral/wood,
/obj/effect/decal/cleanable/dirt/dust,
/obj/effect/decal/cleanable/dirt,
/turf/open/floor/wood,
/area/ruin/unpowered/deadorgone)

(1,1,1) = {"
r
r
r
r
r
r
r
r
r
r
r
r
"}
(2,1,1) = {"
r
v
t
z
z
V
z
Z
V
D
D
r
"}
(3,1,1) = {"
r
z
z
C
z
z
z
D
Q
w
r
r
"}
(4,1,1) = {"
r
Q
D
W
t
t
V
i
D
r
r
J
"}
(5,1,1) = {"
r
M
P
P
r
r
c
r
r
r
T
J
"}
(6,1,1) = {"
r
S
f
x
r
E
k
H
O
g
T
J
"}
(7,1,1) = {"
r
y
t
D
j
q
q
b
q
O
T
T
"}
(8,1,1) = {"
r
r
Q
i
r
A
U
R
l
Y
T
T
"}
(9,1,1) = {"
J
r
r
t
r
I
H
b
p
g
T
J
"}
(10,1,1) = {"
J
J
r
r
r
G
O
a
O
T
T
J
"}
(11,1,1) = {"
J
J
J
J
T
T
T
T
T
T
J
J
"}
(12,1,1) = {"
J
J
J
J
J
T
T
T
J
T
J
J
"}
(13,1,1) = {"
J
J
J
J
J
T
J
J
J
J
J
J
"}
