//MAP CONVERTED BY dmm2tgm.py THIS HEADER COMMENT PREVENTS RECONVERSION, DO NOT REMOVE
"a" = (
/turf/open/misc/grass/jungle,
/area/ruin/unpowered/luna)
"b" = (
/obj/effect/decal/cleanable/dirt/dust,
/obj/effect/decal/cleanable/dirt,
/obj/effect/turf_decal/siding/wideplating_new/dark{
	dir = 1
	},
/obj/item/food/grown/moonflower,
/turf/open/floor/stone,
/area/ruin/unpowered/luna)
"c" = (
/obj/effect/turf_decal/siding/wideplating_new/dark{
	dir = 10
	},
/obj/structure/water_source/puddle,
/obj/effect/decal/cleanable/dirt/dust,
/turf/open/floor/stone,
/area/ruin/unpowered/luna)
"f" = (
/obj/effect/turf_decal/siding/wideplating_new/dark{
	dir = 6
	},
/obj/effect/decal/cleanable/dirt,
/turf/open/floor/stone,
/area/ruin/unpowered/luna)
"g" = (
/obj/structure/flora/bush/jungle/b/style_random,
/turf/open/misc/grass/jungle,
/area/taeloth)
"h" = (
/turf/open/misc/dirt/jungle,
/area/taeloth)
"j" = (
/obj/structure/flora/bush/jungle/c/style_random,
/turf/open/misc/grass/jungle,
/area/taeloth)
"l" = (
/obj/effect/decal/cleanable/dirt/dust,
/obj/effect/decal/cleanable/dirt,
/obj/effect/turf_decal/siding/wideplating_new/dark,
/turf/open/floor/stone,
/area/ruin/unpowered/luna)
"m" = (
/obj/effect/turf_decal/siding/wideplating_new/dark{
	dir = 5
	},
/obj/effect/decal/cleanable/dirt/dust,
/turf/open/floor/stone,
/area/ruin/unpowered/luna)
"p" = (
/obj/effect/turf_decal/siding/wideplating_new/dark{
	dir = 10
	},
/turf/open/floor/stone,
/area/ruin/unpowered/luna)
"q" = (
/turf/template_noop,
/area/template_noop)
"s" = (
/obj/structure/flora/bush/jungle/a/style_random,
/turf/open/misc/grass/jungle,
/area/taeloth)
"t" = (
/obj/structure/flora/rock/style_2,
/obj/item/claymore/cutlass/luna,
/obj/item/table_clock{
	pixel_y = -8;
	pixel_x = 10
	},
/obj/effect/decal/cleanable/dirt,
/turf/open/floor/pod,
/area/ruin/unpowered/luna)
"u" = (
/obj/effect/turf_decal/siding/wideplating_new/dark{
	dir = 1
	},
/obj/effect/decal/cleanable/dirt/dust,
/obj/effect/decal/cleanable/dirt,
/turf/open/floor/stone,
/area/ruin/unpowered/luna)
"v" = (
/obj/effect/turf_decal/siding/wideplating_new/dark,
/obj/effect/decal/cleanable/dirt/dust,
/turf/open/floor/stone,
/area/ruin/unpowered/luna)
"x" = (
/obj/structure/flora/bush/flowers_br/style_random,
/turf/open/misc/grass/jungle,
/area/ruin/unpowered/luna)
"y" = (
/turf/open/water,
/area/ruin/unpowered/luna)
"z" = (
/obj/effect/turf_decal/siding/wideplating_new/dark/corner,
/obj/effect/decal/cleanable/dirt/dust,
/obj/effect/decal/cleanable/dirt,
/obj/effect/turf_decal/siding/wideplating_new/dark/corner{
	dir = 1
	},
/turf/open/floor/stone,
/area/ruin/unpowered/luna)
"A" = (
/obj/effect/turf_decal/siding/wideplating_new/dark/corner{
	dir = 1
	},
/obj/effect/decal/cleanable/dirt/dust,
/obj/effect/decal/cleanable/dirt,
/obj/effect/turf_decal/siding/wideplating_new/dark/corner,
/turf/open/floor/stone,
/area/ruin/unpowered/luna)
"C" = (
/obj/effect/turf_decal/siding/wideplating_new/dark/corner{
	dir = 8
	},
/obj/effect/decal/cleanable/dirt/dust,
/obj/effect/decal/cleanable/dirt,
/obj/effect/turf_decal/siding/wideplating_new/dark/corner{
	dir = 4
	},
/turf/open/floor/stone,
/area/ruin/unpowered/luna)
"E" = (
/obj/effect/turf_decal/siding/wideplating_new/dark{
	dir = 4
	},
/obj/effect/decal/cleanable/dirt/dust,
/obj/effect/decal/cleanable/dirt,
/turf/open/floor/stone,
/area/ruin/unpowered/luna)
"F" = (
/obj/effect/turf_decal/siding/wideplating_new/dark{
	dir = 9
	},
/turf/open/floor/stone,
/area/ruin/unpowered/luna)
"J" = (
/turf/closed/wall/mineral/iron{
	color = "#34ebe8"
	},
/area/ruin/unpowered/luna)
"K" = (
/obj/effect/decal/cleanable/dirt/dust,
/obj/effect/decal/cleanable/dirt,
/obj/effect/turf_decal/siding/wideplating_new/dark{
	dir = 8
	},
/turf/open/floor/stone,
/area/ruin/unpowered/luna)
"L" = (
/turf/open/misc/dirt/jungle,
/area/ruin/unpowered/luna)
"M" = (
/obj/effect/turf_decal/siding/wideplating_new/dark{
	dir = 8
	},
/obj/effect/decal/cleanable/dirt/dust,
/obj/effect/decal/cleanable/dirt,
/turf/open/floor/stone,
/area/ruin/unpowered/luna)
"Q" = (
/obj/effect/decal/cleanable/dirt/dust,
/obj/effect/decal/cleanable/dirt,
/obj/effect/turf_decal/siding/wideplating_new/dark{
	dir = 4
	},
/turf/open/floor/stone,
/area/ruin/unpowered/luna)
"R" = (
/turf/open/misc/grass/jungle,
/area/taeloth)
"T" = (
/obj/effect/turf_decal/siding/wideplating_new/dark/corner{
	dir = 4
	},
/obj/effect/decal/cleanable/dirt/dust,
/obj/effect/decal/cleanable/dirt,
/obj/effect/turf_decal/siding/wideplating_new/dark/corner{
	dir = 8
	},
/turf/open/floor/stone,
/area/ruin/unpowered/luna)
"U" = (
/obj/effect/turf_decal/siding/wideplating_new/dark{
	dir = 5
	},
/turf/open/floor/stone,
/area/ruin/unpowered/luna)
"X" = (
/obj/effect/turf_decal/siding/wideplating_new/dark{
	dir = 9
	},
/obj/effect/decal/cleanable/dirt,
/turf/open/floor/stone,
/area/ruin/unpowered/luna)
"Y" = (
/obj/structure/flora/bush/reed/style_random,
/turf/open/misc/dirt/jungle,
/area/taeloth)

(1,1,1) = {"
q
q
q
q
q
q
q
h
q
q
h
q
q
q
q
"}
(2,1,1) = {"
q
q
q
Y
h
q
h
h
q
h
h
R
q
q
q
"}
(3,1,1) = {"
q
h
h
h
R
R
h
s
q
h
R
R
h
q
q
"}
(4,1,1) = {"
q
q
h
R
j
J
a
a
a
J
R
h
R
q
q
"}
(5,1,1) = {"
q
q
h
R
a
a
L
a
a
L
a
R
R
q
q
"}
(6,1,1) = {"
q
q
R
J
a
a
X
M
p
a
a
J
h
h
q
"}
(7,1,1) = {"
q
h
R
a
x
F
A
Q
C
c
a
L
h
h
h
"}
(8,1,1) = {"
q
h
R
a
L
u
l
t
b
v
a
a
g
h
q
"}
(9,1,1) = {"
q
q
h
x
a
U
T
K
z
f
L
a
R
q
q
"}
(10,1,1) = {"
q
q
h
J
a
L
m
E
f
a
a
J
h
q
q
"}
(11,1,1) = {"
q
q
R
R
a
a
y
y
a
a
a
R
h
h
q
"}
(12,1,1) = {"
q
q
h
h
R
J
a
a
a
J
R
h
h
h
q
"}
(13,1,1) = {"
q
h
h
R
R
R
R
h
h
R
R
h
q
q
q
"}
(14,1,1) = {"
h
q
R
q
R
s
h
h
q
q
q
q
q
q
q
"}
(15,1,1) = {"
q
h
q
q
q
q
q
q
q
q
q
q
q
q
q
"}
