//MAP CONVERTED BY dmm2tgm.py THIS HEADER COMMENT PREVENTS RECONVERSION, DO NOT REMOVE
"a" = (
/turf/closed/wall/mineral/titanium/survival/pod,
/area/misc/survivalpod)
"d" = (
/obj/machinery/door/airlock/survival_pod/glass,
/obj/structure/fans/tiny,
/turf/open/floor/pod/dark,
/area/misc/survivalpod)
"f" = (
/obj/structure/table/reinforced/plastitaniumglass,
/obj/item/stack/ducts/fifty,
/obj/item/stack/ducts/fifty,
/obj/item/stack/ducts/fifty,
/obj/item/stack/ducts/fifty,
/obj/item/stack/ducts/fifty,
/obj/item/stack/ducts/fifty,
/obj/item/stack/ducts/fifty,
/obj/item/stack/ducts/fifty,
/obj/item/stack/ducts/fifty,
/obj/item/stack/ducts/fifty,
/turf/open/floor/pod/dark,
/area/misc/survivalpod)
"g" = (
/obj/structure/table/reinforced/plastitaniumglass,
/obj/item/construction/plumbing,
/turf/open/floor/pod/dark,
/area/misc/survivalpod)
"m" = (
/obj/structure/table/reinforced/plastitaniumglass,
/obj/item/clothing/glasses/science,
/obj/item/clothing/glasses/science,
/obj/item/storage/belt/utility/full,
/turf/open/floor/pod/dark,
/area/misc/survivalpod)
"n" = (
/obj/structure/table/reinforced/plastitaniumglass,
/obj/machinery/reagentgrinder,
/obj/item/stack/sheet/mineral/plasma/five,
/turf/open/floor/pod/dark,
/area/misc/survivalpod)
"q" = (
/turf/open/floor/pod/dark,
/area/misc/survivalpod)
"r" = (
/obj/structure/fans,
/turf/open/floor/pod/dark,
/area/misc/survivalpod)
"u" = (
/obj/effect/spawner/structure/window/survival_pod,
/turf/open/floor/pod/dark,
/area/misc/survivalpod)
"v" = (
/obj/item/gps/computer,
/turf/open/floor/pod/dark,
/area/misc/survivalpod)
"x" = (
/obj/machinery/light/floor,
/turf/open/floor/pod/light,
/area/misc/survivalpod)
"y" = (
/turf/open/floor/pod/light,
/area/misc/survivalpod)
"B" = (
/obj/machinery/light/floor,
/turf/open/floor/pod/dark,
/area/misc/survivalpod)
"L" = (
/obj/machinery/plumbing/receiver,
/turf/open/floor/pod/dark,
/area/misc/survivalpod)

(1,1,1) = {"
a
a
u
u
u
u
u
u
u
a
a
"}
(2,1,1) = {"
a
f
q
q
q
q
q
q
q
L
a
"}
(3,1,1) = {"
a
g
B
q
q
q
q
q
B
q
u
"}
(4,1,1) = {"
a
v
q
q
q
q
y
y
y
q
u
"}
(5,1,1) = {"
u
r
q
y
q
y
y
y
y
q
a
"}
(6,1,1) = {"
d
q
q
x
y
y
y
x
y
q
d
"}
(7,1,1) = {"
u
q
q
y
q
y
y
y
y
q
a
"}
(8,1,1) = {"
a
q
q
q
q
q
y
y
y
q
u
"}
(9,1,1) = {"
a
m
B
q
q
q
q
q
B
q
u
"}
(10,1,1) = {"
a
n
q
q
q
q
q
q
q
L
a
"}
(11,1,1) = {"
a
a
u
u
u
u
u
u
u
a
a
"}
