//MAP CONVERTED BY dmm2tgm.py THIS HEADER COMMENT PREVENTS RECONVERSION, DO NOT REMOVE
"a" = (
/turf/closed/wall/mineral/titanium/survival/pod,
/area/misc/survivalpod)
"c" = (
/obj/structure/fans/tiny,
/obj/machinery/door/airlock/survival_pod/glass,
/turf/open/floor/pod/light,
/area/misc/survivalpod)
"d" = (
/obj/effect/spawner/structure/window/survival_pod,
/turf/open/floor/pod/light,
/area/misc/survivalpod)
"f" = (
/obj/item/gps/computer,
/turf/open/floor/pod/dark,
/area/misc/survivalpod)
"g" = (
/obj/structure/fans,
/turf/open/floor/pod/dark,
/area/misc/survivalpod)
"i" = (
/obj/machinery/stasis,
/turf/open/floor/pod/dark,
/area/misc/survivalpod)
"j" = (
/obj/item/wallframe/defib_mount,
/obj/item/defibrillator/loaded,
/turf/open/floor/pod/dark,
/area/misc/survivalpod)
"k" = (
/obj/structure/table/reinforced/plastitaniumglass,
/obj/item/storage/box/syringes,
/obj/item/storage/medkit/regular,
/obj/item/storage/medkit/robotic_repair,
/obj/item/storage/medkit/toxin,
/obj/item/storage/medkit/o2,
/obj/item/storage/medkit/brute,
/obj/item/storage/medkit/fire,
/turf/open/floor/pod/dark,
/area/misc/survivalpod)
"m" = (
/obj/structure/closet/crate/freezer/blood,
/obj/machinery/iv_drip,
/turf/open/floor/pod/dark,
/area/misc/survivalpod)
"n" = (
/obj/structure/closet/crate/freezer/surplus_limbs,
/turf/open/floor/pod/dark,
/area/misc/survivalpod)
"o" = (
/obj/structure/table/reinforced/plastitaniumglass,
/obj/machinery/reagentgrinder,
/turf/open/floor/pod/dark,
/area/misc/survivalpod)
"q" = (
/turf/open/floor/pod/dark,
/area/misc/survivalpod)
"r" = (
/obj/machinery/chem_master,
/turf/open/floor/pod/dark,
/area/misc/survivalpod)
"t" = (
/obj/machinery/shower/directional/north,
/obj/structure/fluff/shower_drain,
/turf/open/floor/pod/dark,
/area/misc/survivalpod)
"u" = (
/obj/effect/spawner/structure/window/survival_pod,
/turf/open/floor/pod/dark,
/area/misc/survivalpod)
"w" = (
/obj/structure/sink/directional/north,
/turf/open/floor/pod/dark,
/area/misc/survivalpod)
"x" = (
/obj/machinery/light/floor,
/turf/open/floor/pod/light,
/area/misc/survivalpod)
"y" = (
/turf/open/floor/pod/light,
/area/misc/survivalpod)
"A" = (
/obj/structure/table/reinforced/plastitaniumglass,
/obj/item/stack/medical/gauze/twelve,
/obj/item/stack/medical/gauze/twelve,
/obj/item/storage/box/bodybags,
/obj/item/storage/box/gloves,
/obj/item/storage/box/masks,
/obj/item/clothing/suit/toggle/labcoat,
/obj/item/clothing/suit/toggle/labcoat,
/obj/item/clothing/suit/toggle/labcoat,
/obj/item/clothing/suit/toggle/labcoat,
/turf/open/floor/pod/dark,
/area/misc/survivalpod)
"B" = (
/obj/structure/table/reinforced/plastitaniumglass,
/obj/item/storage/box/beakers,
/turf/open/floor/pod/dark,
/area/misc/survivalpod)
"E" = (
/obj/structure/sign/poster/quirk/medical_logo,
/turf/closed/wall/mineral/titanium/survival/pod,
/area/misc/survivalpod)
"G" = (
/obj/machinery/light/directional/east,
/turf/open/floor/pod/dark,
/area/misc/survivalpod)
"I" = (
/obj/item/surgery_tray/full/deployed,
/obj/structure/table/reinforced/plastitaniumglass,
/turf/open/floor/pod/light,
/area/misc/survivalpod)
"K" = (
/obj/structure/table/optable,
/obj/machinery/light/directional/west,
/turf/open/floor/pod/light,
/area/misc/survivalpod)
"L" = (
/obj/machinery/computer/operating{
	dir = 4
	},
/turf/open/floor/pod/light,
/area/misc/survivalpod)
"M" = (
/obj/item/wallframe/frontier_medstation,
/obj/item/reagent_containers/syringe/convermol{
	list_reagents = list(/datum/reagent/medicine/rezadone = 15);
	name = "syringe (rezadone)"
	},
/obj/item/reagent_containers/syringe/convermol{
	list_reagents = list(/datum/reagent/medicine/rezadone = 15);
	name = "syringe (rezadone)"
	},
/obj/structure/table/reinforced/plastitaniumglass,
/turf/open/floor/pod/dark,
/area/misc/survivalpod)
"N" = (
/obj/machinery/computer/operating{
	dir = 8
	},
/turf/open/floor/pod/light,
/area/misc/survivalpod)
"R" = (
/obj/machinery/door/airlock/survival_pod/glass,
/obj/structure/fans/tiny,
/turf/open/floor/pod/light,
/area/misc/survivalpod)
"S" = (
/obj/machinery/light/directional/west,
/obj/structure/fluff/shower_drain,
/obj/machinery/shower/directional/north,
/turf/open/floor/pod/light,
/area/misc/survivalpod)
"U" = (
/obj/machinery/light/directional/east,
/obj/structure/fluff/shower_drain,
/obj/machinery/shower/directional/north,
/turf/open/floor/pod/light,
/area/misc/survivalpod)
"X" = (
/obj/structure/table/optable,
/obj/machinery/light/directional/east,
/turf/open/floor/pod/light,
/area/misc/survivalpod)
"Z" = (
/obj/machinery/light/directional/west,
/turf/open/floor/pod/dark,
/area/misc/survivalpod)

(1,1,1) = {"
a
a
d
d
d
d
a
a
d
a
a
"}
(2,1,1) = {"
a
f
q
Z
q
o
a
I
K
L
a
"}
(3,1,1) = {"
d
g
y
y
x
B
E
j
y
w
a
"}
(4,1,1) = {"
a
a
a
a
y
r
a
a
c
d
a
"}
(5,1,1) = {"
d
i
S
u
y
q
q
Z
q
t
d
"}
(6,1,1) = {"
R
y
y
c
x
y
y
y
x
y
R
"}
(7,1,1) = {"
d
i
U
u
y
q
q
G
q
t
d
"}
(8,1,1) = {"
a
a
a
a
y
M
a
a
c
d
a
"}
(9,1,1) = {"
d
m
y
y
x
k
E
j
y
w
a
"}
(10,1,1) = {"
a
n
q
G
q
A
a
I
X
N
a
"}
(11,1,1) = {"
a
a
d
d
d
d
a
a
d
a
a
"}
