"a" = (/obj/structure/window/reinforced/survival_pod/spawner/directional/north,/turf/open/floor/pod/light,/area/misc/survivalpod)
"e" = (/obj/structure/window/reinforced/survival_pod/spawner/directional/east,/obj/structure/window/reinforced/survival_pod/spawner/directional,/obj/structure/window/reinforced/survival_pod/spawner/directional/north,/obj/machinery/stasis,/turf/open/floor/pod/light,/area/misc/survivalpod)
"l" = (/obj/structure/fans/tiny,/turf/open/floor/pod/light,/area/misc/survivalpod)
"I" = (/obj/structure/window/reinforced/survival_pod,/turf/open/floor/pod/light,/area/misc/survivalpod)
"O" = (/obj/structure/window/reinforced/survival_pod,/obj/structure/window/reinforced/survival_pod/spawner/directional/east,/obj/structure/window/reinforced/survival_pod/spawner/directional/north,/obj/machinery/defibrillator_mount/mobile,/obj/item/defibrillator/loaded,/turf/open/floor/pod/light,/area/misc/survivalpod)
"P" = (/obj/structure/window/reinforced/survival_pod,/obj/structure/window/reinforced/survival_pod/spawner/directional/west,/obj/item/surgery_tray/full/deployed,/turf/open/floor/pod/light,/area/misc/survivalpod)
"V" = (/obj/machinery/light/floor,/turf/open/floor/pod/light,/area/misc/survivalpod)
"X" = (/obj/structure/window/reinforced/survival_pod/spawner/directional/west,/obj/structure/table/optable,/turf/open/floor/pod/light,/area/misc/survivalpod)
"Z" = (/obj/structure/window/reinforced/survival_pod/spawner/directional/west,/obj/structure/window/reinforced/survival_pod/spawner/directional/north,/obj/machinery/computer/operating,/turf/open/floor/pod/light,/area/misc/survivalpod)

(1,1,1) = {"
Zae
XVl
PIO
"}
