//MAP CONVERTED BY dmm2tgm.py THIS HEADER COMMENT PREVENTS RECONVERSION, DO NOT REMOVE
"a" = (
/obj/structure/fans/tiny,
/turf/open/floor/pod/dark,
/area/misc/survivalpod)

(1,1,1) = {"
a
"}
