//MAP CONVERTED BY dmm2tgm.py THIS HEADER COMMENT PREVENTS RECONVERSION, DO NOT REMOVE
"a" = (
/obj/structure/window/reinforced/survival_pod/spawner/directional/south,
/obj/structure/table/reinforced/plastitaniumglass,
/obj/effect/turf_decal/siding/thinplating_new/light{
	dir = 9
	},
/obj/machinery/reagentgrinder,
/turf/open/floor/pod/dark,
/area/misc/survivalpod)
"h" = (
/turf/open/floor/pod/light,
/area/misc/survivalpod)
"l" = (
/obj/machinery/light/floor,
/turf/open/floor/pod/light,
/area/misc/survivalpod)
"o" = (
/obj/structure/window/reinforced/survival_pod/spawner/directional/south,
/obj/effect/turf_decal/siding/thinplating_new/light{
	dir = 5
	},
/obj/machinery/chem_master/condimaster,
/turf/open/floor/pod/dark,
/area/misc/survivalpod)
"p" = (
/obj/structure/window/reinforced/survival_pod/spawner/directional/north,
/obj/structure/table/reinforced/plastitaniumglass,
/obj/effect/turf_decal/siding/thinplating_new/light{
	dir = 10
	},
/obj/machinery/griddle/frontier_tabletop,
/turf/open/floor/pod/dark,
/area/misc/survivalpod)
"t" = (
/obj/structure/window/reinforced/survival_pod/spawner/directional/south,
/obj/structure/window/reinforced/survival_pod/spawner/directional/east,
/obj/machinery/smartfridge/food,
/obj/effect/turf_decal/siding/thinplating_new/light{
	dir = 9
	},
/turf/open/floor/pod/dark,
/area/misc/survivalpod)
"z" = (
/obj/structure/window/reinforced/survival_pod/spawner/directional/north,
/obj/structure/window/reinforced/survival_pod/spawner/directional/east,
/obj/structure/table/reinforced/plastitaniumglass,
/obj/effect/turf_decal/siding/thinplating_new/light{
	dir = 10
	},
/obj/machinery/microwave/frontier_printed,
/turf/open/floor/pod/dark,
/area/misc/survivalpod)
"F" = (
/obj/machinery/door/window/survival_pod/left/directional/west,
/turf/open/floor/pod/light,
/area/misc/survivalpod)
"M" = (
/obj/structure/window/reinforced/survival_pod/spawner/directional/north,
/obj/effect/turf_decal/siding/thinplating_new/light{
	dir = 6
	},
/obj/machinery/oven/range_frontier,
/turf/open/floor/pod/dark,
/area/misc/survivalpod)
"P" = (
/obj/machinery/door/window/survival_pod/left/directional/north,
/turf/open/floor/pod/light,
/area/misc/survivalpod)
"Q" = (
/obj/machinery/door/window/survival_pod/left/directional/east,
/turf/open/floor/pod/light,
/area/misc/survivalpod)
"T" = (
/obj/machinery/door/window/survival_pod/left/directional/south,
/turf/open/floor/pod/light,
/area/misc/survivalpod)
"X" = (
/obj/structure/window/reinforced/survival_pod/spawner/directional/west,
/obj/structure/window/reinforced/survival_pod/spawner/directional/north,
/obj/structure/table/reinforced/plastitaniumglass,
/obj/effect/turf_decal/siding/thinplating_new/light{
	dir = 6
	},
/obj/machinery/chem_dispenser/frontier_appliance,
/turf/open/floor/pod/dark,
/area/misc/survivalpod)
"Y" = (
/obj/structure/window/reinforced/survival_pod/spawner/directional/west,
/obj/structure/window/reinforced/survival_pod/spawner/directional/south,
/obj/structure/table/reinforced/plastitaniumglass,
/obj/effect/turf_decal/siding/thinplating_new/light{
	dir = 5
	},
/obj/machinery/biogenerator/foodricator,
/turf/open/floor/pod/dark,
/area/misc/survivalpod)

(1,1,1) = {"
X
F
Y
"}
(2,1,1) = {"
P
l
T
"}
(3,1,1) = {"
p
h
a
"}
(4,1,1) = {"
M
h
o
"}
(5,1,1) = {"
P
l
T
"}
(6,1,1) = {"
z
Q
t
"}
