"a" = (/obj/machinery/light/floor,/turf/open/floor/pod/light,/area/misc/survivalpod)
"g" = (/obj/structure/window/reinforced/survival_pod/spawner/directional/north,/obj/structure/window/reinforced/survival_pod/spawner/directional/west,/obj/structure/closet/xenoarch,/turf/open/floor/pod/light,/area/misc/survivalpod)
"m" = (/turf/open/space/basic,/area/space)
"o" = (/obj/machinery/door/window/survival_pod/left/directional/south,/turf/open/floor/pod/light,/area/misc/survivalpod)
"w" = (/obj/machinery/door/window/survival_pod/left/directional/north,/turf/open/floor/pod/light,/area/misc/survivalpod)
"I" = (/obj/machinery/door/window/survival_pod/left/directional/west,/turf/open/floor/pod/light,/area/misc/survivalpod)
"J" = (/obj/structure/window/reinforced/survival_pod/spawner/directional/east,/obj/structure/window/reinforced/survival_pod/spawner/directional/south,/obj/item/clothing/suit/hooded/wintercoat/science,/obj/item/gps/science,/turf/open/floor/pod/light,/area/misc/survivalpod)
"M" = (/obj/structure/window/reinforced/survival_pod/spawner/directional/east,/obj/structure/window/reinforced/survival_pod/spawner/directional/north,/obj/item/tank/internals/emergency_oxygen/double,/obj/item/clothing/mask/breath,/obj/item/pickaxe/drill,/turf/open/floor/pod/light,/area/misc/survivalpod)
"O" = (/obj/structure/window/reinforced/survival_pod/spawner/directional/south,/obj/structure/window/reinforced/survival_pod/spawner/directional/west,/obj/machinery/xenoarch/researcher,/turf/open/floor/pod/light,/area/misc/survivalpod)
"U" = (/obj/machinery/door/window/survival_pod/left/directional/east,/turf/open/floor/pod/light,/area/misc/survivalpod)

(1,1,1) = {"
gwM
IaU
OoJ
"}
(1,1,2) = {"
mmm
mmm
mmm
"}
(1,1,3) = {"
mmm
mmm
mmm
"}
