//MAP CONVERTED BY dmm2tgm.py THIS HEADER COMMENT PREVENTS RECONVERSION, DO NOT REMOVE
"a" = (
/obj/structure/window/reinforced/survival_pod/spawner/directional/east,
/obj/structure/window/reinforced/survival_pod/spawner/directional/south,
/obj/item/clothing/suit/hooded/wintercoat/science,
/obj/item/gps/science,
/turf/open/floor/pod/light,
/area/misc/survivalpod)
"c" = (
/obj/machinery/door/window/survival_pod/left/directional/south,
/turf/open/floor/pod/light,
/area/misc/survivalpod)
"e" = (
/obj/machinery/door/window/survival_pod/left/directional/west,
/turf/open/floor/pod/light,
/area/misc/survivalpod)
"k" = (
/obj/machinery/light/floor,
/turf/open/floor/pod/light,
/area/misc/survivalpod)
"v" = (
/obj/structure/window/reinforced/survival_pod/spawner/directional/east,
/obj/structure/window/reinforced/survival_pod/spawner/directional/north,
/obj/item/tank/internals/emergency_oxygen/double,
/obj/item/clothing/mask/breath,
/obj/item/pickaxe/drill,
/turf/open/floor/pod/light,
/area/misc/survivalpod)
"F" = (
/obj/structure/window/reinforced/survival_pod/spawner/directional/north,
/obj/structure/window/reinforced/survival_pod/spawner/directional/west,
/obj/structure/closet/xenoarch,
/turf/open/floor/pod/light,
/area/misc/survivalpod)
"G" = (
/obj/structure/window/reinforced/survival_pod/spawner/directional/south,
/obj/structure/window/reinforced/survival_pod/spawner/directional/west,
/obj/machinery/xenoarch/researcher,
/turf/open/floor/pod/light,
/area/misc/survivalpod)
"T" = (
/obj/machinery/door/window/survival_pod/left/directional/north,
/turf/open/floor/pod/light,
/area/misc/survivalpod)
"W" = (
/obj/machinery/door/window/survival_pod/left/directional/east,
/turf/open/floor/pod/light,
/area/misc/survivalpod)

(1,1,1) = {"
F
e
G
"}
(2,1,1) = {"
T
k
c
"}
(3,1,1) = {"
v
W
a
"}
