//MAP CONVERTED BY dmm2tgm.py THIS HEADER COMMENT PREVENTS RECONVERSION, DO NOT REMOVE
"a" = (
/obj/machinery/light/floor,
/turf/open/floor/pod/light,
/area/misc/survivalpod)
"l" = (
/obj/structure/window/reinforced/survival_pod/spawner/directional/west,
/obj/structure/table/optable,
/turf/open/floor/pod/light,
/area/misc/survivalpod)
"w" = (
/obj/structure/window/reinforced/survival_pod,
/obj/structure/window/reinforced/survival_pod/spawner/directional/west,
/obj/item/surgery_tray/full/deployed,
/turf/open/floor/pod/light,
/area/misc/survivalpod)
"x" = (
/obj/structure/window/reinforced/survival_pod,
/obj/structure/window/reinforced/survival_pod/spawner/directional/east,
/obj/structure/window/reinforced/survival_pod/spawner/directional/north,
/obj/machinery/defibrillator_mount/mobile,
/obj/item/defibrillator/loaded,
/turf/open/floor/pod/light,
/area/misc/survivalpod)
"H" = (
/obj/structure/window/reinforced/survival_pod,
/turf/open/floor/pod/light,
/area/misc/survivalpod)
"L" = (
/obj/structure/window/reinforced/survival_pod/spawner/directional/east,
/obj/structure/window/reinforced/survival_pod/spawner/directional,
/obj/structure/window/reinforced/survival_pod/spawner/directional/north,
/obj/machinery/stasis,
/turf/open/floor/pod/light,
/area/misc/survivalpod)
"M" = (
/obj/structure/fans/tiny,
/turf/open/floor/pod/light,
/area/misc/survivalpod)
"R" = (
/obj/structure/window/reinforced/survival_pod/spawner/directional/west,
/obj/structure/window/reinforced/survival_pod/spawner/directional/north,
/obj/machinery/computer/operating,
/turf/open/floor/pod/light,
/area/misc/survivalpod)
"U" = (
/obj/structure/window/reinforced/survival_pod/spawner/directional/north,
/turf/open/floor/pod/light,
/area/misc/survivalpod)

(1,1,1) = {"
R
l
w
"}
(2,1,1) = {"
U
a
H
"}
(3,1,1) = {"
L
M
x
"}
