//MAP CONVERTED BY dmm2tgm.py THIS HEADER COMMENT PREVENTS RECONVERSION, DO NOT REMOVE
"a" = (
/obj/structure/window/reinforced/survival_pod/spawner/directional/east,
/obj/structure/window/reinforced/survival_pod/spawner/directional/south,
/turf/open/floor/pod/dark,
/area/misc/survivalpod)
"c" = (
/obj/structure/window/reinforced/survival_pod/spawner/directional/north,
/obj/structure/window/reinforced/survival_pod/spawner/directional/west,
/turf/open/floor/pod/dark,
/area/misc/survivalpod)
"d" = (
/obj/machinery/door/window/survival_pod/left/directional/south,
/turf/open/floor/pod/light,
/area/misc/survivalpod)
"l" = (
/obj/structure/window/reinforced/survival_pod/spawner/directional/east,
/obj/structure/window/reinforced/survival_pod/spawner/directional/north,
/turf/open/floor/pod/dark,
/area/misc/survivalpod)
"m" = (
/obj/machinery/light/floor,
/turf/open/floor/pod/light,
/area/misc/survivalpod)
"o" = (
/obj/machinery/door/window/survival_pod/left/directional/east,
/turf/open/floor/pod/light,
/area/misc/survivalpod)
"t" = (
/obj/structure/window/reinforced/survival_pod/spawner/directional/south,
/turf/open/floor/pod/dark,
/area/misc/survivalpod)
"y" = (
/turf/open/floor/pod/dark,
/area/misc/survivalpod)
"z" = (
/obj/structure/window/reinforced/survival_pod/spawner/directional/south,
/obj/structure/window/reinforced/survival_pod/spawner/directional/west,
/turf/open/floor/pod/dark,
/area/misc/survivalpod)
"D" = (
/obj/structure/window/reinforced/survival_pod/spawner/directional/east,
/turf/open/floor/pod/dark,
/area/misc/survivalpod)
"H" = (
/obj/machinery/door/window/survival_pod/left/directional/north,
/turf/open/floor/pod/light,
/area/misc/survivalpod)
"I" = (
/obj/machinery/door/window/survival_pod/left/directional/west,
/turf/open/floor/pod/light,
/area/misc/survivalpod)
"M" = (
/obj/structure/window/reinforced/survival_pod/spawner/directional/north,
/turf/open/floor/pod/dark,
/area/misc/survivalpod)
"N" = (
/turf/open/floor/pod/light,
/area/misc/survivalpod)
"V" = (
/obj/structure/window/reinforced/survival_pod/spawner/directional/west,
/turf/open/floor/pod/dark,
/area/misc/survivalpod)

(1,1,1) = {"
c
I
V
V
I
z
"}
(2,1,1) = {"
H
m
N
N
m
d
"}
(3,1,1) = {"
M
N
y
y
N
t
"}
(4,1,1) = {"
M
N
y
y
N
t
"}
(5,1,1) = {"
H
m
N
N
m
d
"}
(6,1,1) = {"
l
o
D
D
o
a
"}
