//MAP CONVERTED BY dmm2tgm.py THIS HEADER COMMENT PREVENTS RECONVERSION, DO NOT REMOVE
"a" = (
/obj/item/stack/sheet/animalhide/gondola,
/turf/open/floor/grass,
/area/station/maintenance/aft/upper)
"c" = (
/obj/machinery/light/warm/directional/south,
/obj/machinery/atmospherics/pipe/smart/manifold4w/scrubbers/hidden/layer2,
/obj/item/stack/sheet/animalhide/gondola,
/obj/effect/decal/cleanable/blood/drip,
/turf/open/floor/grass,
/area/station/maintenance/aft/upper)
"e" = (
/obj/machinery/atmospherics/components/unary/vent_pump/on/layer4,
/turf/open/floor/grass,
/area/station/maintenance/aft/upper)
"u" = (
/obj/machinery/atmospherics/components/unary/vent_scrubber/on/layer2,
/obj/item/stack/sheet/animalhide/gondola,
/turf/open/floor/grass,
/area/station/maintenance/aft/upper)
"A" = (
/obj/structure/flora/bush/flowers_yw/style_random,
/turf/open/floor/grass,
/area/station/maintenance/aft/upper)
"D" = (
/obj/machinery/atmospherics/pipe/smart/manifold4w/supply/hidden/layer4,
/obj/effect/decal/cleanable/blood/drip,
/turf/open/floor/grass,
/area/station/maintenance/aft/upper)
"H" = (
/obj/machinery/atmospherics/pipe/smart/manifold4w/supply/hidden/layer4,
/obj/machinery/light/warm/directional/south,
/obj/structure/flora/bush/flowers_pp/style_random,
/obj/effect/decal/cleanable/blood,
/turf/open/floor/grass,
/area/station/maintenance/aft/upper)
"J" = (
/obj/effect/decal/cleanable/blood/drip,
/obj/item/clothing/mask/gondola,
/obj/item/clothing/under/costume/gondola,
/turf/open/floor/grass,
/area/station/maintenance/aft/upper)
"M" = (
/obj/effect/decal/cleanable/blood,
/turf/open/floor/grass,
/area/station/maintenance/aft/upper)
"V" = (
/obj/machinery/atmospherics/pipe/smart/manifold4w/scrubbers/hidden/layer2,
/obj/machinery/atmospherics/pipe/smart/manifold4w/supply/hidden/layer4,
/obj/modular_map_connector,
/obj/item/stack/sheet/animalhide/gondola,
/obj/effect/decal/cleanable/blood/footprints/dirty,
/turf/open/floor/grass,
/area/station/maintenance/aft/upper)
"W" = (
/obj/machinery/atmospherics/pipe/smart/manifold4w/scrubbers/hidden/layer2,
/obj/structure/flora/bush/flowers_br/style_random,
/turf/open/floor/grass,
/area/station/maintenance/aft/upper)
"Z" = (
/obj/machinery/atmospherics/pipe/smart/manifold4w/supply/hidden/layer4,
/obj/item/stack/sheet/animalhide/gondola,
/turf/open/floor/grass,
/area/station/maintenance/aft/upper)

(1,1,1) = {"
u
W
c
"}
(2,1,1) = {"
A
M
V
"}
(3,1,1) = {"
J
a
D
"}
(4,1,1) = {"
e
Z
H
"}
