//MAP CONVERTED BY dmm2tgm.py THIS HEADER COMMENT PREVENTS RECONVERSION, DO NOT REMOVE
"a" = (
/obj/structure/flora/rock/pile/jungle/style_random,
/turf/open/misc/asteroid/snow/standard_air,
/area/station/maintenance/aft/upper)
"d" = (
/obj/machinery/atmospherics/pipe/smart/manifold4w/supply/hidden/layer4,
/turf/open/misc/asteroid/snow/standard_air,
/area/station/maintenance/aft/upper)
"i" = (
/turf/open/misc/asteroid/snow/standard_air,
/area/station/maintenance/aft/upper)
"s" = (
/obj/structure/flora/rock/style_random,
/turf/open/misc/asteroid/snow/standard_air,
/area/station/maintenance/aft/upper)
"w" = (
/obj/machinery/atmospherics/components/unary/vent_scrubber/on/layer2{
	dir = 4
	},
/obj/machinery/light/cold/directional/south,
/turf/open/misc/asteroid/snow/standard_air,
/area/station/maintenance/aft/upper)
"z" = (
/mob/living/basic/goat,
/turf/open/misc/asteroid/snow/standard_air,
/area/station/maintenance/aft/upper)
"O" = (
/obj/machinery/atmospherics/components/unary/vent_pump/on/layer4{
	dir = 8
	},
/obj/machinery/light/cold/directional/south,
/turf/open/misc/asteroid/snow/standard_air,
/area/station/maintenance/aft/upper)
"R" = (
/obj/machinery/atmospherics/pipe/smart/manifold4w/scrubbers/hidden/layer2,
/obj/modular_map_connector,
/obj/machinery/atmospherics/pipe/smart/manifold4w/supply/hidden/layer4,
/turf/open/misc/asteroid/snow/standard_air,
/area/station/maintenance/aft/upper)

(1,1,1) = {"
a
i
w
"}
(2,1,1) = {"
i
z
R
"}
(3,1,1) = {"
s
i
d
"}
(4,1,1) = {"
i
a
O
"}
