//MAP CONVERTED BY dmm2tgm.py THIS HEADER COMMENT PREVENTS RECONVERSION, DO NOT REMOVE
"a" = (
/obj/effect/decal/cleanable/crayon{
	icon_state = "i";
	color = "#FF9900";
	pixel_x = -12
	},
/obj/effect/decal/cleanable/crayon{
	icon_state = "d";
	color = "#FF9900";
	pixel_x = -3
	},
/obj/effect/decal/cleanable/crayon{
	icon_state = "e";
	color = "#FF9900";
	pixel_x = 8
	},
/turf/open/floor/plating,
/area/station/maintenance/aft/upper)
"d" = (
/obj/machinery/light/small/directional/south,
/obj/effect/decal/cleanable/blood,
/turf/open/floor/plating,
/area/station/maintenance/aft/upper)
"i" = (
/obj/effect/decal/cleanable/crayon{
	icon_state = "x";
	color = "#EE0000";
	pixel_x = -4
	},
/turf/open/floor/plating,
/area/station/maintenance/aft/upper)
"p" = (
/obj/effect/decal/cleanable/crayon{
	icon_state = "o";
	color = "#FF9900";
	pixel_x = -6
	},
/obj/effect/decal/cleanable/crayon{
	icon_state = "p";
	color = "#FF9900";
	pixel_x = 5;
	pixel_y = 3
	},
/turf/open/floor/plating,
/area/station/maintenance/aft/upper)
"q" = (
/obj/effect/decal/cleanable/crayon{
	icon_state = "n";
	color = "#FF9900";
	pixel_x = -7;
	pixel_y = 2
	},
/obj/effect/decal/cleanable/crayon{
	icon_state = "t";
	color = "#FF9900";
	pixel_x = 9;
	pixel_y = -1
	},
/obj/effect/decal/cleanable/blood/splatter,
/turf/open/floor/plating,
/area/station/maintenance/aft/upper)
"s" = (
/obj/effect/decal/cleanable/crayon{
	icon_state = "f";
	color = "#EE0000"
	},
/obj/effect/decal/cleanable/crayon{
	icon_state = "o";
	color = "#EE0000";
	pixel_x = 10;
	pixel_y = 2
	},
/turf/open/floor/plating,
/area/station/maintenance/aft/upper)
"v" = (
/obj/effect/decal/cleanable/crayon{
	icon_state = "d";
	color = "#FF9900";
	pixel_x = -8;
	pixel_y = 3
	},
/obj/effect/decal/cleanable/crayon{
	icon_state = "o";
	color = "#FF9900";
	pixel_x = 8
	},
/turf/open/floor/plating,
/area/station/maintenance/aft/upper)
"w" = (
/obj/machinery/atmospherics/components/unary/vent_scrubber/on/layer2{
	dir = 4
	},
/obj/machinery/light/small/directional/south,
/turf/open/floor/plating,
/area/station/maintenance/aft/upper)
"z" = (
/obj/effect/decal/cleanable/crayon{
	icon_state = "e";
	color = "#FF9900";
	pixel_x = -14
	},
/obj/effect/decal/cleanable/crayon{
	icon_state = "n";
	color = "#FF9900";
	pixel_x = 3;
	pixel_y = -2
	},
/turf/open/floor/plating,
/area/station/maintenance/aft/upper)
"O" = (
/obj/structure/closet/foxbox,
/turf/open/floor/plating,
/area/station/maintenance/aft/upper)
"R" = (
/obj/machinery/atmospherics/pipe/smart/manifold4w/scrubbers/hidden/layer2,
/obj/modular_map_connector,
/obj/machinery/atmospherics/components/unary/vent_pump/on/layer4,
/turf/open/floor/plating,
/area/station/maintenance/aft/upper)
"S" = (
/obj/effect/decal/cleanable/crayon{
	icon_state = "i";
	color = "#FF9900";
	pixel_x = -10
	},
/obj/effect/decal/cleanable/crayon{
	icon_state = "n";
	color = "#FF9900"
	},
/obj/effect/decal/cleanable/crayon{
	icon_state = "s";
	color = "#FF9900";
	pixel_x = 12
	},
/turf/open/floor/plating,
/area/station/maintenance/aft/upper)

(1,1,1) = {"
v
p
w
"}
(2,1,1) = {"
q
z
R
"}
(3,1,1) = {"
s
S
d
"}
(4,1,1) = {"
i
a
O
"}
