//MAP CONVERTED BY dmm2tgm.py THIS HEADER COMMENT PREVENTS RECONVERSION, DO NOT REMOVE
"a" = (
/mob/living/basic/axolotl,
/turf/open/water/jungle/biodome,
/area/station/maintenance/aft/upper)
"f" = (
/obj/machinery/atmospherics/pipe/smart/manifold4w/supply/hidden/layer4,
/obj/structure/flora/rock/pile/jungle/style_random,
/turf/open/water/jungle/biodome,
/area/station/maintenance/aft/upper)
"i" = (
/obj/machinery/atmospherics/pipe/smart/manifold4w/scrubbers/hidden/layer2,
/obj/machinery/atmospherics/pipe/smart/manifold4w/supply/hidden/layer4,
/obj/modular_map_connector,
/turf/open/misc/ashplanet/wateryrock/biodome,
/area/station/maintenance/aft/upper)
"n" = (
/mob/living/basic/axolotl,
/obj/machinery/atmospherics/pipe/smart/manifold4w/scrubbers/hidden/layer2,
/turf/open/misc/ashplanet/wateryrock/biodome,
/area/station/maintenance/aft/upper)
"p" = (
/obj/structure/flora/rock/pile/jungle/style_random,
/turf/open/water/jungle/biodome,
/area/station/maintenance/aft/upper)
"y" = (
/mob/living/basic/axolotl,
/obj/machinery/atmospherics/components/unary/vent_pump/on/layer4,
/turf/open/misc/ashplanet/wateryrock/biodome,
/area/station/maintenance/aft/upper)
"D" = (
/turf/open/water/jungle/biodome,
/area/station/maintenance/aft/upper)
"J" = (
/obj/machinery/atmospherics/pipe/smart/manifold4w/supply/hidden/layer4,
/turf/open/misc/ashplanet/wateryrock/biodome,
/area/station/maintenance/aft/upper)
"P" = (
/obj/machinery/light/warm/directional/south,
/obj/machinery/atmospherics/pipe/smart/manifold4w/scrubbers/hidden/layer2,
/turf/open/misc/ashplanet/wateryrock/biodome,
/area/station/maintenance/aft/upper)
"X" = (
/obj/machinery/atmospherics/components/unary/vent_scrubber/on/layer2,
/turf/open/misc/ashplanet/wateryrock/biodome,
/area/station/maintenance/aft/upper)

(1,1,1) = {"
X
n
P
"}
(2,1,1) = {"
p
D
i
"}
(3,1,1) = {"
D
a
J
"}
(4,1,1) = {"
y
f
J
"}
