//MAP CONVERTED BY dmm2tgm.py THIS HEADER COMMENT PREVENTS RECONVERSION, DO NOT REMOVE
"a" = (
/obj/machinery/atmospherics/pipe/smart/manifold4w/supply/hidden/layer4,
/obj/structure/fake_eggs,
/turf/open/floor/plating,
/area/station/maintenance/aft/upper)
"e" = (
/obj/machinery/atmospherics/components/unary/vent_pump/on/layer4,
/turf/open/floor/plating,
/area/station/maintenance/aft/upper)
"f" = (
/obj/machinery/atmospherics/pipe/smart/manifold4w/scrubbers/hidden/layer2,
/obj/machinery/atmospherics/pipe/smart/manifold4w/supply/hidden/layer4,
/obj/modular_map_connector,
/turf/open/floor/plating,
/area/station/maintenance/aft/upper)
"i" = (
/obj/machinery/atmospherics/pipe/smart/manifold4w/scrubbers/hidden/layer2,
/obj/machinery/light/warm/directional/south,
/obj/structure/fake_eggs,
/turf/open/floor/plating,
/area/station/maintenance/aft/upper)
"j" = (
/mob/living/basic/giant_spider/maintenance,
/turf/open/floor/plating,
/area/station/maintenance/aft/upper)
"y" = (
/obj/machinery/atmospherics/components/unary/vent_scrubber/on/layer2,
/turf/open/floor/plating,
/area/station/maintenance/aft/upper)
"B" = (
/obj/machinery/atmospherics/pipe/smart/manifold4w/supply/hidden/layer4,
/obj/structure/spider/cocoon,
/turf/open/floor/plating,
/area/station/maintenance/aft/upper)
"I" = (
/turf/open/floor/plating,
/area/station/maintenance/aft/upper)
"M" = (
/obj/machinery/atmospherics/pipe/smart/manifold4w/supply/hidden/layer4,
/mob/living/basic/giant_spider/maintenance,
/turf/open/floor/plating,
/area/station/maintenance/aft/upper)
"O" = (
/obj/machinery/atmospherics/pipe/smart/manifold4w/scrubbers/hidden/layer2,
/mob/living/basic/giant_spider/maintenance,
/turf/open/floor/plating,
/area/station/maintenance/aft/upper)
"X" = (
/obj/structure/spider/cocoon,
/turf/open/floor/plating,
/area/station/maintenance/aft/upper)

(1,1,1) = {"
y
O
i
"}
(2,1,1) = {"
X
I
f
"}
(3,1,1) = {"
j
I
M
"}
(4,1,1) = {"
e
a
B
"}
