//MAP CONVERTED BY dmm2tgm.py THIS HEADER COMMENT PREVENTS RECONVERSION, DO NOT REMOVE
"a" = (
/obj/machinery/atmospherics/pipe/smart/manifold4w/scrubbers/hidden/layer2,
/obj/machinery/atmospherics/pipe/smart/manifold4w/supply/hidden/layer4,
/turf/open/floor/material/meat,
/area/station/maintenance/aft/upper)
"c" = (
/obj/machinery/atmospherics/components/unary/vent_pump/on/layer4,
/turf/open/floor/material/meat,
/area/station/maintenance/aft/upper)
"g" = (
/obj/machinery/atmospherics/pipe/smart/manifold4w/supply/hidden/layer4,
/turf/open/floor/material/meat,
/area/station/maintenance/aft/upper)
"p" = (
/obj/machinery/atmospherics/pipe/smart/manifold4w/scrubbers/hidden/layer2,
/turf/open/floor/material/meat,
/area/station/maintenance/aft/upper)
"w" = (
/mob/living/basic/slime/random,
/turf/open/floor/material/meat,
/area/station/maintenance/aft/upper)
"x" = (
/obj/machinery/atmospherics/components/unary/vent_scrubber/on/layer2,
/turf/open/floor/material/meat,
/area/station/maintenance/aft/upper)
"z" = (
/mob/living/carbon/human/species/monkey,
/turf/open/floor/material/meat,
/area/station/maintenance/aft/upper)
"E" = (
/obj/machinery/atmospherics/pipe/smart/manifold4w/scrubbers/hidden/layer2,
/obj/machinery/light/cold/directional/south,
/turf/open/floor/material/meat,
/area/station/maintenance/aft/upper)
"T" = (
/turf/open/floor/material/meat,
/area/station/maintenance/aft/upper)
"Z" = (
/mob/living/basic/slime,
/turf/open/floor/material/meat,
/area/station/maintenance/aft/upper)

(1,1,1) = {"
x
p
E
"}
(2,1,1) = {"
w
z
a
"}
(3,1,1) = {"
T
Z
g
"}
(4,1,1) = {"
c
g
g
"}
