//MAP CONVERTED BY dmm2tgm.py THIS HEADER COMMENT PREVENTS RECONVERSION, DO NOT REMOVE
"a" = (
/obj/effect/spawner/structure/window/hollow/survival_pod,
/turf/open/floor/plating,
/area/station/maintenance/aft/upper)
"g" = (
/obj/machinery/door/airlock/external/glass,
/turf/open/floor/plating,
/area/station/maintenance/aft/upper)
"h" = (
/mob/living/basic/amoung/pequeno,
/obj/machinery/atmospherics/components/unary/vent_scrubber/on/layer2,
/turf/open/floor/iron/textured,
/area/station/maintenance/aft/upper)
"m" = (
/obj/machinery/atmospherics/pipe/smart/manifold4w/scrubbers/hidden/layer2,
/obj/machinery/atmospherics/pipe/smart/manifold4w/supply/hidden/layer4,
/obj/modular_map_connector,
/turf/open/floor/iron/textured,
/area/station/maintenance/aft/upper)
"n" = (
/obj/machinery/atmospherics/pipe/smart/manifold4w/supply/hidden/layer4,
/obj/effect/spawner/structure/window/hollow/survival_pod,
/turf/open/floor/plating,
/area/station/maintenance/aft/upper)
"u" = (
/obj/machinery/atmospherics/pipe/smart/manifold4w/supply/hidden/layer4,
/turf/open/floor/fakespace,
/area/station/maintenance/aft/upper)
"v" = (
/obj/machinery/light/warm/directional/south,
/obj/machinery/atmospherics/pipe/smart/manifold4w/scrubbers/hidden/layer2,
/turf/open/floor/iron/textured,
/area/station/maintenance/aft/upper)
"E" = (
/mob/living/basic/amoung,
/turf/open/floor/iron/textured,
/area/station/maintenance/aft/upper)
"F" = (
/obj/machinery/atmospherics/pipe/smart/manifold4w/scrubbers/hidden/layer2,
/turf/open/floor/iron/textured,
/area/station/maintenance/aft/upper)
"S" = (
/mob/living/basic/amoung,
/obj/machinery/atmospherics/components/unary/vent_pump/on/layer4,
/turf/open/floor/fakespace,
/area/station/maintenance/aft/upper)
"W" = (
/obj/item/toy/redbutton,
/turf/open/floor/iron/textured,
/area/station/maintenance/aft/upper)

(1,1,1) = {"
h
F
v
"}
(2,1,1) = {"
W
E
m
"}
(3,1,1) = {"
a
g
n
"}
(4,1,1) = {"
S
u
u
"}
