//MAP CONVERTED BY dmm2tgm.py THIS HEADER COMMENT PREVENTS RECONVERSION, DO NOT REMOVE
"a" = (
/obj/machinery/light/warm/directional/south,
/obj/machinery/atmospherics/pipe/smart/manifold4w/scrubbers/hidden/layer2,
/turf/open/floor/plating,
/area/station/maintenance/aft/upper)
"d" = (
/obj/structure/platform/pizza,
/mob/living/basic/mouse/white,
/turf/open/floor/plating,
/area/station/maintenance/aft/upper)
"i" = (
/mob/living/basic/regal_rat/controlled,
/turf/open/floor/plating,
/area/station/maintenance/aft/upper)
"j" = (
/obj/machinery/atmospherics/pipe/smart/manifold4w/scrubbers/hidden/layer2,
/obj/machinery/atmospherics/pipe/smart/manifold4w/supply/hidden/layer4,
/obj/modular_map_connector,
/turf/open/floor/plating,
/area/station/maintenance/aft/upper)
"k" = (
/obj/machinery/atmospherics/components/unary/vent_pump/on/layer4,
/mob/living/basic/mouse/brown,
/turf/open/floor/plating,
/area/station/maintenance/aft/upper)
"n" = (
/obj/machinery/atmospherics/pipe/smart/manifold4w/supply/hidden/layer4,
/turf/open/floor/plating,
/area/station/maintenance/aft/upper)
"q" = (
/obj/machinery/atmospherics/components/unary/vent_scrubber/on/layer2,
/mob/living/basic/mouse,
/turf/open/floor/plating,
/area/station/maintenance/aft/upper)
"H" = (
/turf/open/floor/plating,
/area/station/maintenance/aft/upper)
"N" = (
/obj/machinery/atmospherics/pipe/smart/manifold4w/supply/hidden/layer4,
/mob/living/basic/mouse/rat,
/turf/open/floor/plating,
/area/station/maintenance/aft/upper)
"T" = (
/obj/machinery/atmospherics/pipe/smart/manifold4w/scrubbers/hidden/layer2,
/mob/living/basic/mouse/rat,
/turf/open/floor/plating,
/area/station/maintenance/aft/upper)

(1,1,1) = {"
q
T
a
"}
(2,1,1) = {"
H
d
j
"}
(3,1,1) = {"
i
H
N
"}
(4,1,1) = {"
k
n
n
"}
