//MAP CONVERTED BY dmm2tgm.py THIS HEADER COMMENT PREVENTS RECONVERSION, DO NOT REMOVE
"a" = (
/mob/living/basic/ghost,
/turf/open/floor/cult,
/area/station/maintenance/aft/upper)
"c" = (
/obj/machinery/light/warm/directional/south,
/obj/machinery/atmospherics/pipe/smart/manifold4w/scrubbers/hidden/layer2,
/obj/effect/decal/remains/human,
/turf/open/floor/cult,
/area/station/maintenance/aft/upper)
"e" = (
/obj/machinery/atmospherics/components/unary/vent_pump/on/layer4,
/obj/effect/mapping_helpers/broken_floor,
/turf/open/floor/cult,
/area/station/maintenance/aft/upper)
"u" = (
/obj/machinery/atmospherics/components/unary/vent_scrubber/on/layer2,
/turf/open/floor/cult,
/area/station/maintenance/aft/upper)
"A" = (
/turf/open/floor/cult,
/area/station/maintenance/aft/upper)
"D" = (
/obj/machinery/atmospherics/pipe/smart/manifold4w/supply/hidden/layer4,
/obj/effect/decal/remains/human,
/turf/open/floor/cult,
/area/station/maintenance/aft/upper)
"H" = (
/obj/machinery/atmospherics/pipe/smart/manifold4w/supply/hidden/layer4,
/obj/effect/mapping_helpers/broken_floor,
/turf/open/floor/cult,
/area/station/maintenance/aft/upper)
"J" = (
/obj/effect/mapping_helpers/broken_floor,
/turf/open/floor/cult,
/area/station/maintenance/aft/upper)
"M" = (
/obj/effect/decal/cleanable/grand_remains,
/obj/effect/decal/cleanable/ash/large,
/mob/living/basic/ghost,
/turf/open/floor/cult,
/area/station/maintenance/aft/upper)
"V" = (
/obj/machinery/atmospherics/pipe/smart/manifold4w/scrubbers/hidden/layer2,
/obj/machinery/atmospherics/pipe/smart/manifold4w/supply/hidden/layer4,
/obj/modular_map_connector,
/turf/open/floor/cult,
/area/station/maintenance/aft/upper)
"W" = (
/obj/machinery/atmospherics/pipe/smart/manifold4w/scrubbers/hidden/layer2,
/obj/effect/mapping_helpers/broken_floor,
/turf/open/floor/cult,
/area/station/maintenance/aft/upper)

(1,1,1) = {"
u
W
c
"}
(2,1,1) = {"
A
M
V
"}
(3,1,1) = {"
J
a
H
"}
(4,1,1) = {"
e
D
H
"}
