//MAP CONVERTED BY dmm2tgm.py THIS HEADER COMMENT PREVENTS RECONVERSION, DO NOT REMOVE
"a" = (
/turf/open/floor/circuit,
/area/station/maintenance/aft/upper)
"c" = (
/obj/machinery/light/warm/directional/south,
/obj/machinery/atmospherics/pipe/smart/manifold4w/scrubbers/hidden/layer2,
/turf/open/floor/circuit,
/area/station/maintenance/aft/upper)
"e" = (
/obj/machinery/atmospherics/components/unary/vent_pump/on/layer4,
/mob/living/basic/bot/vibebot,
/turf/open/floor/circuit,
/area/station/maintenance/aft/upper)
"u" = (
/obj/machinery/atmospherics/components/unary/vent_scrubber/on/layer2,
/turf/open/floor/circuit,
/area/station/maintenance/aft/upper)
"A" = (
/turf/open/floor/bronze/filled,
/area/station/maintenance/aft/upper)
"D" = (
/obj/machinery/atmospherics/pipe/smart/manifold4w/supply/hidden/layer4,
/turf/open/floor/bronze/filled,
/area/station/maintenance/aft/upper)
"H" = (
/obj/machinery/atmospherics/pipe/smart/manifold4w/supply/hidden/layer4,
/obj/machinery/light/warm/directional/south,
/turf/open/floor/circuit,
/area/station/maintenance/aft/upper)
"M" = (
/mob/living/simple_animal/bot/secbot/grievous/toy,
/turf/open/floor/circuit,
/area/station/maintenance/aft/upper)
"V" = (
/obj/machinery/atmospherics/pipe/smart/manifold4w/scrubbers/hidden/layer2,
/obj/machinery/atmospherics/pipe/smart/manifold4w/supply/hidden/layer4,
/obj/modular_map_connector,
/turf/open/floor/bronze/filled,
/area/station/maintenance/aft/upper)
"W" = (
/obj/machinery/atmospherics/pipe/smart/manifold4w/scrubbers/hidden/layer2,
/turf/open/floor/bronze/filled,
/area/station/maintenance/aft/upper)

(1,1,1) = {"
u
W
c
"}
(2,1,1) = {"
A
M
V
"}
(3,1,1) = {"
A
a
D
"}
(4,1,1) = {"
e
D
H
"}
