//MAP CONVERTED BY dmm2tgm.py THIS HEADER COMMENT PREVENTS RECONVERSION, DO NOT REMOVE
"a" = (
/obj/effect/turf_decal/siding/thinplating_new/terracotta{
	dir = 1
	},
/turf/open/floor/asphalt,
/area/misc/condo)
"b" = (
/obj/effect/decal/cleanable/dirt,
/turf/open/floor/asphalt,
/area/misc/condo)
"e" = (
/obj/structure/sign/poster/official/report_crimes/directional/north,
/obj/effect/decal/cleanable/dirt,
/turf/open/floor/iron/textured_large,
/area/misc/condo)
"f" = (
/turf/closed/indestructible/iron,
/area/misc/condo)
"g" = (
/turf/closed/indestructible/hoteldoor/fakedoor{
	dir = 4
	},
/area/misc/condo)
"j" = (
/obj/effect/decal/cleanable/dirt,
/turf/open/misc/asteroid/moon,
/area/misc/condo)
"k" = (
/obj/effect/decal/cleanable/dirt/dust,
/turf/open/misc/asteroid/moon,
/area/misc/condo)
"l" = (
/obj/effect/light_emitter/fake_outdoors,
/turf/open/floor/asphalt,
/area/misc/condo)
"o" = (
/obj/structure/sign/poster/official/walk/directional/north,
/obj/effect/decal/cleanable/dirt,
/turf/open/floor/iron/textured_large,
/area/misc/condo)
"p" = (
/obj/structure/fence,
/obj/effect/decal/cleanable/dirt,
/turf/open/misc/asteroid/moon,
/area/misc/condo)
"q" = (
/obj/effect/turf_decal/siding/thinplating_new/terracotta{
	dir = 1
	},
/obj/effect/decal/cleanable/dirt,
/turf/open/floor/asphalt,
/area/misc/condo)
"r" = (
/turf/open/misc/asteroid/moon,
/area/misc/condo)
"s" = (
/obj/effect/planetary_turf_atmos_helper,
/turf/closed/indestructible/iron,
/area/misc/condo)
"x" = (
/obj/structure/closet/crate/trashcart,
/obj/effect/decal/cleanable/dirt/dust,
/turf/open/misc/asteroid/moon,
/area/misc/condo)
"A" = (
/turf/open/floor/iron/textured_large,
/area/misc/condo)
"B" = (
/turf/open/floor/asphalt,
/area/misc/condo)
"E" = (
/obj/effect/turf_decal/siding/thinplating_new,
/obj/structure/fence{
	dir = 4
	},
/obj/effect/decal/cleanable/dirt/dust,
/turf/open/misc/asteroid/moon,
/area/misc/condo)
"H" = (
/obj/structure/fence/end,
/turf/open/misc/asteroid/moon,
/area/misc/condo)
"J" = (
/obj/effect/turf_decal/trimline/white/line,
/turf/open/floor/asphalt,
/area/misc/condo)
"K" = (
/turf/closed/indestructible/hoteldoor/fakedoor,
/area/misc/condo)
"N" = (
/obj/effect/turf_decal/siding/thinplating_new,
/obj/structure/fence{
	dir = 4
	},
/turf/open/misc/asteroid/moon,
/area/misc/condo)
"Q" = (
/obj/effect/turf_decal/siding/thinplating_new,
/obj/structure/fence/door/opened,
/obj/effect/decal/cleanable/dirt,
/turf/open/misc/asteroid/moon,
/area/misc/condo)
"T" = (
/obj/structure/closet/crate/preopen,
/obj/effect/decal/cleanable/dirt,
/turf/open/misc/asteroid/moon,
/area/misc/condo)
"X" = (
/obj/effect/turf_decal/siding/thinplating_new/terracotta{
	dir = 1
	},
/obj/effect/turf_decal/trimline/white/line,
/turf/open/floor/asphalt,
/area/misc/condo)

(1,1,1) = {"
f
f
f
f
f
f
f
f
s
A
X
J
"}
(2,1,1) = {"
f
f
f
f
f
f
g
f
f
e
X
J
"}
(3,1,1) = {"
K
r
k
r
k
k
r
j
N
A
q
B
"}
(4,1,1) = {"
f
p
H
j
r
r
k
k
Q
A
a
B
"}
(5,1,1) = {"
f
T
r
k
k
j
r
x
E
A
a
b
"}
(6,1,1) = {"
f
f
f
f
f
g
f
f
f
A
a
B
"}
(7,1,1) = {"
f
f
f
f
f
f
f
f
f
o
a
l
"}
