//MAP CONVERTED BY dmm2tgm.py THIS HEADER COMMENT PREVENTS RECONVERSION, DO NOT REMOVE
"ar" = (
/obj/structure/table/wood/poker,
/obj/item/storage/fancy/donut_box{
	pixel_y = 5
	},
/turf/open/floor/carpet,
/area/misc/condo)
"aC" = (
/obj/structure/sign/painting/library,
/turf/closed/indestructible/steel,
/area/misc/condo)
"aS" = (
/obj/machinery/greenscreen_camera{
	dir = 4;
	is_operational = 0;
	name = "camera";
	desc = "A cam-corder. You dread to imagine what's on the tape labelled 'Ren'."
	},
/turf/open/floor/plating,
/area/misc/condo)
"bw" = (
/obj/machinery/light_switch/directional/north,
/obj/effect/turf_decal/siding/wideplating_new/light{
	dir = 8
	},
/obj/structure/table/reinforced,
/obj/machinery/microwave{
	pixel_x = -2;
	pixel_y = 6
	},
/turf/open/floor/mineral/titanium/tiled/white,
/area/misc/condo)
"bz" = (
/obj/effect/turf_decal/siding/wood/corner,
/obj/structure/table/wood,
/obj/item/pizzabox/margherita{
	pixel_y = 11
	},
/turf/open/floor/wood/parquet,
/area/misc/condo)
"cy" = (
/obj/machinery/light_switch/directional/north{
	pixel_x = 18
	},
/obj/structure/showcase{
	name = "doorphone";
	icon = 'modular_skyrat/modules/aesthetics/intercom/icons/intercom.dmi';
	icon_state = "intercom";
	pixel_y = 24;
	density = 0
	},
/turf/open/floor/carpet/lone,
/area/misc/condo)
"cz" = (
/obj/effect/turf_decal/siding/wood{
	dir = 4
	},
/turf/open/floor/wood/tile,
/area/misc/condo)
"cD" = (
/obj/effect/turf_decal/siding/wood{
	dir = 1
	},
/obj/structure/sign/painting/large/library{
	dir = 1
	},
/turf/open/floor/wood/tile,
/area/misc/condo)
"dw" = (
/obj/item/kitchen/spoon,
/obj/item/kitchen/spoon,
/obj/item/kitchen/spoon,
/obj/item/kitchen/spoon,
/obj/item/kitchen/fork,
/obj/item/kitchen/fork,
/obj/item/kitchen/fork,
/obj/item/kitchen/fork,
/obj/effect/spawner/random/food_or_drink/three_course_meal,
/obj/effect/spawner/random/food_or_drink/three_course_meal,
/obj/effect/spawner/random/food_or_drink/three_course_meal,
/obj/effect/spawner/random/food_or_drink/three_course_meal,
/obj/effect/spawner/random/food_or_drink/three_course_meal,
/obj/effect/spawner/random/food_or_drink/three_course_meal,
/obj/effect/spawner/random/food_or_drink/three_course_meal,
/obj/item/plate,
/obj/item/plate,
/obj/item/plate,
/obj/item/plate,
/obj/item/storage/cans/sixbeer,
/obj/item/reagent_containers/cup/glass/drinkingglass,
/obj/item/reagent_containers/cup/glass/drinkingglass,
/obj/item/reagent_containers/cup/glass/drinkingglass,
/obj/item/reagent_containers/cup/glass/drinkingglass,
/obj/item/storage/fancy/pickles_jar,
/obj/structure/closet/secure_closet/freezer/kitchen/mining{
	storage_capacity = 60
	},
/obj/effect/spawner/random/food_or_drink/donkpockets,
/turf/open/floor/iron/kitchen,
/area/misc/condo)
"dS" = (
/obj/effect/turf_decal/siding/wood{
	dir = 8
	},
/obj/structure/aquarium/prefilled,
/turf/open/floor/wood/tile,
/area/misc/condo)
"dT" = (
/obj/structure/chair/stool/bar/directional/west,
/turf/open/floor/wood/tile,
/area/misc/condo)
"eO" = (
/obj/structure/bookcase/random,
/obj/effect/turf_decal/siding/wood{
	dir = 1
	},
/turf/open/floor/wood/parquet,
/area/misc/condo)
"fa" = (
/obj/structure/railing{
	dir = 8
	},
/obj/structure/sign/poster/random/directional/north,
/obj/effect/spawner/liquids_spawner,
/turf/open/floor/iron/pool/cobble/corner{
	dir = 1
	},
/area/misc/condo)
"fi" = (
/obj/structure/chair,
/obj/structure/extinguisher_cabinet/directional/north,
/turf/open/floor/iron/kitchen,
/area/misc/condo)
"gQ" = (
/obj/structure/chair/sofa/corp/corner,
/obj/machinery/light/warm/directional/east,
/turf/open/floor/carpet,
/area/misc/condo)
"ho" = (
/obj/effect/spawner/liquids_spawner,
/turf/open/floor/iron/pool/cobble/corner{
	dir = 4
	},
/area/misc/condo)
"ik" = (
/obj/structure/closet/secure_closet/wall{
	pixel_y = -32
	},
/obj/effect/turf_decal/tile/neutral/diagonal_edge,
/obj/structure/sink/directional/east,
/obj/structure/mirror/directional/west,
/obj/effect/turf_decal/siding/white{
	dir = 4
	},
/turf/open/floor/iron/freezer,
/area/misc/condo)
"iL" = (
/obj/effect/turf_decal/siding/wood,
/turf/open/floor/wood/tile,
/area/misc/condo)
"jr" = (
/obj/machinery/light_switch/directional/south,
/turf/open/floor/carpet/donk,
/area/misc/condo)
"jx" = (
/obj/structure/chair/office{
	dir = 4
	},
/obj/effect/turf_decal/siding/wood{
	dir = 10
	},
/turf/open/floor/wood/parquet,
/area/misc/condo)
"jT" = (
/obj/item/kirbyplants/random,
/turf/open/floor/iron/kitchen,
/area/misc/condo)
"kh" = (
/obj/structure/mirror/directional/north,
/obj/effect/turf_decal/siding/wood{
	dir = 1
	},
/turf/open/floor/wood/large,
/area/misc/condo)
"kD" = (
/obj/effect/turf_decal/siding/wood/corner,
/turf/open/floor/wood/tile,
/area/misc/condo)
"kS" = (
/obj/structure/table/wood/poker,
/obj/item/toy/cards/deck,
/turf/open/floor/carpet,
/area/misc/condo)
"kW" = (
/obj/structure/flora/bush/grassy/style_random,
/obj/structure/flora/bush/flowers_br/style_3,
/obj/structure/window{
	dir = 8
	},
/turf/open/floor/grass,
/area/misc/condo)
"lU" = (
/turf/open/floor/carpet/royalblue,
/area/misc/condo)
"md" = (
/obj/structure/table/wood,
/obj/item/flashlight/lamp/green{
	pixel_x = 5;
	pixel_y = 14
	},
/obj/structure/sign/poster/random/directional/east,
/obj/effect/turf_decal/siding/wood{
	dir = 5
	},
/turf/open/floor/wood/parquet,
/area/misc/condo)
"oZ" = (
/turf/closed/indestructible/steel,
/area/misc/condo)
"pm" = (
/obj/structure/table/wood,
/obj/effect/turf_decal/siding/wood{
	dir = 9
	},
/obj/structure/bedsheetbin,
/obj/item/serviette_pack,
/turf/open/floor/wood/parquet,
/area/misc/condo)
"pD" = (
/obj/machinery/light/warm/directional/north,
/turf/open/floor/carpet/royalblue,
/area/misc/condo)
"st" = (
/obj/machinery/door/morgue,
/turf/open/floor/wood/parquet,
/area/misc/condo)
"tZ" = (
/obj/structure/sink/kitchen/directional/west,
/turf/open/floor/iron/kitchen,
/area/misc/condo)
"uX" = (
/obj/structure/chair/sofa/corp/left{
	dir = 8
	},
/turf/open/floor/carpet,
/area/misc/condo)
"wb" = (
/obj/structure/closet/cabinet,
/obj/effect/turf_decal/siding/wood{
	dir = 10
	},
/turf/open/floor/wood/parquet,
/area/misc/condo)
"wl" = (
/obj/structure/curtain/cloth,
/turf/open/floor/iron/kitchen,
/area/misc/condo)
"wu" = (
/turf/open/floor/wood/tile,
/area/misc/condo)
"wS" = (
/obj/structure/closet/cabinet,
/obj/machinery/light/dim/directional/north,
/obj/effect/turf_decal/siding/wood{
	dir = 1
	},
/turf/open/floor/wood/parquet,
/area/misc/condo)
"xQ" = (
/turf/open/floor/plating,
/area/misc/condo)
"xT" = (
/turf/closed/wall,
/area/misc/condo)
"zA" = (
/obj/machinery/computer/security/telescreen/entertainment/directional/east,
/obj/effect/turf_decal/siding/wood{
	dir = 6
	},
/obj/machinery/jukebox{
	req_access = null
	},
/turf/open/floor/wood/parquet,
/area/misc/condo)
"zY" = (
/obj/item/kirbyplants/random,
/obj/effect/turf_decal/siding/wood,
/turf/open/floor/wood/large,
/area/misc/condo)
"Ae" = (
/obj/machinery/door/morgue,
/turf/open/floor/iron/freezer,
/area/misc/condo)
"AE" = (
/obj/item/kirbyplants/random,
/obj/effect/turf_decal/siding/wood{
	dir = 9
	},
/turf/open/floor/wood/tile,
/area/misc/condo)
"BR" = (
/obj/structure/chair/comfy/brown{
	dir = 4
	},
/turf/open/floor/carpet,
/area/misc/condo)
"Ch" = (
/obj/effect/spawner/surgery_tray/full,
/turf/open/floor/plating,
/area/misc/condo)
"Dc" = (
/obj/item/kirbyplants/random,
/obj/structure/sign/poster/random/directional/north,
/turf/open/floor/iron/kitchen,
/area/misc/condo)
"DR" = (
/obj/effect/turf_decal/siding/wood/corner{
	dir = 8
	},
/obj/effect/turf_decal/siding/wood/corner{
	dir = 1
	},
/turf/open/floor/wood/tile,
/area/misc/condo)
"DX" = (
/obj/machinery/computer{
	dir = 8
	},
/turf/open/floor/carpet/donk,
/area/misc/condo)
"Ea" = (
/obj/structure/chair/stool/bar/directional/north,
/turf/open/floor/wood/tile,
/area/misc/condo)
"EX" = (
/obj/structure/table,
/obj/item/food/vendor_tray_meal/ramen,
/obj/machinery/computer/security/telescreen/entertainment/directional/west,
/turf/open/floor/iron/kitchen,
/area/misc/condo)
"Fl" = (
/obj/structure/table,
/obj/effect/spawner/random/food_or_drink/three_course_meal,
/turf/open/floor/iron/kitchen,
/area/misc/condo)
"FN" = (
/turf/open/space/bluespace,
/area/misc/condo)
"Gv" = (
/obj/structure/chair/sofa/corp/right,
/obj/structure/sign/poster/random/directional/north,
/turf/open/floor/carpet,
/area/misc/condo)
"HO" = (
/obj/structure/railing/corner{
	dir = 1
	},
/obj/effect/spawner/liquids_spawner,
/obj/machinery/light/dim/directional/south,
/turf/open/floor/iron/pool/cobble/corner{
	dir = 8
	},
/area/misc/condo)
"Ib" = (
/obj/item/toy/plush/skyrat/chunko/inessa,
/turf/open/floor/carpet,
/area/misc/condo)
"Ix" = (
/obj/structure/bed/double,
/obj/effect/spawner/random/bedsheet/double,
/obj/effect/turf_decal/siding/wood{
	dir = 4
	},
/turf/open/floor/wood/parquet,
/area/misc/condo)
"Je" = (
/obj/structure/dresser,
/obj/machinery/computer/security/telescreen/entertainment/directional/north,
/obj/effect/turf_decal/siding/wood{
	dir = 1
	},
/turf/open/floor/wood/parquet,
/area/misc/condo)
"JW" = (
/obj/item/kirbyplants/random,
/obj/effect/turf_decal/siding/wood/corner,
/obj/effect/turf_decal/siding/wood{
	dir = 10
	},
/turf/open/floor/wood/tile,
/area/misc/condo)
"LC" = (
/obj/effect/turf_decal/siding/wood{
	dir = 1
	},
/obj/structure/closet/mini_fridge{
	density = 0;
	pixel_y = 8
	},
/obj/item/storage/cans/sixbeer,
/turf/open/floor/wood/tile,
/area/misc/condo)
"LW" = (
/obj/item/screwdriver/power,
/turf/open/floor/plating,
/area/misc/condo)
"Mj" = (
/turf/open/floor/carpet/donk,
/area/misc/condo)
"Mk" = (
/obj/machinery/light_switch/directional/north,
/obj/structure/curtain,
/obj/machinery/shower/directional/east{
	pixel_x = -10
	},
/obj/item/soap/deluxe,
/turf/open/floor/iron/freezer,
/area/misc/condo)
"Mp" = (
/obj/structure/bed/dogbed,
/obj/effect/turf_decal/siding/wood{
	dir = 6
	},
/turf/open/floor/wood/parquet,
/area/misc/condo)
"MO" = (
/obj/structure/chair{
	dir = 8
	},
/turf/open/floor/iron/kitchen,
/area/misc/condo)
"Oh" = (
/obj/structure/sign/poster/random/directional/south,
/obj/machinery/vending/wallmed/directional/west,
/obj/structure/table,
/obj/structure/towel_bin,
/turf/open/floor/iron/freezer,
/area/misc/condo)
"Ok" = (
/obj/item/clothing/suit/jacket/miljacket,
/obj/item/clothing/mask/bandana/skull/black{
	pixel_y = 7;
	pixel_x = 2
	},
/turf/open/floor/plating,
/area/misc/condo)
"Py" = (
/obj/structure/table/reinforced,
/obj/machinery/light/cold/directional/east,
/obj/effect/turf_decal/siding/wideplating_new/light{
	dir = 10
	},
/obj/item/kitchen/rollingpin{
	pixel_x = -3
	},
/obj/item/knife/kitchen,
/turf/open/floor/mineral/titanium/tiled/white,
/area/misc/condo)
"PK" = (
/obj/structure/sign/poster/random/directional/south,
/turf/open/floor/iron/kitchen,
/area/misc/condo)
"QJ" = (
/obj/structure/table/wood/poker,
/obj/structure/noticeboard{
	dir = 4;
	pixel_x = -64;
	pixel_y = -32
	},
/turf/open/floor/carpet,
/area/misc/condo)
"Rr" = (
/obj/structure/chair{
	dir = 1
	},
/turf/open/floor/iron/kitchen,
/area/misc/condo)
"RF" = (
/obj/effect/spawner/liquids_spawner,
/turf/open/floor/iron/pool/cobble/corner,
/area/misc/condo)
"RM" = (
/obj/structure/flora/bush/large/style_random,
/obj/structure/flora/bush/lavendergrass/style_random,
/obj/structure/window{
	dir = 8
	},
/obj/structure/window{
	dir = 1
	},
/turf/open/floor/grass,
/area/misc/condo)
"RP" = (
/turf/open/floor/carpet,
/area/misc/condo)
"SS" = (
/turf/closed/indestructible/hoteldoor{
	icon_state = "door_closed";
	icon = 'icons/obj/doors/puzzledoor/default.dmi'
	},
/area/misc/condo)
"SV" = (
/obj/structure/chair{
	dir = 1
	},
/obj/machinery/light/cold/directional/west,
/turf/open/floor/iron/kitchen,
/area/misc/condo)
"Tj" = (
/obj/machinery/light/warm/directional/west,
/obj/effect/turf_decal/siding/wood{
	dir = 8
	},
/turf/open/floor/wood/tile,
/area/misc/condo)
"Tu" = (
/obj/structure/toilet{
	dir = 8
	},
/obj/machinery/light/small/directional/east,
/turf/open/floor/iron/freezer,
/area/misc/condo)
"TY" = (
/obj/structure/falsewall,
/turf/open/floor/plating,
/area/misc/condo)
"Ul" = (
/obj/structure/curtain,
/turf/open/floor/iron/freezer,
/area/misc/condo)
"UQ" = (
/obj/structure/chair/stool/bar/directional/south,
/obj/structure/sign/poster/random/directional/north,
/obj/effect/turf_decal/siding/wood{
	dir = 1
	},
/turf/open/floor/wood/tile,
/area/misc/condo)
"UU" = (
/obj/effect/turf_decal/siding/wood{
	dir = 8
	},
/obj/structure/decorative/shelf,
/obj/machinery/light_switch/directional/west,
/turf/open/floor/wood/tile,
/area/misc/condo)
"Wh" = (
/turf/open/floor/iron/freezer,
/area/misc/condo)
"Wt" = (
/obj/structure/closet/secure_closet/wall{
	pixel_y = 32
	},
/obj/effect/turf_decal/tile/neutral/diagonal_edge,
/obj/effect/turf_decal/siding/white{
	dir = 4
	},
/turf/open/floor/iron/freezer,
/area/misc/condo)
"WI" = (
/turf/open/floor/iron/kitchen,
/area/misc/condo)
"WJ" = (
/obj/effect/gibspawner/human,
/obj/structure/table/optable,
/obj/machinery/light/red/dim/directional/south,
/turf/open/floor/plating,
/area/misc/condo)
"WN" = (
/obj/structure/sign/painting/library,
/turf/closed/wall,
/area/misc/condo)
"WX" = (
/obj/effect/turf_decal/siding/wood{
	dir = 8
	},
/turf/open/floor/wood/parquet,
/area/misc/condo)
"YW" = (
/obj/effect/turf_decal/siding/wood{
	dir = 4
	},
/obj/effect/turf_decal/siding/wood/corner{
	dir = 8
	},
/turf/open/floor/wood/tile,
/area/misc/condo)
"Zq" = (
/obj/effect/turf_decal/siding/wideplating_new/light{
	dir = 9
	},
/obj/structure/closet/crate/bin,
/turf/open/floor/mineral/titanium/tiled/white,
/area/misc/condo)

(1,1,1) = {"
FN
FN
FN
FN
FN
FN
FN
FN
FN
FN
FN
FN
FN
FN
FN
"}
(2,1,1) = {"
FN
oZ
oZ
aC
oZ
oZ
SS
oZ
oZ
oZ
oZ
oZ
oZ
oZ
FN
"}
(3,1,1) = {"
FN
oZ
pm
WX
jx
xT
cy
wb
xT
Dc
EX
SV
jT
oZ
FN
"}
(4,1,1) = {"
FN
oZ
eO
Mj
DX
xT
kh
zY
xT
fi
Fl
Rr
PK
oZ
FN
"}
(5,1,1) = {"
FN
oZ
wS
Mj
Mj
st
lU
lU
wl
WI
MO
WI
WI
oZ
FN
"}
(6,1,1) = {"
FN
oZ
Je
Mj
jr
xT
pD
lU
wl
WI
WI
WI
dw
oZ
FN
"}
(7,1,1) = {"
FN
oZ
md
Ix
Mp
xT
lU
lU
xT
bw
Py
tZ
Zq
oZ
FN
"}
(8,1,1) = {"
FN
oZ
xT
xT
xT
xT
st
xT
xT
xT
xT
xT
xT
oZ
FN
"}
(9,1,1) = {"
FN
oZ
AE
ar
BR
Tj
DR
UU
dS
JW
xT
Mk
Oh
oZ
FN
"}
(10,1,1) = {"
FN
oZ
UQ
QJ
kS
Ea
kD
cz
cz
YW
Ae
Wh
Tu
oZ
FN
"}
(11,1,1) = {"
FN
oZ
cD
dT
dT
wu
iL
xT
xT
xT
xT
Ul
xT
oZ
FN
"}
(12,1,1) = {"
FN
oZ
LC
wu
wu
RP
RP
WN
LW
aS
xT
Wt
ik
oZ
FN
"}
(13,1,1) = {"
FN
oZ
Gv
RP
bz
Ib
RP
TY
xQ
WJ
xT
fa
HO
oZ
FN
"}
(14,1,1) = {"
FN
oZ
gQ
uX
zA
RM
kW
xT
Ok
Ch
xT
RF
ho
oZ
FN
"}
(15,1,1) = {"
FN
oZ
oZ
aC
oZ
oZ
oZ
oZ
oZ
oZ
oZ
oZ
oZ
oZ
FN
"}
(16,1,1) = {"
FN
FN
FN
FN
FN
FN
FN
FN
FN
FN
FN
FN
FN
FN
FN
"}
