//MAP CONVERTED BY dmm2tgm.py THIS HEADER COMMENT PREVENTS RECONVERSION, DO NOT REMOVE
"br" = (
/turf/open/misc/beach/sand,
/area/misc/condo)
"bI" = (
/obj/effect/turf_decal/siding/wood{
	dir = 10
	},
/turf/open/floor/wood/large,
/area/misc/condo)
"bO" = (
/obj/structure/chair{
	dir = 4
	},
/obj/effect/turf_decal/siding/wood{
	dir = 9
	},
/turf/open/floor/wood/parquet,
/area/misc/condo)
"bW" = (
/obj/structure/table/reinforced,
/obj/effect/turf_decal/siding/white{
	dir = 1
	},
/obj/item/knife/kitchen,
/turf/open/floor/iron/kitchen,
/area/misc/condo)
"cj" = (
/obj/effect/light_emitter/interlink,
/obj/item/toy/plush/carpplushie,
/turf/open/water/beach,
/area/misc/condo)
"ct" = (
/turf/closed/wall/mineral/wood,
/area/misc/condo)
"cC" = (
/obj/structure/dresser,
/obj/effect/turf_decal/siding/wood{
	dir = 9
	},
/turf/open/floor/wood/large,
/area/misc/condo)
"cW" = (
/turf/open/misc/beach/coast{
	dir = 4
	},
/area/misc/condo)
"dI" = (
/obj/effect/light_emitter/interlink,
/turf/open/misc/beach/coast{
	dir = 5
	},
/area/misc/condo)
"dS" = (
/turf/open/floor/wood/large,
/area/misc/condo)
"en" = (
/obj/effect/light_emitter/interlink,
/turf/open/water/beach,
/area/misc/condo)
"eH" = (
/obj/effect/light_emitter/interlink,
/turf/open/misc/beach/coast{
	dir = 1
	},
/area/misc/condo)
"fy" = (
/obj/effect/turf_decal/siding/wood{
	dir = 8
	},
/obj/machinery/light/warm/directional/west,
/turf/open/floor/wood/parquet,
/area/misc/condo)
"fA" = (
/turf/closed/wall/mineral/sandstone,
/area/misc/condo)
"hj" = (
/obj/machinery/door/morgue,
/turf/open/floor/wood,
/area/misc/condo)
"hX" = (
/obj/structure/fluff/beach_umbrella,
/obj/effect/light_emitter/interlink,
/turf/open/misc/beach/coast{
	dir = 1
	},
/area/misc/condo)
"ib" = (
/turf/open/misc/beach/coast/corner{
	dir = 8
	},
/area/misc/condo)
"iQ" = (
/obj/effect/light_emitter/interlink,
/turf/open/misc/beach/coast{
	dir = 9
	},
/area/misc/condo)
"jO" = (
/obj/effect/turf_decal/siding{
	dir = 4
	},
/obj/machinery/door/morgue,
/turf/open/indestructible/bathroom,
/area/misc/condo)
"jU" = (
/obj/machinery/door/airlock/wood,
/turf/open/floor/wood,
/area/misc/condo)
"kh" = (
/obj/effect/turf_decal/siding/wood{
	dir = 4
	},
/turf/open/floor/wood/parquet,
/area/misc/condo)
"kW" = (
/obj/structure/closet/crate/bin,
/obj/effect/turf_decal/siding/wood{
	dir = 10
	},
/obj/machinery/light_switch/directional/west,
/turf/open/floor/wood/parquet,
/area/misc/condo)
"mH" = (
/obj/machinery/jukebox{
	req_access = null
	},
/turf/open/misc/beach/sand,
/area/misc/condo)
"na" = (
/obj/effect/turf_decal/siding/wood,
/turf/open/floor/carpet/lone,
/area/misc/condo)
"nb" = (
/obj/item/kirbyplants/random,
/obj/effect/turf_decal/siding/wood{
	dir = 10
	},
/turf/open/floor/wood,
/area/misc/condo)
"ny" = (
/obj/effect/turf_decal/siding/wood/corner{
	dir = 1
	},
/turf/open/floor/wood/large,
/area/misc/condo)
"oM" = (
/obj/structure/bed/double/pod,
/obj/effect/turf_decal/siding/wood{
	dir = 1
	},
/obj/effect/spawner/random/bedsheet/double,
/turf/open/floor/wood/large,
/area/misc/condo)
"oX" = (
/obj/effect/turf_decal/siding/wood/corner,
/turf/open/floor/wood/parquet,
/area/misc/condo)
"ph" = (
/obj/effect/light_emitter/interlink,
/turf/open/misc/beach/sand,
/area/misc/condo)
"qh" = (
/obj/effect/turf_decal/siding/wood{
	dir = 8
	},
/turf/open/floor/wood/parquet,
/area/misc/condo)
"ra" = (
/turf/closed/indestructible/rock,
/area/misc/condo)
"rm" = (
/turf/open/floor/iron/stairs/old{
	dir = 1
	},
/area/misc/condo)
"rV" = (
/obj/structure/closet/cabinet,
/obj/effect/turf_decal/siding/wood/end{
	dir = 8
	},
/turf/open/floor/wood/large,
/area/misc/condo)
"tR" = (
/obj/machinery/shower/directional/east,
/obj/structure/drain/big,
/obj/item/soap/deluxe,
/obj/structure/curtain,
/turf/open/indestructible/bathroom,
/area/misc/condo)
"wa" = (
/obj/structure/chair{
	dir = 4
	},
/obj/effect/turf_decal/siding/wood{
	dir = 8
	},
/turf/open/floor/wood/parquet,
/area/misc/condo)
"wo" = (
/obj/structure/closet/secure_closet/freezer/kitchen/all_access,
/obj/effect/spawner/random/food_or_drink/three_course_meal,
/obj/effect/spawner/random/food_or_drink/three_course_meal,
/obj/effect/spawner/random/food_or_drink/three_course_meal,
/obj/effect/spawner/random/food_or_drink/three_course_meal,
/obj/effect/turf_decal/siding/wood{
	dir = 6
	},
/turf/open/floor/wood/parquet,
/area/misc/condo)
"wL" = (
/obj/item/kirbyplants/random,
/obj/effect/turf_decal/siding/wood{
	dir = 6
	},
/turf/open/floor/wood,
/area/misc/condo)
"yc" = (
/obj/effect/turf_decal/siding/wood{
	dir = 9
	},
/obj/structure/sign/painting/large/library{
	dir = 1
	},
/turf/open/floor/wood,
/area/misc/condo)
"yH" = (
/turf/closed/indestructible/hoteldoor{
	icon_state = "door_closed";
	icon = 'icons/obj/doors/puzzledoor/default.dmi'
	},
/area/misc/condo)
"Bo" = (
/obj/structure/table/reinforced,
/obj/machinery/microwave{
	pixel_x = -2;
	pixel_y = 6
	},
/turf/open/floor/iron/kitchen,
/area/misc/condo)
"Bs" = (
/obj/effect/turf_decal/siding/wood,
/turf/open/floor/wood,
/area/misc/condo)
"CM" = (
/obj/effect/turf_decal/siding/wood{
	dir = 9
	},
/obj/structure/bed/dogbed,
/obj/item/toy/plush/shark,
/turf/open/floor/wood/large,
/area/misc/condo)
"Dg" = (
/obj/structure/toilet{
	dir = 4
	},
/obj/structure/window/spawner/directional/north,
/turf/open/indestructible/bathroom,
/area/misc/condo)
"EI" = (
/obj/effect/turf_decal/siding/wood{
	dir = 1
	},
/obj/machinery/light/warm/directional/north,
/turf/open/floor/wood,
/area/misc/condo)
"FJ" = (
/obj/effect/turf_decal/siding/wood{
	dir = 5
	},
/obj/item/kirbyplants/random,
/turf/open/floor/wood/parquet,
/area/misc/condo)
"FN" = (
/obj/machinery/door/airlock/sandstone{
	name = "Beach Cabin"
	},
/obj/effect/turf_decal/sand,
/turf/open/floor/wood,
/area/misc/condo)
"Gj" = (
/obj/item/toy/beach_ball,
/obj/effect/light_emitter/interlink,
/turf/open/water/beach,
/area/misc/condo)
"Gm" = (
/obj/structure/chair/sofa/middle{
	dir = 1
	},
/obj/effect/turf_decal/sand,
/turf/open/misc/beach/sand,
/area/misc/condo)
"GB" = (
/obj/structure/chair{
	dir = 8
	},
/obj/effect/turf_decal/siding/wood/corner{
	dir = 4
	},
/turf/open/floor/wood/parquet,
/area/misc/condo)
"GD" = (
/obj/effect/turf_decal/siding/white{
	dir = 9
	},
/obj/machinery/light/floor{
	alpha = 0;
	invisibility = 100;
	light_range = 10;
	nightshift_light_power = 10
	},
/turf/open/floor/iron/kitchen,
/area/misc/condo)
"HH" = (
/turf/open/floor/carpet/cyan,
/area/misc/condo)
"HK" = (
/obj/structure/table/wood,
/turf/open/floor/wood/parquet,
/area/misc/condo)
"Ib" = (
/turf/open/misc/beach/coast{
	dir = 1
	},
/area/misc/condo)
"Ig" = (
/obj/effect/turf_decal/siding/wood,
/turf/open/floor/wood/large,
/area/misc/condo)
"IM" = (
/obj/effect/turf_decal/siding/wood{
	dir = 5
	},
/obj/item/flashlight/lamp/green{
	pixel_x = 5;
	pixel_y = 14
	},
/obj/structure/table/wood,
/turf/open/floor/wood/large,
/area/misc/condo)
"Jm" = (
/obj/structure/table/wood,
/obj/effect/turf_decal/siding/wood{
	dir = 1
	},
/obj/item/pizzabox/margherita{
	pixel_y = 11
	},
/obj/item/storage/cans/sixbeer,
/turf/open/floor/wood/parquet,
/area/misc/condo)
"KQ" = (
/obj/effect/turf_decal/siding/wood{
	dir = 1
	},
/turf/open/floor/wood,
/area/misc/condo)
"Lg" = (
/obj/effect/turf_decal/siding/wood,
/turf/open/floor/wood/parquet,
/area/misc/condo)
"Lp" = (
/obj/effect/light_emitter/interlink,
/turf/open/misc/beach/coast/corner{
	dir = 8
	},
/area/misc/condo)
"Lv" = (
/obj/structure/sink/directional/north,
/obj/structure/mirror/directional/south,
/turf/open/indestructible/bathroom,
/area/misc/condo)
"LF" = (
/obj/effect/turf_decal/siding/wood{
	dir = 5
	},
/obj/machinery/light_switch/directional/north,
/turf/open/floor/wood,
/area/misc/condo)
"MB" = (
/obj/effect/turf_decal/siding/white{
	dir = 8
	},
/turf/open/floor/iron/kitchen,
/area/misc/condo)
"ML" = (
/obj/effect/turf_decal/siding/wood/end{
	dir = 4
	},
/obj/machinery/light/floor,
/obj/machinery/light_switch/directional/south,
/turf/open/floor/wood/large,
/area/misc/condo)
"MP" = (
/obj/structure/chair{
	dir = 8
	},
/obj/effect/turf_decal/siding/wood{
	dir = 5
	},
/turf/open/floor/wood/parquet,
/area/misc/condo)
"Pe" = (
/obj/structure/chair/sofa/left{
	dir = 1
	},
/obj/effect/turf_decal/sand,
/turf/open/misc/beach/sand,
/area/misc/condo)
"PJ" = (
/turf/open/misc/beach/coast/corner{
	dir = 4
	},
/area/misc/condo)
"Qg" = (
/obj/structure/chair/sofa/right{
	dir = 1
	},
/obj/effect/turf_decal/sand,
/turf/open/misc/beach/sand,
/area/misc/condo)
"Qz" = (
/obj/effect/turf_decal/siding/wood{
	dir = 6
	},
/turf/open/floor/wood/parquet,
/area/misc/condo)
"QG" = (
/obj/structure/curtain/cloth/fancy,
/turf/closed/indestructible/fakeglass,
/area/misc/condo)
"Rr" = (
/obj/machinery/light/floor{
	alpha = 0;
	invisibility = 100;
	light_range = 10;
	nightshift_light_power = 10
	},
/turf/open/indestructible/bathroom,
/area/misc/condo)
"RL" = (
/obj/effect/turf_decal/siding/wood{
	dir = 4
	},
/obj/structure/chair/comfy/teal{
	dir = 8
	},
/obj/machinery/light_switch/directional/east,
/turf/open/floor/wood/large,
/area/misc/condo)
"SS" = (
/obj/effect/light_emitter/interlink,
/turf/open/misc/beach/coast/corner{
	dir = 4
	},
/area/misc/condo)
"Yg" = (
/obj/effect/turf_decal/siding/wood{
	dir = 6
	},
/obj/structure/closet/cabinet,
/obj/item/hairbrush{
	pixel_x = 2;
	pixel_y = 3
	},
/obj/item/serviette_pack,
/turf/open/floor/wood/large,
/area/misc/condo)
"ZE" = (
/obj/effect/turf_decal/siding/wood,
/obj/machinery/light/warm/dim/directional/south,
/turf/open/floor/wood/large,
/area/misc/condo)

(1,1,1) = {"
ra
ra
ra
ra
ra
ra
ra
ra
ra
ra
ra
ra
ra
ra
ra
"}
(2,1,1) = {"
ra
en
en
en
en
dI
Lp
br
fA
fA
fA
fA
fA
fA
ra
"}
(3,1,1) = {"
ra
en
cj
en
en
iQ
SS
br
fA
rV
ct
tR
Dg
fA
ra
"}
(4,1,1) = {"
ra
en
en
en
en
eH
br
rm
FN
ML
ct
Rr
Lv
fA
ra
"}
(5,1,1) = {"
ra
en
en
en
iQ
SS
br
fA
fA
hj
ct
jO
ct
fA
ra
"}
(6,1,1) = {"
ra
en
en
en
eH
br
fA
fA
cC
bI
ct
yc
nb
fA
ra
"}
(7,1,1) = {"
ra
en
en
iQ
PJ
br
QG
CM
ny
ZE
ct
EI
na
yH
ra
"}
(8,1,1) = {"
ra
en
en
hX
HH
HH
QG
oM
dS
Ig
jU
KQ
Bs
fA
ra
"}
(9,1,1) = {"
ra
en
en
dI
cW
ib
QG
IM
RL
Yg
ct
LF
wL
fA
ra
"}
(10,1,1) = {"
ra
en
en
en
en
Ib
fA
fA
ct
ct
ct
hj
ct
fA
ra
"}
(11,1,1) = {"
ra
en
en
en
en
Ib
Pe
QG
bO
wa
fy
qh
kW
fA
ra
"}
(12,1,1) = {"
ra
en
en
en
en
eH
Gm
QG
Jm
HK
oX
kh
Qz
fA
ra
"}
(13,1,1) = {"
ra
en
Gj
en
en
eH
Qg
QG
MP
GB
Lg
GD
MB
fA
ra
"}
(14,1,1) = {"
ra
en
en
en
iQ
SS
mH
fA
fA
FJ
wo
bW
Bo
fA
ra
"}
(15,1,1) = {"
ra
en
en
iQ
SS
ph
ph
br
fA
fA
fA
fA
fA
fA
ra
"}
(16,1,1) = {"
ra
ra
ra
ra
ra
ra
ra
ra
ra
ra
ra
ra
ra
ra
ra
"}
