//MAP CONVERTED BY dmm2tgm.py THIS HEADER COMMENT PREVENTS RECONVERSION, DO NOT REMOVE
"a" = (
/obj/structure/bed/double,
/obj/item/bedsheet/purple/double,
/obj/machinery/light_switch/directional/east,
/turf/open/floor/carpet/purple,
/area/misc/condo)
"d" = (
/obj/effect/turf_decal/siding/wood{
	dir = 8
	},
/turf/open/floor/carpet/purple,
/area/misc/condo)
"e" = (
/obj/structure/curtain/cloth,
/obj/structure/drain,
/obj/machinery/shower/directional/south,
/turf/open/floor/iron/freezer,
/area/misc/condo)
"f" = (
/obj/effect/spawner/structure/window,
/turf/open/floor/plating,
/area/misc/condo)
"h" = (
/turf/open/floor/wood,
/area/misc/condo)
"i" = (
/obj/structure/fluff/fake_scrubber,
/obj/structure/closet/secure_closet/freezer/fridge/open,
/turf/open/floor/wood,
/area/misc/condo)
"j" = (
/obj/structure/fluff/fake_vent,
/obj/structure/chair/comfy/brown{
	color = "#A46106";
	dir = 8
	},
/turf/open/floor/wood,
/area/misc/condo)
"l" = (
/obj/structure/dresser,
/obj/machinery/digital_clock/directional/north,
/turf/open/floor/carpet/purple,
/area/misc/condo)
"m" = (
/obj/structure/flora/grass/jungle,
/obj/structure/flora/bush/flowers_pp,
/obj/structure/window/spawner/directional/north,
/turf/open/floor/grass,
/area/misc/condo)
"o" = (
/obj/effect/turf_decal/tile/neutral/half/contrasted,
/obj/effect/turf_decal/trimline/dark/filled/line{
	dir = 1
	},
/obj/effect/turf_decal/trimline/dark/filled/mid_joiner{
	dir = 1
	},
/turf/open/floor/iron,
/area/misc/condo)
"q" = (
/obj/structure/table,
/obj/machinery/microwave/engineering/cell_included{
	pixel_y = 8
	},
/turf/open/floor/wood,
/area/misc/condo)
"r" = (
/obj/effect/planetary_turf_atmos_helper,
/turf/closed/indestructible/normal_wall,
/area/misc/condo)
"s" = (
/obj/effect/turf_decal/tile/neutral/half/contrasted{
	dir = 4
	},
/obj/effect/turf_decal/trimline/dark/filled/line{
	dir = 10
	},
/obj/effect/turf_decal/trimline/dark/filled/mid_joiner,
/obj/effect/turf_decal/trimline/dark/filled/mid_joiner{
	dir = 8
	},
/turf/open/floor/iron,
/area/misc/condo)
"t" = (
/obj/structure/flora/bush/fullgrass,
/obj/structure/flora/bush/sunny,
/obj/structure/window/spawner/directional/north,
/turf/open/floor/grass,
/area/misc/condo)
"v" = (
/obj/structure/flora/grass/jungle,
/obj/structure/flora/bush/grassy,
/obj/structure/flora/bush/generic,
/obj/structure/flora/bush/flowers_pp,
/obj/structure/window/spawner/directional/north,
/turf/open/floor/grass,
/area/misc/condo)
"w" = (
/obj/effect/turf_decal/siding/wood{
	dir = 8
	},
/obj/structure/window/spawner/directional/west,
/obj/structure/bed/pillow_large,
/turf/open/floor/carpet/purple,
/area/misc/condo)
"y" = (
/obj/effect/turf_decal/siding/wood{
	dir = 8
	},
/obj/structure/closet/secure_closet/personal/cabinet,
/obj/structure/window/spawner/directional/west,
/turf/open/floor/carpet/purple,
/area/misc/condo)
"B" = (
/obj/effect/turf_decal/tile/neutral/anticorner/contrasted,
/obj/effect/turf_decal/trimline/dark/filled/line{
	dir = 1
	},
/obj/effect/turf_decal/trimline/dark/filled/mid_joiner{
	dir = 1
	},
/turf/open/floor/iron,
/area/misc/condo)
"C" = (
/obj/structure/closet/crate/bin,
/turf/open/floor/wood,
/area/misc/condo)
"F" = (
/obj/effect/turf_decal/tile/neutral/half/contrasted{
	dir = 4
	},
/obj/machinery/light/built/directional/east,
/obj/effect/turf_decal/trimline/dark/filled/line{
	dir = 8
	},
/obj/effect/turf_decal/trimline/dark/filled/mid_joiner{
	dir = 8
	},
/turf/open/floor/iron,
/area/misc/condo)
"G" = (
/obj/structure/curtain/bounty,
/turf/closed/indestructible/fakeglass,
/area/misc/condo)
"H" = (
/obj/structure/toilet{
	dir = 1
	},
/obj/machinery/light/small/directional/east{
	pixel_y = 11
	},
/obj/structure/sink/directional/west,
/obj/structure/mirror/directional/east,
/turf/open/floor/iron/freezer,
/area/misc/condo)
"I" = (
/obj/structure/table,
/obj/machinery/light/directional/south,
/turf/open/floor/wood,
/area/misc/condo)
"J" = (
/obj/effect/turf_decal/tile/neutral/half/contrasted,
/obj/effect/turf_decal/trimline/dark/filled/line{
	dir = 1
	},
/obj/effect/turf_decal/trimline/dark/filled/mid_joiner{
	dir = 1
	},
/obj/effect/turf_decal/trimline/dark/filled/mid_joiner{
	dir = 1
	},
/turf/open/floor/iron,
/area/misc/condo)
"K" = (
/turf/cordon,
/area/misc/condo)
"L" = (
/obj/effect/turf_decal/tile/neutral/half/contrasted{
	dir = 4
	},
/obj/effect/turf_decal/trimline/dark/filled/line{
	dir = 8
	},
/obj/effect/turf_decal/trimline/dark/filled/mid_joiner{
	dir = 8
	},
/turf/open/floor/iron,
/area/misc/condo)
"N" = (
/obj/structure/table/wood,
/turf/open/floor/wood,
/area/misc/condo)
"O" = (
/turf/open/floor/carpet/purple,
/area/misc/condo)
"P" = (
/turf/open/floor/iron/freezer,
/area/misc/condo)
"S" = (
/obj/machinery/door/airlock/bathroom{
	name = "Restroom"
	},
/turf/open/floor/carpet/purple,
/area/misc/condo)
"T" = (
/turf/closed/indestructible/hoteldoor/fakedoor,
/area/misc/condo)
"W" = (
/turf/closed/indestructible/normal_wall,
/area/misc/condo)
"Z" = (
/obj/effect/turf_decal/tile/neutral,
/obj/effect/turf_decal/trimline/dark/filled/line{
	dir = 9
	},
/obj/effect/turf_decal/trimline/dark/filled/mid_joiner{
	dir = 1
	},
/obj/effect/turf_decal/trimline/dark/filled/mid_joiner{
	dir = 8
	},
/turf/open/floor/iron,
/area/misc/condo)

(1,1,1) = {"
Z
L
F
L
s
K
K
"}
(2,1,1) = {"
J
W
W
G
T
W
r
"}
(3,1,1) = {"
J
m
G
C
h
q
W
"}
(4,1,1) = {"
o
v
G
N
h
I
W
"}
(5,1,1) = {"
B
t
G
j
h
i
W
"}
(6,1,1) = {"
f
W
W
y
d
w
W
"}
(7,1,1) = {"
K
K
W
l
O
a
W
"}
(8,1,1) = {"
K
K
W
W
S
W
W
"}
(9,1,1) = {"
K
K
W
e
P
H
W
"}
(10,1,1) = {"
K
K
W
W
W
W
W
"}
