//MAP CONVERTED BY dmm2tgm.py THIS HEADER COMMENT PREVENTS RECONVERSION, DO NOT REMOVE
"as" = (
/turf/open/floor/wood,
/area/misc/condo)
"eK" = (
/obj/structure/flora/rock/pile/jungle/style_4,
/turf/open/floor/grass,
/area/misc/condo)
"fh" = (
/obj/machinery/light/warm/dim/directional/east,
/turf/open/floor/wood/tile,
/area/misc/condo)
"hm" = (
/turf/open/floor/wood/tile,
/area/misc/condo)
"iN" = (
/obj/effect/turf_decal/weather/dirt,
/obj/structure/flora/tree/jungle/style_5,
/turf/open/floor/grass,
/area/misc/condo)
"jH" = (
/obj/structure/sign/painting/library{
	pixel_x = -32
	},
/turf/open/floor/wood,
/area/misc/condo)
"jK" = (
/obj/structure/bookcase/random,
/turf/open/floor/carpet/red,
/area/misc/condo)
"jW" = (
/obj/structure/flora/tree/jungle/style_2,
/turf/open/floor/grass,
/area/misc/condo)
"kO" = (
/obj/effect/turf_decal/weather/dirt,
/obj/structure/flora/tree/jungle/style_4,
/turf/open/floor/grass,
/area/misc/condo)
"mO" = (
/obj/structure/flora/rock/pile/jungle/style_3,
/turf/open/floor/grass,
/area/misc/condo)
"mS" = (
/obj/effect/turf_decal/siding/wood{
	dir = 5
	},
/obj/structure/closet/crate/bin{
	pixel_x = -4;
	pixel_y = 8
	},
/turf/open/floor/stone,
/area/misc/condo)
"nC" = (
/obj/effect/turf_decal/weather/dirt{
	dir = 9
	},
/turf/open/floor/grass,
/area/misc/condo)
"nZ" = (
/obj/effect/turf_decal/weather/dirt,
/obj/structure/flora/bush/jungle/b,
/turf/open/floor/grass,
/area/misc/condo)
"oD" = (
/obj/structure/flora/rock/pile/jungle/style_5,
/obj/effect/turf_decal/weather/dirt{
	dir = 4
	},
/turf/open/floor/grass,
/area/misc/condo)
"oK" = (
/obj/structure/chair/comfy/beige,
/turf/open/floor/carpet/red,
/area/misc/condo)
"pn" = (
/obj/structure/chair/sofa/left/maroon{
	dir = 8
	},
/turf/open/floor/wood,
/area/misc/condo)
"po" = (
/obj/effect/turf_decal/weather/dirt{
	dir = 6
	},
/obj/effect/turf_decal/weather/dirt{
	dir = 1
	},
/turf/open/floor/grass,
/area/misc/condo)
"qY" = (
/obj/machinery/light_switch/directional/south,
/turf/open/floor/iron/showroomfloor,
/area/misc/condo)
"vq" = (
/obj/structure/table/wood,
/obj/effect/spawner/random/food_or_drink/three_course_meal{
	pixel_x = 2;
	pixel_y = 5
	},
/turf/open/floor/carpet/green,
/area/misc/condo)
"wW" = (
/obj/effect/turf_decal/weather/dirt{
	dir = 1
	},
/turf/open/floor/grass,
/area/misc/condo)
"xl" = (
/turf/open/misc/dirt/station,
/area/misc/condo)
"xZ" = (
/obj/structure/flora/bush/ferny/style_3,
/turf/open/floor/grass,
/area/misc/condo)
"yG" = (
/obj/machinery/door/airlock/wood/glass,
/obj/structure/fans/tiny/invisible,
/turf/open/floor/wood/tile,
/area/misc/condo)
"yW" = (
/obj/structure/closet/cabinet,
/turf/open/floor/wood/tile,
/area/misc/condo)
"zG" = (
/obj/effect/turf_decal/siding/wood,
/obj/structure/closet/crate/freezer,
/obj/item/food/meat/rawcutlet,
/obj/item/food/meat/rawcutlet,
/obj/item/food/meat/rawcutlet,
/obj/item/food/meat/slab,
/obj/item/food/meat/slab,
/obj/item/food/meat/slab,
/obj/item/food/meat/slab/chicken,
/obj/item/food/meat/slab/chicken,
/obj/item/food/meat/slab/chicken,
/turf/open/floor/stone,
/area/misc/condo)
"BO" = (
/turf/open/water/hot_spring/cafe,
/area/misc/condo)
"Cx" = (
/obj/structure/flora/bush/jungle/c,
/turf/open/floor/grass,
/area/misc/condo)
"CQ" = (
/obj/effect/turf_decal/weather/dirt,
/obj/structure/chair/sofa/bench/left,
/turf/open/floor/grass,
/area/misc/condo)
"Dp" = (
/turf/closed/indestructible/hoteldoor/fakedoor,
/area/misc/condo)
"DO" = (
/obj/structure/flora/rock/pile/jungle/style_3,
/obj/effect/turf_decal/weather/dirt{
	dir = 5
	},
/turf/open/floor/grass,
/area/misc/condo)
"Fi" = (
/obj/structure/flora/tree/jungle/style_6,
/turf/open/floor/grass,
/area/misc/condo)
"FQ" = (
/obj/effect/turf_decal/weather/dirt,
/obj/structure/chair/sofa/bench/right,
/turf/open/floor/grass,
/area/misc/condo)
"Hr" = (
/obj/effect/turf_decal/weather/dirt{
	dir = 9
	},
/obj/structure/flora/rock/pile/jungle,
/turf/open/floor/grass,
/area/misc/condo)
"Hv" = (
/obj/structure/table/wood,
/obj/item/storage/box/matches{
	pixel_x = -8;
	pixel_y = 4
	},
/obj/item/stack/sheet/mineral/wood/fifty{
	pixel_x = 7;
	pixel_y = 3
	},
/turf/open/floor/carpet/green,
/area/misc/condo)
"HA" = (
/obj/effect/turf_decal/siding/wood{
	dir = 6
	},
/obj/structure/fireplace{
	dir = 4
	},
/turf/open/floor/stone,
/area/misc/condo)
"Jf" = (
/obj/structure/window/green_glass_pane,
/obj/structure/curtain/cloth/fancy,
/turf/open/floor/wood/tile,
/area/misc/condo)
"KB" = (
/obj/effect/turf_decal/weather/dirt{
	dir = 5
	},
/turf/open/floor/grass,
/area/misc/condo)
"KT" = (
/obj/effect/turf_decal/weather/dirt{
	dir = 6
	},
/obj/structure/flora/rock/pile/jungle/style_3,
/turf/open/floor/grass,
/area/misc/condo)
"Li" = (
/obj/structure/chair/sofa/corner/maroon,
/obj/structure/sign/painting/library{
	pixel_x = 32;
	pixel_y = 0
	},
/turf/open/floor/wood,
/area/misc/condo)
"Lr" = (
/obj/structure/flora/rock/pile/jungle/style_2,
/turf/open/floor/grass,
/area/misc/condo)
"LM" = (
/obj/machinery/door/airlock/wood,
/obj/structure/fans/tiny/invisible,
/turf/open/floor/wood/tile,
/area/misc/condo)
"LP" = (
/turf/open/floor/carpet/red,
/area/misc/condo)
"Me" = (
/obj/item/kirbyplants/random,
/turf/open/floor/wood/tile,
/area/misc/condo)
"Mq" = (
/obj/effect/decal/remains/human,
/turf/open/misc/dirt/station,
/area/misc/condo)
"MB" = (
/obj/machinery/shower/directional/south,
/obj/structure/drain,
/obj/structure/curtain,
/turf/open/floor/iron/showroomfloor,
/area/misc/condo)
"NB" = (
/obj/structure/sign/painting/library{
	pixel_x = -32
	},
/turf/open/floor/wood/tile,
/area/misc/condo)
"OJ" = (
/obj/structure/dresser,
/obj/structure/sign/painting/library{
	pixel_x = 32;
	pixel_y = 0
	},
/turf/open/floor/wood/tile,
/area/misc/condo)
"Pd" = (
/obj/machinery/light/warm/dim/directional/south,
/obj/structure/sign/painting/large/library{
	pixel_x = 0;
	pixel_y = -34
	},
/obj/structure/table/wood,
/obj/structure/towel_bin,
/turf/open/floor/wood/tile,
/area/misc/condo)
"PB" = (
/turf/closed/indestructible/rock,
/area/misc/condo)
"Qr" = (
/obj/structure/bed/double/pod,
/obj/effect/spawner/random/bedsheet/any/double,
/turf/open/floor/wood/tile,
/area/misc/condo)
"QH" = (
/obj/machinery/grill,
/obj/effect/turf_decal/siding/wood{
	dir = 6
	},
/turf/open/floor/stone,
/area/misc/condo)
"RE" = (
/obj/machinery/door/airlock/wood,
/turf/open/floor/wood/tile,
/area/misc/condo)
"Sq" = (
/obj/structure/flora/tree/jungle/style_4,
/obj/effect/turf_decal/weather/dirt{
	dir = 6
	},
/turf/open/floor/grass,
/area/misc/condo)
"SQ" = (
/obj/effect/turf_decal/weather/dirt{
	dir = 4
	},
/turf/open/floor/grass,
/area/misc/condo)
"SS" = (
/turf/open/floor/carpet/green,
/area/misc/condo)
"Tb" = (
/obj/structure/toilet,
/obj/machinery/light/small/directional/north,
/obj/structure/sign/painting/large/library{
	dir = 1
	},
/obj/effect/turf_decal/siding/wideplating{
	dir = 4
	},
/turf/open/floor/iron/showroomfloor,
/area/misc/condo)
"To" = (
/obj/effect/turf_decal/siding/wood{
	dir = 10
	},
/obj/machinery/light/small/dim/directional/north,
/obj/item/reagent_containers/cup/bottle/welding_fuel{
	pixel_x = 7;
	pixel_y = 3
	},
/obj/structure/table/wood,
/obj/item/flashlight/lantern/on{
	pixel_x = -8;
	pixel_y = 8
	},
/turf/open/floor/stone,
/area/misc/condo)
"TN" = (
/turf/open/floor/grass,
/area/misc/condo)
"Uc" = (
/obj/effect/turf_decal/weather/dirt{
	dir = 6
	},
/turf/open/floor/grass,
/area/misc/condo)
"Un" = (
/obj/structure/mirror/directional/south,
/obj/effect/turf_decal/siding/wideplating{
	dir = 4
	},
/turf/open/floor/iron/showroomfloor,
/area/misc/condo)
"Uq" = (
/obj/structure/chair/sofa/right/maroon,
/obj/machinery/light_switch/directional/north,
/turf/open/floor/wood,
/area/misc/condo)
"VW" = (
/obj/machinery/light/warm/dim/directional/east,
/obj/structure/chair/sofa/middle/maroon{
	dir = 8
	},
/turf/open/floor/wood,
/area/misc/condo)
"Xi" = (
/turf/closed/wall/mineral/wood,
/area/misc/condo)
"Yv" = (
/obj/structure/flora/bush/ferny/style_2,
/turf/open/floor/grass,
/area/misc/condo)
"Zj" = (
/obj/effect/turf_decal/weather/dirt,
/turf/open/floor/grass,
/area/misc/condo)
"ZD" = (
/obj/machinery/light_switch/directional/west,
/turf/open/floor/carpet/red,
/area/misc/condo)

(1,1,1) = {"
PB
PB
PB
PB
PB
PB
PB
PB
PB
PB
PB
PB
PB
PB
PB
"}
(2,1,1) = {"
PB
PB
eK
Cx
oD
Xi
Xi
Xi
Xi
Xi
Xi
Xi
DO
SQ
PB
"}
(3,1,1) = {"
PB
TN
TN
Sq
xl
LM
NB
as
mS
HA
jH
yG
xl
xl
Dp
"}
(4,1,1) = {"
PB
TN
Zj
xl
xl
Jf
Me
as
SS
SS
as
Xi
To
nC
PB
"}
(5,1,1) = {"
PB
TN
nZ
xl
Hr
Xi
Xi
Uq
vq
Hv
as
Jf
zG
wW
PB
"}
(6,1,1) = {"
PB
TN
kO
xl
wW
TN
Jf
Li
VW
pn
as
Xi
QH
KB
PB
"}
(7,1,1) = {"
PB
mO
Zj
xl
wW
TN
Xi
Xi
Xi
Xi
RE
Xi
Jf
Xi
PB
"}
(8,1,1) = {"
PB
mO
FQ
xl
wW
TN
eK
PB
Xi
jK
LP
ZD
yW
Xi
PB
"}
(9,1,1) = {"
PB
Fi
CQ
xl
wW
TN
jW
Lr
Jf
oK
LP
LP
Pd
Xi
PB
"}
(10,1,1) = {"
PB
xZ
Zj
xl
wW
TN
TN
Yv
Xi
OJ
Qr
fh
hm
Xi
PB
"}
(11,1,1) = {"
PB
eK
Zj
xl
wW
PB
PB
PB
Xi
Xi
Xi
Xi
RE
Xi
PB
"}
(12,1,1) = {"
PB
TN
iN
xl
po
xl
xl
PB
PB
PB
Xi
MB
qY
Xi
PB
"}
(13,1,1) = {"
PB
TN
Uc
xl
xl
xl
xl
xl
PB
PB
Xi
Tb
Un
Xi
PB
"}
(14,1,1) = {"
PB
KT
xl
xl
xl
xl
Mq
xl
xl
PB
Xi
BO
BO
Xi
PB
"}
(15,1,1) = {"
PB
xl
xl
xl
xl
xl
xl
xl
xl
PB
Xi
Xi
Xi
Xi
PB
"}
(16,1,1) = {"
PB
PB
PB
PB
PB
PB
PB
PB
PB
PB
PB
PB
PB
PB
PB
"}
