//MAP CONVERTED BY dmm2tgm.py THIS HEADER COMMENT PREVENTS RECONVERSION, DO NOT REMOVE
"ax" = (
/obj/effect/turf_decal/siding/wood{
	dir = 8
	},
/obj/effect/turf_decal/siding/wood{
	dir = 4
	},
/obj/machinery/light/floor,
/turf/open/indestructible/hotelwood,
/area/misc/condo)
"aN" = (
/obj/structure/sign/painting{
	pixel_y = 32
	},
/obj/item/banner/command/mundane,
/obj/effect/turf_decal/tile/neutral/fourcorners,
/obj/machinery/light/directional/north,
/obj/effect/turf_decal/siding/wood{
	dir = 4
	},
/turf/open/indestructible/dark,
/area/misc/condo)
"bA" = (
/obj/structure/window/reinforced/survival_pod/spawner/directional/north,
/obj/structure/showcase/mecha/marauder,
/obj/effect/turf_decal/tile/neutral/full,
/obj/structure/sign/nanotrasen{
	pixel_y = -32
	},
/turf/open/indestructible/dark/smooth_large,
/area/misc/condo)
"ca" = (
/obj/structure/table/wood,
/obj/machinery{
	icon = 'modular_skyrat/modules/aesthetics/intercom/icons/intercom.dmi';
	icon_state = "intercom";
	name = "Intercom";
	pixel_y = -1
	},
/turf/open/indestructible/carpet,
/area/misc/condo)
"dE" = (
/turf/closed/indestructible/fakeglass,
/area/misc/condo)
"dZ" = (
/obj/structure/table/wood,
/obj/item/reagent_containers/cup/glass/bottle/cognac{
	pixel_y = 18;
	pixel_x = -7
	},
/obj/item/reagent_containers/cup/glass/bottle/whiskey{
	pixel_x = 7;
	pixel_y = 16
	},
/obj/item/reagent_containers/cup/glass/flask/gold{
	pixel_x = 5;
	name = "Golden Flask";
	desc = "A gold flask belonging to the one who owns this office."
	},
/turf/open/indestructible/hotelwood,
/area/misc/condo)
"go" = (
/obj/item/kirbyplants/organic/plant22,
/obj/effect/turf_decal/tile/dark_blue/opposingcorners,
/turf/open/indestructible/dark,
/area/misc/condo)
"gK" = (
/obj/item/banner/command/mundane,
/obj/machinery/light_switch/directional/south,
/turf/open/indestructible/dark/smooth_large,
/area/misc/condo)
"hu" = (
/obj/item/banner/command/mundane,
/obj/effect/turf_decal/tile/neutral/fourcorners,
/obj/machinery/light/directional/south,
/obj/structure/secure_safe/directional/south{
	pixel_y = -22
	},
/obj/effect/turf_decal/siding/wood{
	dir = 4
	},
/turf/open/indestructible/dark,
/area/misc/condo)
"hN" = (
/turf/closed/indestructible/hoteldoor/fakedoor,
/area/misc/condo)
"ij" = (
/obj/structure/table/wood,
/obj/effect/turf_decal/tile/neutral/fourcorners,
/obj/machinery/recharger{
	pixel_x = -6;
	pixel_y = 6
	},
/obj/item/flashlight/lamp/green{
	pixel_y = 12;
	pixel_x = 6
	},
/obj/item/cigarette/cigar/havana{
	pixel_x = 5;
	pixel_y = 1
	},
/turf/open/indestructible/dark,
/area/misc/condo)
"jh" = (
/obj/structure/table/wood,
/obj/item/paper_bin{
	pixel_y = 4;
	pixel_x = -4
	},
/obj/item/pen/fountain/captain{
	pixel_y = 4;
	pixel_x = -5;
	name = "Golden Fountain Pen"
	},
/obj/item/book/manual/wiki/security_space_law{
	pixel_y = 3;
	pixel_x = 10
	},
/obj/effect/turf_decal/tile/neutral/fourcorners,
/turf/open/indestructible/dark,
/area/misc/condo)
"ks" = (
/obj/structure/table/wood,
/obj/effect/turf_decal/tile/neutral/fourcorners,
/obj/item/phone{
	desc = "Supposedly a direct line to Nanotrasen Central Command. It's not even plugged in.";
	pixel_x = 19;
	pixel_y = -4
	},
/obj/machinery{
	icon = 'modular_skyrat/modules/aesthetics/intercom/icons/intercom.dmi';
	icon_state = "intercom";
	pixel_x = 1;
	name = "Intercom"
	},
/turf/open/indestructible/dark,
/area/misc/condo)
"kL" = (
/obj/structure/chair/comfy/beige{
	dir = 1
	},
/turf/open/indestructible/carpet,
/area/misc/condo)
"le" = (
/obj/structure/table/wood,
/obj/item/lighter{
	color = "#d4af37";
	desc = "A gold-plated Zippo lighter";
	name = "Golden Lighter";
	pixel_x = 10;
	pixel_y = -15
	},
/obj/item/cigarette/cigar/premium{
	pixel_x = -6
	},
/obj/item/cigarette/cigar/havana{
	pixel_x = 3;
	pixel_y = 1
	},
/obj/item/cigarette/cigar/premium{
	pixel_x = 9;
	pixel_y = -2
	},
/obj/item/reagent_containers/cup/glass/drinkingglass{
	pixel_x = -8;
	pixel_y = 15
	},
/obj/item/reagent_containers/cup/glass/drinkingglass{
	pixel_x = 1;
	pixel_y = 15
	},
/obj/item/reagent_containers/cup/glass/drinkingglass{
	pixel_x = 10;
	pixel_y = 15
	},
/turf/open/indestructible/hotelwood,
/area/misc/condo)
"ng" = (
/obj/effect/turf_decal/siding/wood{
	dir = 4
	},
/obj/effect/turf_decal/siding/wood{
	dir = 8
	},
/obj/machinery/light/floor,
/turf/open/indestructible/hotelwood,
/area/misc/condo)
"nh" = (
/obj/effect/turf_decal/siding/wood{
	dir = 5
	},
/obj/effect/turf_decal/siding/wood/corner{
	dir = 8
	},
/turf/open/indestructible/hotelwood,
/area/misc/condo)
"oO" = (
/obj/effect/turf_decal/tile/neutral/fourcorners,
/obj/effect/turf_decal/siding/wood{
	dir = 1
	},
/turf/open/indestructible/dark,
/area/misc/condo)
"pD" = (
/turf/closed/indestructible/riveted,
/area/misc/condo)
"pO" = (
/turf/open/indestructible/hotelwood,
/area/misc/condo)
"qR" = (
/obj/structure/bookcase{
	icon_state = "book-5"
	},
/turf/open/indestructible/hotelwood,
/area/misc/condo)
"rg" = (
/obj/effect/turf_decal/siding/wood{
	dir = 4
	},
/obj/effect/turf_decal/siding/wood{
	dir = 8
	},
/turf/open/indestructible/hotelwood,
/area/misc/condo)
"rz" = (
/obj/structure/showcase/fakeid{
	dir = 1;
	name = "\improper CentComm Oversight Console";
	desc = "You can use this to watch the watchers."
	},
/turf/open/indestructible/hotelwood,
/area/misc/condo)
"uM" = (
/obj/item/banner/command/mundane,
/obj/structure/extinguisher_cabinet/directional/north,
/turf/open/indestructible/dark/smooth_large,
/area/misc/condo)
"wV" = (
/obj/structure/window/reinforced/survival_pod/spawner/directional/north,
/obj/structure/showcase/perfect_employee,
/obj/effect/turf_decal/tile/neutral/full,
/obj/machinery/light/floor,
/turf/open/indestructible/dark/smooth_large,
/area/misc/condo)
"xF" = (
/obj/effect/turf_decal/tile/neutral/fourcorners,
/obj/effect/turf_decal/siding/wood/corner{
	dir = 8
	},
/obj/item/kirbyplants/organic/plant21,
/obj/structure/sign/poster/official/state_laws/directional/south,
/turf/open/indestructible/dark,
/area/misc/condo)
"yM" = (
/obj/machinery/vending/boozeomat/cafe,
/turf/closed/indestructible/riveted,
/area/misc/condo)
"yX" = (
/obj/structure/table/wood,
/obj/effect/turf_decal/tile/neutral/fourcorners,
/obj/item/stamp{
	pixel_x = -9;
	pixel_y = 11
	},
/obj/item/stamp/denied{
	pixel_y = 7;
	pixel_x = -9
	},
/obj/item/stamp/void{
	pixel_x = -9;
	pixel_y = 3
	},
/obj/item/stamp/centcom{
	pixel_x = -9;
	pixel_y = -1
	},
/turf/open/indestructible/dark,
/area/misc/condo)
"zb" = (
/turf/open/space/basic,
/area/misc/condo)
"AN" = (
/obj/machinery/jukebox{
	icon = 'modular_skyrat/modules/aesthetics/intercom/icons/intercom.dmi';
	icon_state = "intercom";
	pixel_y = -10;
	name = "Enviroment Sound System";
	desc = "It's hip to be square!"
	},
/turf/closed/indestructible/riveted,
/area/misc/condo)
"AU" = (
/obj/structure/table/wood,
/obj/item/documents/nanotrasen{
	pixel_y = 3
	},
/turf/open/indestructible/carpet,
/area/misc/condo)
"Bo" = (
/obj/effect/turf_decal/siding/wood{
	dir = 8
	},
/obj/effect/turf_decal/siding/wood{
	dir = 4
	},
/turf/open/indestructible/hotelwood,
/area/misc/condo)
"Ct" = (
/obj/effect/turf_decal/siding/wood{
	dir = 10
	},
/obj/effect/turf_decal/siding/wood/corner{
	dir = 4
	},
/turf/open/indestructible/hotelwood,
/area/misc/condo)
"CA" = (
/obj/machinery/light/directional/north,
/obj/structure/sign/poster/official/work_for_a_future/directional/north,
/obj/structure/bookcase{
	icon_state = "book-5"
	},
/turf/open/indestructible/dark,
/area/misc/condo)
"CQ" = (
/obj/effect/turf_decal/tile/neutral/fourcorners,
/obj/structure/chair/comfy{
	dir = 8
	},
/turf/open/indestructible/dark,
/area/misc/condo)
"Ew" = (
/obj/effect/turf_decal/siding/wood{
	dir = 1
	},
/obj/effect/turf_decal/siding/wood,
/turf/open/indestructible/hotelwood,
/area/misc/condo)
"FC" = (
/obj/effect/turf_decal/siding/wood{
	dir = 6
	},
/obj/effect/turf_decal/siding/wood/corner{
	dir = 1
	},
/turf/open/indestructible/hotelwood,
/area/misc/condo)
"II" = (
/obj/machinery/light/floor,
/turf/open/indestructible/hotelwood,
/area/misc/condo)
"Jh" = (
/obj/structure/table/wood,
/obj/item/paper_bin{
	pixel_y = 3
	},
/obj/item/pen/fountain{
	pixel_y = 4
	},
/turf/open/indestructible/carpet,
/area/misc/condo)
"Kd" = (
/obj/structure/table/wood,
/obj/item/storage/fancy/cigarettes/cigars/cohiba{
	pixel_x = -2;
	pixel_y = 15
	},
/obj/item/storage/fancy/cigarettes/cigars/havana{
	pixel_x = 2;
	pixel_y = 2
	},
/turf/open/indestructible/hotelwood,
/area/misc/condo)
"Na" = (
/obj/structure/table/wood,
/obj/effect/turf_decal/tile/neutral/fourcorners,
/obj/item/folder/blue{
	pixel_x = -3;
	pixel_y = 5
	},
/obj/item/folder/syndicate/blue{
	pixel_x = -5;
	pixel_y = 2
	},
/turf/open/indestructible/dark,
/area/misc/condo)
"Nc" = (
/obj/structure/showcase/fakeid{
	name = "\improper CentComm Communications Console";
	desc = "You can use this to communicate... if you know the password."
	},
/turf/open/indestructible/hotelwood,
/area/misc/condo)
"Pb" = (
/obj/effect/turf_decal/tile/neutral/fourcorners,
/obj/machinery/photocopier/gratis,
/obj/machinery/light_switch/directional/south,
/turf/open/indestructible/dark,
/area/misc/condo)
"Ps" = (
/obj/effect/turf_decal/tile/neutral/full,
/obj/structure/table/wood,
/obj/item/storage/box/drinkingglasses{
	pixel_y = 8;
	pixel_x = 2
	},
/obj/item/reagent_containers/cup/glass/coffee{
	pixel_x = -12;
	pixel_y = 12
	},
/obj/item/reagent_containers/cup/glass/coffee{
	pixel_x = -12;
	pixel_y = 5
	},
/obj/item/reagent_containers/cup/glass/coffee{
	pixel_x = -12;
	pixel_y = -1
	},
/obj/item/reagent_containers/condiment/pack/sugar{
	pixel_x = 11;
	pixel_y = -1
	},
/obj/item/reagent_containers/condiment/pack/sugar{
	pixel_x = 4;
	pixel_y = -1
	},
/obj/item/reagent_containers/condiment/pack/sugar{
	pixel_x = -4;
	pixel_y = -1
	},
/turf/open/indestructible/dark/smooth_large,
/area/misc/condo)
"Pv" = (
/obj/effect/turf_decal/tile/dark_blue/opposingcorners,
/turf/open/indestructible/dark,
/area/misc/condo)
"PO" = (
/obj/effect/turf_decal/tile/neutral/full,
/obj/machinery/vending/cigarette/beach,
/turf/open/indestructible/dark/smooth_large,
/area/misc/condo)
"Qd" = (
/obj/effect/turf_decal/tile/neutral/fourcorners,
/obj/effect/turf_decal/siding/wood/corner{
	dir = 1
	},
/obj/item/kirbyplants/organic/plant10,
/obj/structure/sign/poster/official/fruit_bowl/directional/north,
/turf/open/indestructible/dark,
/area/misc/condo)
"QQ" = (
/obj/structure/table/wood,
/obj/item/storage/fancy/donut_box{
	pixel_y = 12
	},
/obj/item/storage/fancy/donut_box{
	pixel_y = 1
	},
/obj/effect/turf_decal/tile/neutral/full,
/turf/open/indestructible/dark/smooth_large,
/area/misc/condo)
"Sq" = (
/obj/effect/turf_decal/tile/neutral/full,
/obj/machinery/vending/coffee,
/turf/open/indestructible/dark/smooth_large,
/area/misc/condo)
"Sx" = (
/obj/effect/turf_decal/tile/neutral/fourcorners,
/obj/effect/turf_decal/siding/wood,
/turf/open/indestructible/dark,
/area/misc/condo)
"UC" = (
/obj/effect/turf_decal/tile/neutral/fourcorners,
/turf/open/indestructible/dark,
/area/misc/condo)
"UR" = (
/obj/structure/chair/comfy/beige,
/turf/open/indestructible/carpet,
/area/misc/condo)
"Xc" = (
/obj/effect/turf_decal/siding/wood{
	dir = 9
	},
/obj/effect/turf_decal/siding/wood/corner,
/turf/open/indestructible/hotelwood,
/area/misc/condo)
"Xi" = (
/obj/effect/turf_decal/siding/wood,
/obj/effect/turf_decal/siding/wood{
	dir = 1
	},
/turf/open/indestructible/hotelwood,
/area/misc/condo)
"XQ" = (
/obj/machinery/light/directional/south,
/obj/structure/sign/poster/official/obey/directional/south,
/obj/structure/bookcase{
	icon_state = "book-5"
	},
/turf/open/indestructible/dark,
/area/misc/condo)
"Zn" = (
/obj/effect/turf_decal/tile/neutral/fourcorners,
/obj/effect/turf_decal/siding/wood{
	dir = 4
	},
/turf/open/indestructible/dark,
/area/misc/condo)
"Zo" = (
/obj/structure/window/reinforced/survival_pod/spawner/directional/north,
/obj/effect/turf_decal/tile/neutral/full,
/obj/structure/table/wood/fancy/black,
/obj/item/sign/flag/galfed{
	pixel_y = 3;
	pixel_x = 4
	},
/obj/item/sign/flag/nanotrasen{
	pixel_y = 1
	},
/turf/open/indestructible/dark/smooth_large,
/area/misc/condo)

(1,1,1) = {"
zb
pD
pD
pD
dE
dE
hN
dE
dE
pD
pD
pD
zb
zb
zb
"}
(2,1,1) = {"
pD
pD
pD
pD
uM
go
Pv
go
gK
pD
pD
pD
pD
zb
zb
"}
(3,1,1) = {"
pD
pD
pD
CA
Pv
Pv
Pv
Pv
Pv
XQ
pD
pD
pD
zb
zb
"}
(4,1,1) = {"
pD
pD
PO
oO
Xc
ax
Bo
ax
Ct
Sx
bA
pD
pD
zb
zb
"}
(5,1,1) = {"
pD
pD
Sq
oO
Ew
UR
AU
kL
Xi
Sx
wV
pD
pD
zb
zb
"}
(6,1,1) = {"
pD
pD
AN
oO
Ew
UR
Jh
kL
Xi
Sx
Zo
pD
pD
zb
zb
"}
(7,1,1) = {"
pD
pD
QQ
oO
Ew
UR
ca
kL
Xi
Sx
wV
pD
pD
zb
zb
"}
(8,1,1) = {"
pD
pD
Ps
oO
nh
ng
rg
ng
FC
Sx
bA
pD
pD
zb
zb
"}
(9,1,1) = {"
pD
pD
pD
Qd
UC
ks
Na
jh
UC
xF
pD
pD
pD
zb
zb
"}
(10,1,1) = {"
zb
pD
yM
UC
UC
ij
CQ
yX
UC
Pb
pD
pD
pD
zb
zb
"}
(11,1,1) = {"
zb
pD
pD
aN
Zn
Zn
Zn
Zn
Zn
hu
pD
pD
zb
zb
zb
"}
(12,1,1) = {"
zb
pD
pD
qR
Nc
pO
II
pO
rz
qR
pD
pD
zb
zb
zb
"}
(13,1,1) = {"
zb
pD
pD
dE
dE
dZ
le
Kd
dE
dE
pD
pD
zb
zb
zb
"}
(14,1,1) = {"
zb
zb
zb
zb
dE
dE
dE
dE
dE
zb
zb
zb
zb
zb
zb
"}
(15,1,1) = {"
zb
zb
zb
zb
zb
zb
zb
zb
zb
zb
zb
zb
zb
zb
zb
"}
(16,1,1) = {"
zb
zb
zb
zb
zb
zb
zb
zb
zb
zb
zb
zb
zb
zb
zb
"}
