//MAP CONVERTED BY dmm2tgm.py THIS HEADER COMMENT PREVENTS RECONVERSION, DO NOT REMOVE
"an" = (
/turf/cordon,
/area/misc/condo)
"bZ" = (
/obj/machinery/light/directional/west,
/obj/structure/table,
/obj/item/clothing/under/syndicate/skyrat/tactical/skirt,
/turf/open/floor/iron/dark,
/area/misc/condo)
"cX" = (
/obj/machinery/light/directional/north,
/obj/structure/platform/plastitanium,
/turf/open/floor/plating,
/area/misc/condo)
"dQ" = (
/obj/effect/turf_decal/siding/wideplating_new/dark,
/obj/structure/fluff/fake_scrubber,
/turf/open/floor/iron/dark/diagonal,
/area/misc/condo)
"fJ" = (
/turf/open/floor/iron/checker,
/area/misc/condo)
"fW" = (
/obj/structure/fireaxecabinet/empty/directional/north,
/obj/structure/platform/plastitanium,
/obj/effect/turf_decal/siding/wideplating_new/dark/corner{
	dir = 8
	},
/turf/open/floor/plating,
/area/misc/condo)
"gJ" = (
/obj/item/kirbyplants/random,
/obj/effect/turf_decal/siding/wideplating_new/dark{
	dir = 9
	},
/turf/open/floor/iron/dark/textured_large,
/area/misc/condo)
"gS" = (
/obj/structure/platform/plastitanium,
/obj/effect/turf_decal/siding/wideplating_new/dark{
	dir = 6
	},
/turf/open/floor/plating,
/area/misc/condo)
"ip" = (
/obj/effect/turf_decal/siding/wideplating_new/dark{
	dir = 8
	},
/turf/open/floor/mineral/plastitanium/red,
/area/misc/condo)
"ka" = (
/obj/effect/turf_decal/syndicateemblem/top/left{
	dir = 1
	},
/obj/effect/turf_decal/siding/thinplating_new/dark{
	dir = 1
	},
/turf/open/floor/mineral/plastitanium/red,
/area/misc/condo)
"kh" = (
/obj/structure/table,
/turf/open/floor/iron/checker,
/area/misc/condo)
"kn" = (
/obj/structure/fluff/preserved_borer,
/obj/effect/turf_decal/siding/wideplating_new/dark{
	dir = 4
	},
/turf/open/floor/iron/dark/textured_large,
/area/misc/condo)
"kU" = (
/obj/effect/turf_decal/syndicateemblem/bottom/right,
/obj/effect/turf_decal/siding/thinplating_new/dark,
/turf/open/floor/mineral/plastitanium/red,
/area/misc/condo)
"ms" = (
/obj/structure/fluff/fake_vent,
/obj/effect/turf_decal/siding/wideplating_new/dark,
/turf/open/floor/iron/dark/diagonal,
/area/misc/condo)
"mI" = (
/obj/effect/turf_decal/syndicateemblem/middle/right,
/obj/effect/turf_decal/skyrat_decals/ds2/right,
/turf/open/floor/mineral/plastitanium/red,
/area/misc/condo)
"nz" = (
/obj/effect/turf_decal/siding/wideplating_new/dark{
	dir = 8
	},
/obj/effect/turf_decal/siding/wideplating_new/dark{
	dir = 4
	},
/obj/structure/fluff/fake_firedoor{
	dir = 8
	},
/turf/open/floor/iron/dark/textured_large,
/area/misc/condo)
"nO" = (
/obj/effect/turf_decal/siding/wideplating_new/dark{
	dir = 9
	},
/obj/machinery/computer/security/telescreen/entertainment/directional/north,
/turf/open/floor/mineral/plastitanium/red,
/area/misc/condo)
"nT" = (
/obj/structure/railing{
	dir = 1
	},
/obj/effect/turf_decal/siding/wideplating_new/dark{
	dir = 1
	},
/obj/structure/chair/sofa/bench/left,
/turf/open/floor/iron/dark/diagonal,
/area/misc/condo)
"oe" = (
/obj/effect/turf_decal/siding/wideplating_new/dark{
	dir = 9
	},
/obj/structure/table,
/turf/open/floor/mineral/plastitanium/red,
/area/misc/condo)
"oO" = (
/obj/structure/reagent_dispensers/water_cooler,
/obj/effect/turf_decal/siding/wideplating_new/dark{
	dir = 8
	},
/turf/open/floor/iron/dark/textured_large,
/area/misc/condo)
"qb" = (
/obj/structure/fluff/fake_vent,
/turf/open/floor/mineral/plastitanium/red,
/area/misc/condo)
"qA" = (
/obj/effect/turf_decal/bot_red,
/obj/machinery/light/floor,
/turf/open/floor/iron/dark/diagonal,
/area/misc/condo)
"qE" = (
/obj/effect/turf_decal/siding/wideplating_new/dark,
/turf/open/floor/iron/dark/diagonal,
/area/misc/condo)
"rH" = (
/turf/closed/indestructible/rock,
/area/misc/condo)
"sO" = (
/obj/effect/turf_decal/syndicateemblem/bottom/right{
	dir = 8
	},
/obj/effect/turf_decal/siding/thinplating_new/dark{
	dir = 1
	},
/turf/open/floor/mineral/plastitanium/red,
/area/misc/condo)
"tf" = (
/obj/effect/turf_decal/syndicateemblem/top/right,
/obj/effect/turf_decal/siding/thinplating_new/dark{
	dir = 1
	},
/turf/open/floor/mineral/plastitanium/red,
/area/misc/condo)
"ti" = (
/obj/structure/table,
/obj/item/clothing/under/syndicate/skyrat/tactical,
/turf/open/floor/iron/dark,
/area/misc/condo)
"ub" = (
/obj/structure/railing{
	dir = 1
	},
/obj/structure/table/reinforced/plastitaniumglass,
/obj/machinery/microwave,
/obj/effect/turf_decal/siding/wideplating_new/dark{
	dir = 8
	},
/turf/open/floor/iron/dark,
/area/misc/condo)
"uo" = (
/obj/effect/turf_decal/syndicateemblem/middle/middle,
/obj/effect/turf_decal/skyrat_decals/ds2/middle,
/turf/open/floor/mineral/plastitanium/red,
/area/misc/condo)
"uQ" = (
/obj/structure/railing{
	dir = 1
	},
/obj/item/toy/balloon/arrest,
/obj/effect/turf_decal/siding/wideplating_new/dark{
	dir = 1
	},
/turf/open/floor/iron/dark/diagonal,
/area/misc/condo)
"wx" = (
/obj/effect/turf_decal/siding/wideplating_new/dark{
	dir = 5
	},
/obj/structure/closet/secure_closet/personal,
/turf/open/floor/mineral/plastitanium/red,
/area/misc/condo)
"xD" = (
/obj/structure/table,
/obj/machinery/light/directional/south,
/turf/open/floor/iron/checker,
/area/misc/condo)
"yh" = (
/obj/structure/table,
/turf/open/floor/iron/dark,
/area/misc/condo)
"yR" = (
/obj/structure/chair{
	dir = 8
	},
/turf/open/floor/iron/checker,
/area/misc/condo)
"zj" = (
/obj/effect/turf_decal/bot_red/left,
/turf/open/floor/iron/dark/diagonal,
/area/misc/condo)
"zo" = (
/obj/effect/turf_decal/syndicateemblem/bottom/right{
	dir = 4
	},
/obj/effect/turf_decal/siding/thinplating_new/dark,
/turf/open/floor/mineral/plastitanium/red,
/area/misc/condo)
"Bb" = (
/obj/effect/turf_decal/siding/wideplating_new/dark,
/obj/machinery/light/directional/south,
/turf/open/floor/mineral/plastitanium/red,
/area/misc/condo)
"Bk" = (
/obj/effect/turf_decal/siding/wideplating_new/dark{
	dir = 6
	},
/obj/structure/bed/double,
/obj/item/bedsheet/black/double,
/turf/open/floor/mineral/plastitanium/red,
/area/misc/condo)
"BQ" = (
/obj/effect/turf_decal/siding/wideplating_new/dark{
	dir = 1
	},
/obj/machinery/door/airlock/security{
	name = "Hostage Containment"
	},
/turf/open/floor/iron/dark/textured_large,
/area/misc/condo)
"BV" = (
/obj/structure/railing/corner{
	dir = 4
	},
/obj/structure/sign/poster/contraband/hacking_guide/directional/north,
/obj/effect/turf_decal/siding/wideplating_new/dark{
	dir = 1
	},
/obj/structure/chair/sofa/bench/right,
/turf/open/floor/iron/dark/diagonal,
/area/misc/condo)
"BW" = (
/obj/effect/turf_decal/siding/wideplating_new/dark{
	dir = 10
	},
/turf/open/floor/mineral/plastitanium/red,
/area/misc/condo)
"Dj" = (
/obj/structure/platform/plastitanium,
/obj/effect/turf_decal/siding/wideplating_new/dark,
/turf/open/floor/plating,
/area/misc/condo)
"EF" = (
/obj/structure/chair/office/tactical,
/obj/machinery/light_switch/directional/west,
/turf/open/floor/iron/checker,
/area/misc/condo)
"EQ" = (
/obj/effect/turf_decal/bot_red/right,
/turf/open/floor/iron/dark/diagonal,
/area/misc/condo)
"Fl" = (
/turf/closed/indestructible/opsglass,
/area/misc/condo)
"FU" = (
/obj/structure/fluff/fake_scrubber,
/turf/open/floor/mineral/plastitanium/red,
/area/misc/condo)
"GH" = (
/obj/effect/turf_decal/siding/wideplating_new/dark{
	dir = 8
	},
/obj/structure/closet/secure_closet/freezer/fridge/all_access,
/turf/open/floor/iron/dark,
/area/misc/condo)
"GN" = (
/obj/effect/planetary_turf_atmos_helper,
/turf/closed/indestructible/syndicate,
/area/misc/condo)
"GS" = (
/obj/effect/turf_decal/siding/wideplating_new/dark{
	dir = 8
	},
/obj/structure/closet/crate/trashcart/laundry,
/turf/open/floor/iron/dark,
/area/misc/condo)
"Hk" = (
/obj/structure/fluff/balloon_nuke,
/obj/effect/turf_decal/siding/wideplating_new/dark{
	dir = 5
	},
/turf/open/floor/iron/dark/textured_large,
/area/misc/condo)
"HD" = (
/turf/closed/indestructible/fakedoor/blast_door{
	name = "Master At Arms' Office"
	},
/area/misc/condo)
"HF" = (
/obj/structure/sign/flag/syndicate,
/turf/closed/indestructible/syndicate,
/area/misc/condo)
"Iz" = (
/obj/structure/table/reinforced/plastitaniumglass,
/obj/item/food/chips{
	pixel_y = 9;
	pixel_x = 4
	},
/obj/item/reagent_containers/cup/glass/waterbottle{
	pixel_x = -4
	},
/obj/machinery/light/directional/east,
/obj/effect/turf_decal/siding/wideplating_new/dark{
	dir = 8
	},
/turf/open/floor/iron/dark,
/area/misc/condo)
"IX" = (
/obj/effect/turf_decal/siding/wideplating_new/dark{
	dir = 6
	},
/turf/open/floor/mineral/plastitanium/red,
/area/misc/condo)
"LR" = (
/obj/structure/steps/directional/north,
/turf/open/floor/iron/dark,
/area/misc/condo)
"MA" = (
/obj/effect/turf_decal/siding/wideplating_new/dark{
	dir = 5
	},
/turf/open/floor/mineral/plastitanium/red,
/area/misc/condo)
"OC" = (
/obj/effect/turf_decal/siding/wideplating_new/dark{
	dir = 4
	},
/turf/open/floor/mineral/plastitanium/red,
/area/misc/condo)
"QB" = (
/obj/effect/turf_decal/syndicateemblem/bottom/middle,
/obj/effect/turf_decal/siding/thinplating_new/dark,
/turf/open/floor/mineral/plastitanium/red,
/area/misc/condo)
"Sh" = (
/obj/effect/turf_decal/syndicateemblem/top/left,
/obj/effect/turf_decal/siding/thinplating_new/dark,
/turf/open/floor/mineral/plastitanium/red,
/area/misc/condo)
"SF" = (
/obj/machinery/light_switch/directional/east,
/obj/structure/steps/directional/north,
/turf/open/floor/iron/dark,
/area/misc/condo)
"Tu" = (
/obj/effect/turf_decal/syndicateemblem/bottom/left,
/obj/effect/turf_decal/siding/thinplating_new/dark,
/turf/open/floor/mineral/plastitanium/red,
/area/misc/condo)
"TE" = (
/obj/structure/chair{
	dir = 4
	},
/obj/machinery/computer/security/telescreen/entertainment/directional/west,
/turf/open/floor/iron/checker,
/area/misc/condo)
"TR" = (
/obj/structure/sign/poster/contraband/gorlex_recruitment/directional/north,
/obj/structure/platform/plastitanium,
/obj/effect/turf_decal/siding/wideplating_new/dark/corner,
/turf/open/floor/plating,
/area/misc/condo)
"Ui" = (
/obj/effect/turf_decal/syndicateemblem/top/left,
/obj/effect/turf_decal/siding/thinplating_new/dark{
	dir = 1
	},
/turf/open/floor/mineral/plastitanium/red,
/area/misc/condo)
"Wj" = (
/obj/structure/rack,
/obj/item/clothing/under/rank/prisoner/syndicate,
/obj/item/clothing/under/rank/prisoner/skirt/syndicate,
/turf/open/floor/iron/dark,
/area/misc/condo)
"Wn" = (
/turf/closed/indestructible/syndicate,
/area/misc/condo)
"Wt" = (
/obj/structure/hedge,
/obj/effect/turf_decal/siding/wideplating_new/dark{
	dir = 8
	},
/turf/open/floor/iron/dark,
/area/misc/condo)
"WC" = (
/obj/structure/platform/plastitanium,
/obj/effect/turf_decal/siding/wideplating_new/dark{
	dir = 10
	},
/turf/open/floor/plating,
/area/misc/condo)
"XS" = (
/obj/effect/turf_decal/siding/wideplating_new/dark{
	dir = 8
	},
/obj/effect/turf_decal/siding/wideplating_new/dark{
	dir = 4
	},
/obj/machinery/door/airlock/security{
	name = "Defensive Operations"
	},
/turf/open/floor/iron/dark/textured_large,
/area/misc/condo)
"XX" = (
/turf/closed/indestructible/hoteldoor/fakedoor,
/area/misc/condo)
"Yn" = (
/obj/effect/turf_decal/syndicateemblem/middle/left,
/obj/effect/turf_decal/skyrat_decals/ds2/left,
/turf/open/floor/mineral/plastitanium/red,
/area/misc/condo)
"YF" = (
/obj/effect/turf_decal/siding/wideplating_new/dark{
	dir = 10
	},
/obj/structure/table,
/turf/open/floor/mineral/plastitanium/red,
/area/misc/condo)
"YT" = (
/obj/effect/turf_decal/siding/wideplating_new/dark{
	dir = 1
	},
/turf/open/floor/mineral/plastitanium/red,
/area/misc/condo)
"Zc" = (
/obj/effect/turf_decal/syndicateemblem/top/middle,
/obj/effect/turf_decal/siding/thinplating_new/dark{
	dir = 1
	},
/turf/open/floor/mineral/plastitanium/red,
/area/misc/condo)
"Zk" = (
/turf/open/floor/iron/dark/diagonal,
/area/misc/condo)

(1,1,1) = {"
an
Wn
Wn
Wn
Wn
Wn
Wn
Wn
Wn
Wn
"}
(2,1,1) = {"
an
HD
ti
bZ
yh
Wj
Fl
oe
YF
Wn
"}
(3,1,1) = {"
an
Wn
nO
ip
ip
BW
BQ
YT
Bb
Wn
"}
(4,1,1) = {"
an
HD
MA
OC
OC
IX
Fl
wx
Bk
Wn
"}
(5,1,1) = {"
Wn
Wn
Wn
XS
Fl
XS
Wn
Wn
Wn
Wn
"}
(6,1,1) = {"
Wn
Dj
LR
ka
FU
zo
Hk
kn
Wn
an
"}
(7,1,1) = {"
Wn
fW
WC
Ui
Yn
Tu
EQ
Zk
Wn
an
"}
(8,1,1) = {"
HF
cX
Dj
Zc
uo
QB
qA
Zk
XX
an
"}
(9,1,1) = {"
Wn
TR
gS
tf
mI
kU
zj
Zk
Wn
an
"}
(10,1,1) = {"
Wn
Dj
SF
sO
qb
Sh
gJ
oO
Wn
an
"}
(11,1,1) = {"
Wn
Wn
Wn
nz
nz
nz
Wn
Wn
Wn
an
"}
(12,1,1) = {"
an
Wn
BV
dQ
fJ
fJ
EF
TE
Wn
an
"}
(13,1,1) = {"
an
rH
nT
qE
fJ
fJ
kh
xD
Wn
an
"}
(14,1,1) = {"
an
rH
uQ
ms
fJ
fJ
yR
yR
Wn
an
"}
(15,1,1) = {"
an
rH
ub
Iz
GH
GS
Wt
Wn
GN
an
"}
(16,1,1) = {"
an
Wn
Wn
Wn
Wn
Wn
Wn
Wn
an
an
"}
