//MAP CONVERTED BY dmm2tgm.py THIS HEADER COMMENT PREVENTS RECONVERSION, DO NOT REMOVE
"ae" = (
/obj/machinery/vending/engivend,
/turf/open/floor/iron/dark,
/area/misc/condo)
"aC" = (
/turf/open/floor/iron/dark,
/area/misc/condo)
"cw" = (
/obj/machinery/suit_storage_unit,
/turf/open/floor/iron/smooth_large,
/area/misc/condo)
"cy" = (
/obj/effect/turf_decal/tile/yellow/half{
	dir = 8
	},
/obj/machinery/light/directional/west,
/turf/open/floor/iron/smooth_half{
	dir = 1
	},
/area/misc/condo)
"cO" = (
/turf/open/floor/plating,
/area/misc/condo)
"da" = (
/obj/effect/turf_decal/tile/yellow/half/contrasted{
	dir = 1
	},
/obj/effect/turf_decal/tile/dark/half,
/obj/structure/closet/secure_closet/engineering_welding,
/turf/open/floor/iron,
/area/misc/condo)
"dw" = (
/obj/structure/closet/firecloset,
/obj/effect/turf_decal/siding/yellow{
	dir = 4
	},
/obj/effect/turf_decal/siding/yellow{
	dir = 8
	},
/obj/machinery/light/small/directional/west,
/turf/open/floor/iron/smooth_large,
/area/misc/condo)
"dB" = (
/obj/effect/spawner/structure/window/reinforced/plasma,
/obj/structure/cable,
/turf/open/floor/plating,
/area/misc/condo)
"es" = (
/obj/effect/turf_decal/siding/yellow/corner,
/obj/effect/turf_decal/siding/yellow/corner{
	dir = 1
	},
/obj/effect/turf_decal/siding/yellow/corner{
	dir = 4
	},
/obj/effect/turf_decal/siding/yellow/corner{
	dir = 8
	},
/turf/open/floor/iron/smooth_large,
/area/misc/condo)
"eK" = (
/obj/effect/turf_decal/tile/yellow/half{
	dir = 1
	},
/obj/structure/chair/office{
	dir = 1;
	name = "grimy chair"
	},
/turf/open/floor/iron/smooth_half,
/area/misc/condo)
"fw" = (
/obj/effect/turf_decal/tile/yellow/half{
	dir = 4
	},
/turf/open/floor/iron/smooth_half{
	dir = 1
	},
/area/misc/condo)
"gd" = (
/turf/open/floor/iron/showroomfloor,
/area/misc/condo)
"iK" = (
/obj/effect/turf_decal/stripes/line,
/turf/open/floor/engine,
/area/misc/condo)
"iL" = (
/obj/effect/spawner/structure/window/reinforced/plasma,
/turf/open/floor/plating,
/area/misc/condo)
"jk" = (
/obj/structure/chair/office{
	dir = 8
	},
/obj/effect/turf_decal/tile/yellow/half{
	dir = 8
	},
/turf/open/floor/iron/smooth_half{
	dir = 1
	},
/area/misc/condo)
"jT" = (
/turf/open/floor/iron,
/area/misc/condo)
"kh" = (
/obj/machinery/power/energy_accumulator/tesla_coil/anchored,
/turf/open/floor/engine,
/area/misc/condo)
"kz" = (
/obj/machinery/portable_atmospherics/canister,
/obj/effect/turf_decal/bot,
/turf/open/floor/engine,
/area/misc/condo)
"mn" = (
/obj/structure/girder,
/turf/open/floor/iron/dark,
/area/misc/condo)
"mx" = (
/obj/effect/turf_decal/tile/yellow/half/contrasted{
	dir = 4
	},
/turf/open/floor/iron,
/area/misc/condo)
"mQ" = (
/obj/effect/turf_decal/tile/yellow{
	dir = 1
	},
/turf/open/floor/iron/smooth_corner{
	dir = 1
	},
/area/misc/condo)
"ni" = (
/obj/structure/table/reinforced,
/obj/item/tank/internals/emergency_oxygen/engi{
	pixel_x = 5
	},
/obj/item/clothing/gloves/color/black,
/obj/item/clothing/glasses/meson/engine,
/turf/open/floor/engine,
/area/misc/condo)
"no" = (
/obj/structure/table/reinforced,
/obj/item/storage/toolbox/mechanical,
/obj/item/analyzer,
/obj/item/pipe_dispenser,
/obj/item/flashlight,
/turf/open/floor/engine,
/area/misc/condo)
"nM" = (
/turf/closed/indestructible/hoteldoor/fakedoor,
/area/misc/condo)
"oU" = (
/obj/machinery/atmospherics/components/unary/thermomachine/freezer{
	dir = 8
	},
/obj/effect/turf_decal/bot,
/obj/structure/sign/warning/fire/directional/north,
/turf/open/floor/engine,
/area/misc/condo)
"pi" = (
/obj/machinery/power/shieldwallgen,
/turf/open/floor/plating,
/area/misc/condo)
"pz" = (
/obj/effect/turf_decal/tile/yellow/anticorner{
	dir = 1
	},
/obj/machinery/light/directional/west,
/obj/structure/chair/office{
	dir = 1;
	name = "grimy chair"
	},
/turf/open/floor/iron/smooth_corner,
/area/misc/condo)
"pS" = (
/obj/machinery/power/energy_accumulator/grounding_rod/anchored,
/turf/open/floor/engine,
/area/misc/condo)
"pT" = (
/obj/machinery/light/directional/west,
/obj/machinery/vending/tool,
/turf/open/floor/iron/dark,
/area/misc/condo)
"qN" = (
/obj/machinery/door/airlock/bathroom,
/turf/open/floor/iron,
/area/misc/condo)
"re" = (
/obj/effect/turf_decal/tile/yellow/anticorner/contrasted,
/turf/open/floor/iron,
/area/misc/condo)
"ri" = (
/obj/structure/cable,
/obj/effect/turf_decal/stripes/line{
	dir = 5
	},
/turf/open/floor/engine,
/area/misc/condo)
"sn" = (
/turf/open/floor/engine,
/area/misc/condo)
"so" = (
/obj/effect/turf_decal/stripes/corner,
/obj/effect/turf_decal/stripes/corner{
	dir = 1
	},
/turf/open/floor/engine,
/area/misc/condo)
"sq" = (
/obj/machinery/shower/directional/east,
/obj/structure/fluff/shower_drain,
/turf/open/floor/iron/showroomfloor,
/area/misc/condo)
"sV" = (
/obj/machinery/atmospherics/components/unary/vent_pump/on{
	dir = 4
	},
/obj/machinery/light/directional/east,
/turf/open/floor/engine,
/area/misc/condo)
"uK" = (
/obj/machinery/door/airlock/engineering,
/turf/open/floor/iron,
/area/misc/condo)
"vg" = (
/obj/effect/turf_decal/stripes/line{
	dir = 6
	},
/turf/open/floor/engine,
/area/misc/condo)
"vm" = (
/obj/effect/turf_decal/tile/yellow/anticorner{
	dir = 4
	},
/obj/structure/rack,
/turf/open/floor/iron/smooth_corner{
	dir = 8
	},
/area/misc/condo)
"wq" = (
/obj/effect/turf_decal/tile/yellow/anticorner{
	dir = 8
	},
/turf/open/floor/iron/smooth_corner{
	dir = 4
	},
/area/misc/condo)
"wy" = (
/obj/effect/turf_decal/tile/yellow/half,
/turf/open/floor/iron/smooth_half,
/area/misc/condo)
"xe" = (
/turf/open/floor/iron/smooth_large,
/area/misc/condo)
"xA" = (
/obj/effect/turf_decal/stripes/line{
	dir = 4
	},
/obj/effect/turf_decal/stripes/corner{
	dir = 8
	},
/turf/open/floor/engine,
/area/misc/condo)
"xW" = (
/obj/effect/turf_decal/tile/yellow/half/contrasted{
	dir = 8
	},
/turf/open/floor/iron,
/area/misc/condo)
"yy" = (
/obj/structure/table,
/turf/open/floor/iron/dark,
/area/misc/condo)
"BK" = (
/obj/machinery/atmospherics/components/unary/vent_pump/on{
	dir = 4
	},
/turf/open/floor/engine,
/area/misc/condo)
"BR" = (
/obj/machinery/door/poddoor/preopen{
	id = "hiblert"
	},
/turf/open/floor/plating,
/area/misc/condo)
"Cn" = (
/obj/effect/turf_decal/tile/yellow/half/contrasted,
/obj/effect/turf_decal/tile/dark/half{
	dir = 1
	},
/obj/structure/closet/secure_closet/engineering_welding,
/turf/open/floor/iron,
/area/misc/condo)
"Cs" = (
/obj/machinery/power/smes,
/turf/open/floor/iron/smooth_large,
/area/misc/condo)
"CD" = (
/obj/structure/table,
/obj/structure/reagent_dispensers/servingdish{
	icon = 'icons/obj/machines/engine/supermatter.dmi';
	icon_state = "sm";
	name = "souper matter"
	},
/turf/open/floor/engine,
/area/misc/condo)
"CZ" = (
/obj/structure/closet/radiation,
/obj/effect/turf_decal/siding/yellow{
	dir = 4
	},
/obj/effect/turf_decal/siding/yellow{
	dir = 8
	},
/obj/machinery/light/small/directional/west,
/turf/open/floor/iron/smooth_large,
/area/misc/condo)
"Df" = (
/obj/machinery/computer{
	dir = 1
	},
/obj/effect/turf_decal/tile/yellow/anticorner{
	dir = 8
	},
/turf/open/floor/iron/smooth_corner{
	dir = 4
	},
/area/misc/condo)
"Dy" = (
/obj/machinery/vending/wardrobe/engi_wardrobe/ghost_cafe,
/turf/open/floor/iron/dark,
/area/misc/condo)
"DF" = (
/obj/structure/window/reinforced/plasma/spawner/directional/west,
/obj/machinery/atmospherics/components/unary/vent_scrubber/on{
	dir = 8
	},
/turf/open/floor/engine,
/area/misc/condo)
"DP" = (
/obj/effect/turf_decal/stripes/line{
	dir = 8
	},
/turf/open/floor/engine,
/area/misc/condo)
"ER" = (
/obj/machinery/portable_atmospherics/canister,
/obj/effect/turf_decal/bot,
/obj/structure/sign/warning/fire/directional/south,
/turf/open/floor/engine,
/area/misc/condo)
"Fg" = (
/obj/machinery/light/small/dim/directional/east,
/turf/open/floor/plating,
/area/misc/condo)
"Fo" = (
/obj/effect/turf_decal/siding/yellow,
/obj/effect/turf_decal/siding/yellow{
	dir = 1
	},
/turf/open/floor/iron/smooth_large,
/area/misc/condo)
"FN" = (
/turf/closed/indestructible/reinforced,
/area/misc/condo)
"GG" = (
/obj/effect/turf_decal/tile/yellow/half{
	dir = 1
	},
/turf/open/floor/iron/smooth_half,
/area/misc/condo)
"Hl" = (
/obj/effect/turf_decal/stripes/line{
	dir = 1
	},
/turf/open/floor/engine,
/area/misc/condo)
"Iz" = (
/obj/structure/closet/crate,
/obj/item/storage/toolbox/mechanical/old/clean,
/turf/open/floor/plating,
/area/misc/condo)
"IE" = (
/obj/effect/turf_decal/stripes/line{
	dir = 9
	},
/turf/open/floor/engine,
/area/misc/condo)
"JE" = (
/obj/machinery/computer,
/turf/open/floor/iron/smooth_large,
/area/misc/condo)
"LT" = (
/obj/structure/rack,
/obj/item/reagent_containers/cup/bowl,
/obj/item/reagent_containers/cup/bowl,
/obj/item/reagent_containers/cup/bowl,
/obj/item/reagent_containers/cup/bowl,
/obj/item/reagent_containers/cup/bowl,
/obj/effect/turf_decal/bot,
/turf/open/floor/engine,
/area/misc/condo)
"Mo" = (
/obj/machinery/door/airlock/engineering/glass,
/turf/open/floor/iron/dark,
/area/misc/condo)
"Mp" = (
/obj/machinery/door/airlock/engineering/glass,
/turf/open/floor/engine,
/area/misc/condo)
"Nn" = (
/obj/structure/reagent_dispensers/fueltank,
/obj/effect/turf_decal/tile/yellow/anticorner,
/turf/open/floor/iron/smooth_corner{
	dir = 1
	},
/area/misc/condo)
"NG" = (
/obj/machinery/door/poddoor{
	id = "hiblert"
	},
/turf/open/floor/plating,
/area/misc/condo)
"Oi" = (
/obj/effect/turf_decal/tile/yellow/half{
	dir = 1
	},
/obj/structure/rack,
/obj/item/storage/toolbox/mechanical,
/turf/open/floor/iron/smooth_half,
/area/misc/condo)
"Ov" = (
/obj/structure/reagent_dispensers/watertank{
	icon = 'modular_skyrat/modules/aesthetics/emitter/icons/emitter.dmi';
	icon_state = "emitter"
	},
/turf/open/floor/plating,
/area/misc/condo)
"Pt" = (
/obj/machinery/door/airlock/engineering/glass,
/turf/open/floor/iron/smooth_large,
/area/misc/condo)
"PA" = (
/obj/effect/turf_decal/stripes/line{
	dir = 1
	},
/obj/structure/sign/warning/directional/north,
/turf/open/floor/engine,
/area/misc/condo)
"PC" = (
/obj/effect/turf_decal/tile/yellow/anticorner/contrasted{
	dir = 8
	},
/turf/open/floor/iron,
/area/misc/condo)
"PH" = (
/obj/machinery/light/directional/north,
/obj/structure/sign/warning/fire/directional/north,
/obj/effect/turf_decal/stripes/line{
	dir = 9
	},
/turf/open/floor/engine,
/area/misc/condo)
"PJ" = (
/obj/machinery/light/directional/north,
/obj/structure/cable,
/turf/open/floor/plating,
/area/misc/condo)
"Rs" = (
/obj/machinery/shower/directional/west,
/obj/structure/fluff/shower_drain,
/turf/open/floor/iron/showroomfloor,
/area/misc/condo)
"RL" = (
/obj/effect/turf_decal/tile/yellow/half/contrasted,
/obj/effect/turf_decal/tile/dark/half{
	dir = 1
	},
/obj/machinery/light/directional/east,
/obj/structure/closet/secure_closet/engineering_welding,
/turf/open/floor/iron,
/area/misc/condo)
"RM" = (
/obj/effect/turf_decal/stripes/line{
	dir = 4
	},
/turf/open/floor/engine,
/area/misc/condo)
"SS" = (
/obj/machinery/light/small/directional/east,
/turf/open/floor/iron/showroomfloor,
/area/misc/condo)
"Uy" = (
/obj/structure/cable,
/turf/open/floor/plating,
/area/misc/condo)
"UD" = (
/obj/effect/turf_decal/tile/yellow/half{
	dir = 4
	},
/obj/structure/sign/warning/directional/east,
/turf/open/floor/iron/smooth_half{
	dir = 1
	},
/area/misc/condo)
"UP" = (
/obj/structure/reagent_dispensers/watertank{
	icon = 'modular_skyrat/modules/aesthetics/emitter/icons/emitter.dmi';
	icon_state = "emitter";
	anchored = 1
	},
/turf/open/floor/iron/dark,
/area/misc/condo)
"UW" = (
/obj/structure/chair/sofa/bench/left,
/obj/effect/turf_decal/tile/yellow/anticorner/contrasted{
	dir = 4
	},
/turf/open/floor/iron,
/area/misc/condo)
"Vg" = (
/obj/machinery/door/poddoor{
	id = "hiblert"
	},
/turf/open/floor/iron/dark,
/area/misc/condo)
"VM" = (
/obj/effect/turf_decal/tile/yellow/anticorner{
	dir = 1
	},
/turf/open/floor/iron/smooth_corner,
/area/misc/condo)
"WL" = (
/obj/effect/turf_decal/stripes/line,
/obj/structure/sign/warning/electric_shock/directional/south,
/turf/open/floor/engine,
/area/misc/condo)
"WM" = (
/obj/effect/turf_decal/stripes/line{
	dir = 8
	},
/obj/structure/sign/warning/electric_shock/directional/west,
/turf/open/floor/engine,
/area/misc/condo)
"WT" = (
/obj/effect/turf_decal/stripes/line{
	dir = 5
	},
/turf/open/floor/engine,
/area/misc/condo)
"Xg" = (
/obj/structure/chair/sofa/bench/right,
/obj/effect/turf_decal/tile/yellow/anticorner/contrasted{
	dir = 1
	},
/turf/open/floor/iron,
/area/misc/condo)
"XU" = (
/obj/machinery/atmospherics/components/unary/thermomachine/freezer{
	dir = 8
	},
/obj/effect/turf_decal/bot,
/turf/open/floor/engine,
/area/misc/condo)
"XV" = (
/obj/machinery/door/poddoor{
	id = "hiblert"
	},
/turf/open/floor/iron,
/area/misc/condo)
"YK" = (
/obj/machinery/door/poddoor/preopen{
	id = "Engineering";
	name = "Engineering Blast Door"
	},
/obj/effect/spawner/structure/window/reinforced,
/turf/open/floor/plating,
/area/misc/condo)
"YW" = (
/obj/effect/turf_decal/stripes/line{
	dir = 10
	},
/turf/open/floor/engine,
/area/misc/condo)
"Zj" = (
/obj/machinery/light/directional/south,
/obj/effect/turf_decal/stripes/line{
	dir = 10
	},
/turf/open/floor/engine,
/area/misc/condo)
"ZY" = (
/obj/effect/turf_decal/stripes/line{
	dir = 8
	},
/obj/effect/turf_decal/stripes/corner{
	dir = 4
	},
/turf/open/floor/engine,
/area/misc/condo)

(1,1,1) = {"
FN
FN
FN
FN
FN
FN
FN
FN
FN
FN
FN
FN
FN
FN
FN
"}
(2,1,1) = {"
FN
Dy
ae
pT
FN
nM
FN
XV
Vg
FN
JE
pz
wq
Cs
FN
"}
(3,1,1) = {"
FN
Xg
xW
PC
FN
VM
cy
jk
Df
YK
JE
eK
wy
Cs
FN
"}
(4,1,1) = {"
FN
UW
jT
re
uK
GG
xe
xe
wy
Pt
VM
mQ
wy
Cs
FN
"}
(5,1,1) = {"
FN
Cn
jT
da
FN
vm
fw
UD
Nn
YK
Oi
xe
wy
cw
FN
"}
(6,1,1) = {"
FN
Cn
jT
da
FN
FN
Pt
FN
FN
FN
NG
NG
BR
FN
FN
"}
(7,1,1) = {"
FN
RL
mx
da
FN
CZ
es
dw
FN
Ov
cO
cO
cO
pi
FN
"}
(8,1,1) = {"
FN
FN
qN
FN
FN
Rs
Fo
Rs
FN
Ov
cO
Fg
Iz
pi
FN
"}
(9,1,1) = {"
FN
sq
gd
sq
FN
FN
Pt
FN
FN
FN
FN
FN
FN
FN
FN
"}
(10,1,1) = {"
FN
Rs
SS
Rs
FN
LT
IE
WM
DP
DP
DP
YW
no
ni
FN
"}
(11,1,1) = {"
FN
FN
FN
FN
FN
PH
so
RM
RM
RM
RM
xA
ZY
Zj
FN
"}
(12,1,1) = {"
FN
yy
aC
aC
Mo
Hl
iK
FN
kh
pS
kh
FN
Hl
iK
FN
"}
(13,1,1) = {"
FN
PJ
Uy
Uy
dB
Hl
WL
FN
DF
DF
DF
FN
PA
iK
FN
"}
(14,1,1) = {"
FN
mn
UP
aC
dB
ri
vg
iL
sn
CD
sn
Mp
WT
vg
FN
"}
(15,1,1) = {"
FN
Uy
Uy
Uy
dB
kz
ER
FN
BK
sV
BK
FN
oU
XU
FN
"}
(16,1,1) = {"
FN
FN
FN
FN
FN
FN
FN
FN
FN
FN
FN
FN
FN
FN
FN
"}
