//MAP CONVERTED BY dmm2tgm.py THIS HEADER COMMENT PREVENTS RECONVERSION, DO NOT REMOVE
"aC" = (
/turf/closed/indestructible/steel,
/area/misc/hilbertshotel)
"ca" = (
/turf/closed/indestructible/rock,
/area/misc/hilbertshotel)
"cy" = (
/obj/machinery/atmospherics/components/unary/vent_scrubber/on/layer4{
	dir = 1
	},
/obj/effect/turf_decal/stripes/line{
	dir = 4;
	plane = -3
	},
/turf/open/floor/plating,
/area/misc/hilbertshotel)
"fC" = (
/obj/structure/lattice/catwalk,
/obj/structure/railing{
	dir = 1
	},
/obj/structure/marker_beacon/burgundy,
/turf/open/floor/fakespace,
/area/misc/hilbertshotel)
"jT" = (
/turf/open/floor/fakespace,
/area/misc/hilbertshotel)
"kH" = (
/obj/machinery/atmospherics/pipe/smart/manifold4w/supply/hidden{
	dir = 4
	},
/turf/closed/indestructible/steel,
/area/misc/hilbertshotel)
"sq" = (
/obj/item/toy/plush/lizard_plushie/space{
	pixel_y = 32
	},
/turf/open/floor/fakespace,
/area/misc/hilbertshotel)
"sB" = (
/turf/closed/indestructible/hoteldoor{
	icon_state = "closed";
	icon = 'modular_skyrat/modules/aesthetics/airlock/icons/airlocks/external/external.dmi'
	},
/area/misc/hilbertshotel)
"uI" = (
/obj/effect/light_emitter/fake_outdoors,
/turf/open/floor/fakespace,
/area/misc/hilbertshotel)
"yE" = (
/obj/structure/lattice,
/turf/open/floor/fakespace,
/area/misc/hilbertshotel)
"Ap" = (
/obj/machinery/atmospherics/pipe/smart/manifold4w/scrubbers/hidden/layer4{
	dir = 4
	},
/obj/structure/falsewall,
/obj/structure/fans/tiny/invisible,
/turf/open/floor/plating,
/area/misc/hilbertshotel)
"Bp" = (
/obj/effect/turf_decal/stripes/line{
	dir = 4;
	plane = -3
	},
/obj/machinery/suit_storage_unit/standard_unit,
/turf/open/floor/plating,
/area/misc/hilbertshotel)
"Do" = (
/obj/structure/tank_dispenser/oxygen,
/obj/machinery/light/directional/south,
/turf/open/floor/plating,
/area/misc/hilbertshotel)
"FN" = (
/turf/closed/wall/space{
	space_lit = 1
	},
/area/misc/hilbertshotel)
"MT" = (
/obj/effect/spawner/structure/window/reinforced,
/turf/open/floor/plating,
/area/misc/hilbertshotel)
"Nr" = (
/obj/machinery/atmospherics/components/tank/air,
/turf/open/floor/plating/airless,
/area/misc/hilbertshotel)
"QV" = (
/obj/machinery/atmospherics/pipe/smart/manifold4w/supply/hidden{
	dir = 4
	},
/obj/machinery/suit_storage_unit/standard_unit,
/turf/open/floor/plating/airless,
/area/misc/hilbertshotel)
"SS" = (
/obj/machinery/atmospherics/components/unary/vent_pump/on{
	dir = 1
	},
/turf/open/floor/plating,
/area/misc/hilbertshotel)
"UI" = (
/obj/machinery/door/airlock/external/glass,
/turf/open/floor/plating,
/area/misc/hilbertshotel)
"Wl" = (
/obj/structure/lattice/catwalk,
/obj/structure/marker_beacon/cerulean,
/turf/open/floor/fakespace,
/area/misc/hilbertshotel)
"Wz" = (
/obj/machinery/atmospherics/components/unary/outlet_injector/layer4,
/turf/open/floor/plating/airless,
/area/misc/hilbertshotel)
"Xw" = (
/obj/structure/lattice/catwalk,
/obj/structure/railing,
/obj/structure/marker_beacon/burgundy,
/turf/open/floor/fakespace,
/area/misc/hilbertshotel)
"XT" = (
/obj/machinery/atmospherics/pipe/smart/manifold4w/scrubbers/hidden/layer4{
	dir = 4
	},
/turf/open/floor/plating/airless,
/area/misc/hilbertshotel)

(1,1,1) = {"
ca
ca
ca
ca
ca
aC
sB
aC
aC
ca
ca
ca
ca
ca
ca
"}
(2,1,1) = {"
ca
Nr
Nr
QV
QV
kH
SS
Do
aC
aC
aC
aC
aC
aC
aC
"}
(3,1,1) = {"
ca
Wz
XT
XT
XT
Ap
cy
Bp
aC
yE
yE
jT
yE
jT
FN
"}
(4,1,1) = {"
aC
aC
aC
aC
aC
aC
UI
MT
aC
jT
yE
jT
Wl
jT
FN
"}
(5,1,1) = {"
FN
jT
yE
jT
jT
jT
fC
Xw
jT
jT
Wl
jT
jT
jT
FN
"}
(6,1,1) = {"
FN
jT
Wl
jT
jT
jT
jT
jT
jT
jT
jT
jT
jT
jT
FN
"}
(7,1,1) = {"
FN
jT
jT
uI
jT
jT
jT
uI
jT
jT
jT
uI
jT
jT
FN
"}
(8,1,1) = {"
FN
jT
jT
jT
jT
jT
jT
jT
jT
jT
jT
jT
jT
jT
FN
"}
(9,1,1) = {"
FN
jT
jT
jT
jT
jT
jT
jT
jT
jT
jT
jT
jT
jT
FN
"}
(10,1,1) = {"
FN
jT
jT
uI
jT
jT
jT
uI
jT
jT
jT
uI
jT
jT
FN
"}
(11,1,1) = {"
FN
jT
jT
jT
jT
jT
jT
jT
jT
jT
jT
jT
jT
jT
FN
"}
(12,1,1) = {"
FN
jT
jT
jT
jT
jT
jT
jT
jT
jT
jT
jT
jT
jT
FN
"}
(13,1,1) = {"
FN
jT
jT
uI
jT
jT
jT
uI
jT
jT
jT
uI
jT
jT
FN
"}
(14,1,1) = {"
FN
sq
jT
jT
jT
jT
jT
jT
jT
jT
jT
jT
jT
jT
FN
"}
(15,1,1) = {"
FN
jT
jT
jT
jT
jT
jT
jT
jT
jT
jT
jT
jT
jT
FN
"}
(16,1,1) = {"
FN
FN
FN
FN
FN
FN
FN
FN
FN
FN
FN
FN
FN
FN
FN
"}
