//MAP CONVERTED BY dmm2tgm.py THIS HEADER COMMENT PREVENTS RECONVERSION, DO NOT REMOVE
"aC" = (
/turf/closed/indestructible/steel,
/area/misc/condo)
"ca" = (
/turf/closed/indestructible/rock,
/area/misc/condo)
"cy" = (
/obj/machinery/atmospherics/components/unary/vent_scrubber/on/layer4{
	dir = 1
	},
/obj/effect/turf_decal/stripes/line{
	dir = 4;
	plane = -3
	},
/turf/open/floor/plating,
/area/misc/condo)
"fC" = (
/obj/structure/lattice/catwalk,
/obj/structure/railing{
	dir = 1
	},
/obj/structure/marker_beacon/burgundy,
/turf/open/floor/fakespace,
/area/misc/condo)
"kH" = (
/obj/machinery/atmospherics/pipe/smart/manifold4w/supply/hidden{
	dir = 4
	},
/turf/closed/indestructible/steel,
/area/misc/condo)
"sq" = (
/obj/item/toy/plush/lizard_plushie/space{
	pixel_y = 32
	},
/turf/open/floor/fakespace,
/area/misc/condo)
"sB" = (
/turf/closed/indestructible/hoteldoor{
	icon_state = "closed";
	icon = 'modular_skyrat/modules/aesthetics/airlock/icons/airlocks/external/external.dmi'
	},
/area/misc/condo)
"uI" = (
/obj/effect/light_emitter/fake_outdoors,
/turf/open/floor/fakespace,
/area/misc/condo)
"yE" = (
/obj/structure/lattice,
/turf/open/floor/fakespace,
/area/misc/condo)
"Ap" = (
/obj/machinery/atmospherics/pipe/smart/manifold4w/scrubbers/hidden/layer4{
	dir = 4
	},
/obj/structure/falsewall,
/obj/structure/fans/tiny/invisible,
/turf/open/floor/plating,
/area/misc/condo)
"Bp" = (
/obj/effect/turf_decal/stripes/line{
	dir = 4;
	plane = -3
	},
/obj/machinery/suit_storage_unit/standard_unit,
/turf/open/floor/plating,
/area/misc/condo)
"Do" = (
/obj/structure/tank_dispenser/oxygen,
/obj/machinery/light/directional/south,
/turf/open/floor/plating,
/area/misc/condo)
"FN" = (
/turf/closed/wall/space{
	space_lit = 1
	},
/area/misc/condo)
"MT" = (
/obj/effect/spawner/structure/window/reinforced,
/turf/open/floor/plating,
/area/misc/condo)
"Nr" = (
/obj/machinery/atmospherics/components/tank/air,
/turf/open/floor/plating,
/area/misc/condo)
"QV" = (
/obj/machinery/atmospherics/pipe/smart/manifold4w/supply/hidden{
	dir = 4
	},
/obj/machinery/suit_storage_unit/standard_unit,
/turf/open/floor/plating,
/area/misc/condo)
"SS" = (
/obj/machinery/atmospherics/components/unary/vent_pump/on{
	dir = 1
	},
/turf/open/floor/plating,
/area/misc/condo)
"UI" = (
/obj/machinery/door/airlock/external/glass,
/turf/open/floor/plating,
/area/misc/condo)
"VH" = (
/turf/open/floor/fakespace,
/area/misc/condo)
"Wl" = (
/obj/structure/lattice/catwalk,
/obj/structure/marker_beacon/cerulean,
/turf/open/floor/fakespace,
/area/misc/condo)
"Wz" = (
/obj/machinery/atmospherics/components/unary/outlet_injector/layer4,
/turf/open/floor/plating,
/area/misc/condo)
"Xw" = (
/obj/structure/lattice/catwalk,
/obj/structure/railing,
/obj/structure/marker_beacon/burgundy,
/turf/open/floor/fakespace,
/area/misc/condo)
"XT" = (
/obj/machinery/atmospherics/pipe/smart/manifold4w/scrubbers/hidden/layer4{
	dir = 4
	},
/turf/open/floor/plating,
/area/misc/condo)

(1,1,1) = {"
ca
ca
ca
ca
ca
aC
sB
aC
aC
ca
ca
ca
ca
ca
ca
"}
(2,1,1) = {"
ca
Nr
Nr
QV
QV
kH
SS
Do
aC
aC
aC
aC
aC
aC
aC
"}
(3,1,1) = {"
ca
Wz
XT
XT
XT
Ap
cy
Bp
aC
yE
yE
VH
yE
VH
FN
"}
(4,1,1) = {"
aC
aC
aC
aC
aC
aC
UI
MT
aC
VH
yE
VH
Wl
VH
FN
"}
(5,1,1) = {"
FN
VH
yE
VH
VH
VH
fC
Xw
VH
VH
Wl
VH
VH
VH
FN
"}
(6,1,1) = {"
FN
VH
Wl
VH
VH
VH
VH
VH
VH
VH
VH
VH
VH
VH
FN
"}
(7,1,1) = {"
FN
VH
VH
uI
VH
VH
VH
uI
VH
VH
VH
uI
VH
VH
FN
"}
(8,1,1) = {"
FN
VH
VH
VH
VH
VH
VH
VH
VH
VH
VH
VH
VH
VH
FN
"}
(9,1,1) = {"
FN
VH
VH
VH
VH
VH
VH
VH
VH
VH
VH
VH
VH
VH
FN
"}
(10,1,1) = {"
FN
VH
VH
uI
VH
VH
VH
uI
VH
VH
VH
uI
VH
VH
FN
"}
(11,1,1) = {"
FN
VH
VH
VH
VH
VH
VH
VH
VH
VH
VH
VH
VH
VH
FN
"}
(12,1,1) = {"
FN
VH
VH
VH
VH
VH
VH
VH
VH
VH
VH
VH
VH
VH
FN
"}
(13,1,1) = {"
FN
VH
VH
uI
VH
VH
VH
uI
VH
VH
VH
uI
VH
VH
FN
"}
(14,1,1) = {"
FN
sq
VH
VH
VH
VH
VH
VH
VH
VH
VH
VH
VH
VH
FN
"}
(15,1,1) = {"
FN
VH
VH
VH
VH
VH
VH
VH
VH
VH
VH
VH
VH
VH
FN
"}
(16,1,1) = {"
FN
FN
FN
FN
FN
FN
FN
FN
FN
FN
FN
FN
FN
FN
FN
"}
