//MAP CONVERTED BY dmm2tgm.py THIS HEADER COMMENT PREVENTS RECONVERSION, DO NOT REMOVE
"aj" = (
/obj/structure/table/wood/shuttle_bar,
/obj/item/storage/box/matches,
/obj/item/cigarette/cigar{
	pixel_x = 7;
	pixel_y = 10
	},
/obj/machinery/firealarm/directional/west{
	soundloop = /datum/looping_sound/firealarm;
	appearance_power_state = 0;
	is_operational = 0
	},
/turf/open/indestructible/hotelwood{
	force_no_gravity = 1
	},
/area/misc/condo)
"ay" = (
/obj/effect/mapping_helpers/broken_floor,
/obj/effect/spawner/random/trash/moisture_trap,
/turf/open/indestructible/plating{
	force_no_gravity = 1
	},
/area/misc/condo)
"aD" = (
/obj/effect/mapping_helpers/broken_floor,
/obj/effect/mob_spawn/corpse/human/scientist,
/turf/open/indestructible/plating{
	force_no_gravity = 1
	},
/area/misc/condo)
"aG" = (
/obj/machinery/atmospherics/pipe/smart/manifold/scrubbers/hidden/layer4,
/obj/machinery/atmospherics/pipe/smart/manifold/supply/hidden/layer2,
/obj/structure/cable,
/turf/closed/indestructible/titanium,
/area/misc/condo)
"bl" = (
/obj/structure/sign/poster/official/safety_internals/directional/north,
/turf/open/indestructible/dark/textured{
	force_no_gravity = 1;
	name = "Dark Tiling"
	},
/area/misc/condo)
"cA" = (
/obj/effect/mapping_helpers/broken_floor,
/obj/machinery/hydroponics/constructable,
/obj/effect/mapping_helpers/broken_machine,
/turf/open/indestructible/dark/textured{
	force_no_gravity = 1;
	name = "Dark Tiling"
	},
/area/misc/condo)
"cK" = (
/obj/effect/mapping_helpers/burnt_floor,
/obj/machinery/light/red/dim/directional/south,
/turf/open/indestructible/dark/textured{
	force_no_gravity = 1;
	name = "Dark Tiling"
	},
/area/misc/condo)
"cO" = (
/obj/machinery/atmospherics/pipe/smart/manifold/supply/hidden/layer2,
/turf/open/indestructible/dark/textured{
	force_no_gravity = 1;
	name = "Dark Tiling"
	},
/area/misc/condo)
"dS" = (
/obj/machinery/atmospherics/components/unary/vent_pump/on/layer2,
/turf/open/indestructible/dark/textured{
	force_no_gravity = 1;
	name = "Dark Tiling"
	},
/area/misc/condo)
"dY" = (
/obj/machinery/modular_computer/preset/research{
	is_operational = 0;
	name = "Research Terminal";
	desc = "A stationary Research computer. This one appears to have been wiped clean and displays an Evactuation order."
	},
/obj/machinery/light/broken/directional/north,
/turf/open/indestructible/dark/textured{
	force_no_gravity = 1;
	name = "Dark Tiling"
	},
/area/misc/condo)
"eM" = (
/obj/machinery/rnd/production/protolathe/department/science{
	on_station_lathe = 0;
	is_operational = 0;
	name = "Cloning Lab Lathe"
	},
/turf/open/indestructible/dark/textured{
	force_no_gravity = 1;
	name = "Dark Tiling"
	},
/area/misc/condo)
"eZ" = (
/obj/structure/chair/comfy/brown{
	dir = 8
	},
/turf/open/indestructible/hotelwood{
	force_no_gravity = 1
	},
/area/misc/condo)
"fM" = (
/obj/machinery/firealarm/directional/west{
	soundloop = /datum/looping_sound/firealarm;
	appearance_power_state = 0;
	is_operational = 0
	},
/obj/item/flashlight/flare{
	start_on = 1
	},
/obj/item/crowbar/large,
/turf/open/indestructible/dark/textured{
	force_no_gravity = 1;
	name = "Dark Tiling"
	},
/area/misc/condo)
"gG" = (
/obj/structure/cable,
/obj/machinery/atmospherics/pipe/smart/manifold/supply/hidden/layer2,
/obj/machinery/atmospherics/pipe/smart/manifold/scrubbers/hidden/layer4,
/turf/closed/indestructible/hoteldoor{
	icon_state = "closed";
	icon = 'modular_skyrat/modules/aesthetics/airlock/icons/airlocks/station2/glass.dmi';
	baseturfs = /turf/open/indestructible/plating
	},
/area/misc/condo)
"ia" = (
/obj/item/wallframe/intercom,
/turf/closed/indestructible/titanium{
	baseturfs = /turf/open/indestructible/plating
	},
/area/misc/condo)
"jp" = (
/turf/open/indestructible/dark/textured{
	force_no_gravity = 1;
	name = "Dark Tiling"
	},
/area/misc/condo)
"jx" = (
/obj/effect/spawner/structure/window/reinforced/plasma,
/obj/structure/cable,
/obj/effect/mapping_helpers/damaged_window,
/obj/effect/mapping_helpers/damaged_window,
/turf/open/indestructible/plating{
	force_no_gravity = 1
	},
/area/misc/condo)
"jK" = (
/obj/effect/mapping_helpers/burnt_floor,
/obj/machinery/light/broken/directional/north,
/obj/machinery/vending/hydronutrients,
/turf/open/indestructible/dark/textured{
	force_no_gravity = 1;
	name = "Dark Tiling"
	},
/area/misc/condo)
"jV" = (
/obj/effect/spawner/structure/window/reinforced/plasma,
/obj/structure/cable,
/obj/effect/mapping_helpers/damaged_window,
/turf/open/indestructible/plating{
	force_no_gravity = 1
	},
/area/misc/condo)
"kg" = (
/obj/machinery/atmospherics/pipe/smart/manifold/supply/hidden/layer2,
/obj/machinery/atmospherics/pipe/smart/manifold/scrubbers/hidden/layer4,
/turf/open/indestructible/hotelwood{
	force_no_gravity = 1
	},
/area/misc/condo)
"kG" = (
/obj/machinery/atmospherics/pipe/smart/manifold/supply/hidden/layer2,
/obj/machinery/atmospherics/pipe/smart/manifold/scrubbers/hidden/layer4,
/turf/closed/indestructible/titanium{
	baseturfs = /turf/open/indestructible/plating
	},
/area/misc/condo)
"kJ" = (
/obj/structure/table/wood/shuttle_bar,
/obj/machinery/light/very_dim/directional/east,
/turf/open/indestructible/hotelwood{
	force_no_gravity = 1
	},
/area/misc/condo)
"kX" = (
/obj/machinery/atmospherics/pipe/smart/manifold/supply/hidden/layer2,
/obj/effect/turf_decal/vg_decals/atmos/air,
/turf/open/indestructible/plating{
	force_no_gravity = 1
	},
/area/misc/condo)
"lz" = (
/obj/structure/cable,
/turf/open/indestructible/plating{
	force_no_gravity = 1
	},
/area/misc/condo)
"me" = (
/obj/structure/closet/emcloset{
	anchored = 1
	},
/turf/open/indestructible/dark/textured{
	force_no_gravity = 1;
	name = "Dark Tiling"
	},
/area/misc/condo)
"ms" = (
/obj/structure/sign/departments/engineering/directional/west,
/turf/open/indestructible/dark/textured{
	force_no_gravity = 1;
	name = "Dark Tiling"
	},
/area/misc/condo)
"mv" = (
/obj/item/melee/baton/security/cattleprod{
	pixel_x = -6;
	pixel_y = 6;
	preload_cell_type = /obj/item/stock_parts/power_store/cell/hyper
	},
/obj/effect/decal/cleanable/blood/old,
/obj/item/restraints/handcuffs/cable/yellow,
/turf/open/indestructible/plating{
	force_no_gravity = 1
	},
/area/misc/condo)
"mH" = (
/obj/machinery/atmospherics/pipe/smart/manifold/scrubbers/hidden/layer4,
/obj/machinery/portable_atmospherics/scrubber,
/turf/open/indestructible/plating{
	force_no_gravity = 1
	},
/area/misc/condo)
"mL" = (
/obj/item/paperwork,
/obj/machinery/atmospherics/components/unary/vent_pump/on/layer2,
/turf/open/indestructible/dark/textured{
	force_no_gravity = 1;
	name = "Dark Tiling"
	},
/area/misc/condo)
"nx" = (
/obj/structure/cable,
/turf/closed/indestructible/titanium{
	baseturfs = /turf/open/indestructible/plating
	},
/area/misc/condo)
"nV" = (
/obj/machinery/atmospherics/components/unary/vent_scrubber/on/layer4,
/turf/open/indestructible/dark/textured{
	force_no_gravity = 1;
	name = "Dark Tiling"
	},
/area/misc/condo)
"oe" = (
/obj/structure/cable,
/obj/machinery/atmospherics/pipe/smart/manifold/supply/hidden/layer2,
/obj/machinery/atmospherics/pipe/smart/manifold/scrubbers/hidden/layer4,
/obj/effect/mapping_helpers/broken_floor,
/turf/open/indestructible/plating{
	force_no_gravity = 1
	},
/area/misc/condo)
"oW" = (
/obj/structure/cable,
/obj/machinery/atmospherics/pipe/smart/manifold/supply/hidden/layer2,
/obj/machinery/atmospherics/pipe/smart/manifold/scrubbers/hidden/layer4,
/turf/open/indestructible/dark/textured{
	force_no_gravity = 1;
	name = "Dark Tiling"
	},
/area/misc/condo)
"pz" = (
/obj/machinery/atmospherics/pipe/smart/manifold/supply/hidden/layer2,
/obj/machinery/atmospherics/pipe/smart/manifold/scrubbers/hidden/layer4,
/obj/structure/table/wood/shuttle_bar,
/obj/item/flashlight/lamp/green{
	pixel_y = 14
	},
/obj/item/reagent_containers/cup/glass/flask/gold{
	pixel_x = 6;
	pixel_y = 5
	},
/turf/open/indestructible/hotelwood{
	force_no_gravity = 1
	},
/area/misc/condo)
"qg" = (
/obj/effect/mapping_helpers/burnt_floor,
/turf/open/indestructible/dark/textured{
	force_no_gravity = 1;
	name = "Dark Tiling"
	},
/area/misc/condo)
"qm" = (
/obj/machinery/atmospherics/pipe/smart/manifold/supply/hidden/layer2,
/obj/machinery/atmospherics/pipe/smart/manifold/scrubbers/hidden/layer4,
/turf/open/floor/wood/tile{
	force_no_gravity = 1
	},
/area/misc/condo)
"qp" = (
/obj/structure/bed/double,
/obj/item/bedsheet/hop/double,
/turf/open/indestructible/hotelwood{
	force_no_gravity = 1
	},
/area/misc/condo)
"qA" = (
/obj/structure/closet/secure_closet/personal/cabinet{
	anchored = 1
	},
/obj/machinery/light/red/dim/directional/east,
/turf/open/indestructible/hotelwood{
	force_no_gravity = 1
	},
/area/misc/condo)
"rs" = (
/obj/structure/cable,
/turf/closed/indestructible/reinforced,
/area/misc/condo)
"rV" = (
/obj/machinery/vending/hydroseeds,
/turf/open/indestructible/dark/textured{
	force_no_gravity = 1;
	name = "Dark Tiling"
	},
/area/misc/condo)
"rX" = (
/obj/structure/closet/crate/internals,
/turf/open/indestructible/dark/textured{
	force_no_gravity = 1;
	name = "Dark Tiling"
	},
/area/misc/condo)
"sH" = (
/turf/closed/indestructible/hoteldoor{
	icon_state = "closed";
	icon = 'modular_skyrat/modules/aesthetics/airlock/icons/airlocks/station2/glass.dmi';
	baseturfs = /turf/open/indestructible/plating
	},
/area/misc/condo)
"tb" = (
/obj/structure/broken_flooring/plating/always_floorplane/directional,
/turf/open/indestructible/plating{
	force_no_gravity = 1
	},
/area/misc/condo)
"tY" = (
/obj/structure/grille/broken,
/turf/open/space/basic,
/area/misc/condo)
"ua" = (
/obj/item/stack/sheet/mineral/titanium{
	pixel_x = 4;
	pixel_y = 4
	},
/obj/effect/mapping_helpers/burnt_floor,
/obj/effect/mapping_helpers/burnt_floor,
/turf/open/indestructible/dark/textured{
	force_no_gravity = 1;
	name = "Dark Tiling"
	},
/area/misc/condo)
"uG" = (
/obj/machinery/atmospherics/components/unary/vent_scrubber/on/layer4,
/obj/machinery/light/red/dim/directional/west,
/turf/open/indestructible/plating{
	force_no_gravity = 1
	},
/area/misc/condo)
"uL" = (
/obj/item/wallframe/light_fixture{
	pixel_x = -7;
	pixel_y = 6
	},
/obj/item/stack/cable_coil/cut,
/obj/item/light/tube/broken,
/turf/open/indestructible/plating{
	force_no_gravity = 1
	},
/area/misc/condo)
"uN" = (
/obj/machinery/atmospherics/components/unary/vent_scrubber/on/layer4,
/turf/open/floor/wood/tile{
	force_no_gravity = 1
	},
/area/misc/condo)
"vu" = (
/obj/effect/decal/cleanable/dirt,
/obj/machinery/light/red/dim/directional/north,
/turf/open/indestructible/dark/textured{
	force_no_gravity = 1;
	name = "Dark Tiling"
	},
/area/misc/condo)
"vI" = (
/obj/machinery/light/red/dim/directional/west,
/turf/open/indestructible/dark/textured{
	force_no_gravity = 1;
	name = "Dark Tiling"
	},
/area/misc/condo)
"vJ" = (
/obj/effect/spawner/structure/window/reinforced/plasma,
/obj/effect/mapping_helpers/damaged_window,
/obj/structure/cable,
/turf/open/indestructible/plating,
/area/misc/condo)
"wn" = (
/obj/structure/closet/firecloset{
	anchored = 1
	},
/turf/open/indestructible/dark/textured{
	force_no_gravity = 1;
	name = "Dark Tiling"
	},
/area/misc/condo)
"wr" = (
/obj/machinery/atmospherics/pipe/smart/manifold/scrubbers/hidden/layer4,
/obj/machinery/atmospherics/pipe/smart/manifold/supply/hidden/layer2,
/obj/structure/cable,
/obj/machinery/door/firedoor/closed,
/turf/open/indestructible/dark/textured{
	force_no_gravity = 1;
	name = "Dark Tiling"
	},
/area/misc/condo)
"yg" = (
/obj/machinery/atmospherics/components/unary/vent_pump/on/layer2,
/turf/open/floor/wood/tile{
	force_no_gravity = 1
	},
/area/misc/condo)
"yT" = (
/obj/effect/decal/cleanable/blood/splatter,
/obj/structure/cable,
/obj/machinery/atmospherics/pipe/smart/manifold/scrubbers/hidden/layer4,
/obj/machinery/atmospherics/pipe/smart/manifold/supply/hidden/layer2,
/obj/item/flashlight,
/turf/open/indestructible/dark/textured{
	force_no_gravity = 1;
	name = "Dark Tiling"
	},
/area/misc/condo)
"yZ" = (
/obj/structure/cable,
/obj/machinery/atmospherics/components/tank/air/layer2,
/turf/open/indestructible/plating{
	force_no_gravity = 1
	},
/area/misc/condo)
"zG" = (
/obj/effect/mapping_helpers/broken_floor,
/turf/open/indestructible/plating{
	force_no_gravity = 1
	},
/area/misc/condo)
"Ak" = (
/obj/machinery/atmospherics/pipe/smart/manifold/scrubbers/hidden/layer4,
/turf/open/floor/wood/tile{
	force_no_gravity = 1
	},
/area/misc/condo)
"Au" = (
/obj/effect/decal/cleanable/dirt,
/obj/effect/spawner/random/structure/closet_maintenance,
/turf/open/indestructible/plating{
	force_no_gravity = 1
	},
/area/misc/condo)
"Ax" = (
/obj/item/wallframe/firecloset,
/turf/closed/indestructible/titanium{
	baseturfs = /turf/open/indestructible/plating
	},
/area/misc/condo)
"AA" = (
/obj/structure/filingcabinet,
/turf/open/indestructible/dark/textured{
	force_no_gravity = 1;
	name = "Dark Tiling"
	},
/area/misc/condo)
"Bl" = (
/obj/machinery/power/smes,
/obj/structure/cable,
/turf/open/indestructible/plating{
	force_no_gravity = 1
	},
/area/misc/condo)
"Bu" = (
/obj/machinery/door/airlock/rd,
/obj/machinery/door/firedoor/closed,
/turf/open/indestructible/hotelwood{
	force_no_gravity = 1
	},
/area/misc/condo)
"BE" = (
/obj/structure/table/reinforced/plasmarglass,
/obj/machinery/recharger,
/obj/item/paper_bin/carbon{
	pixel_x = -5;
	pixel_y = 6
	},
/obj/structure/cable,
/obj/machinery/light/red/dim/directional/south,
/obj/item/paper{
	pixel_x = 7;
	pixel_y = 8;
	name = "ATTENTION!";
	default_raw_text = "<B>ATTENTION!</B><BR><BR>This is a hand-typed letter from Research Director D. Warner. The Hydroponics-Cloning Farm has been engulfed by an unknown Anomaly simply referred to as a 'Void flux'. If you are reading this, and this portion of the station has yet not been safely recovered from whatever depths of presumably the void it resides in, proceed to the Bluespace Network pad down the Eastern Corridor.<BR><BR>-Signed, Research Director D. Warner"
	},
/turf/open/indestructible/dark/textured{
	force_no_gravity = 1;
	name = "Dark Tiling"
	},
/area/misc/condo)
"Cd" = (
/obj/effect/spawner/structure/window/reinforced/plasma,
/obj/structure/cable,
/turf/open/indestructible/plating{
	force_no_gravity = 1
	},
/area/misc/condo)
"Cq" = (
/obj/machinery/door/airlock/research,
/obj/machinery/door/firedoor/closed,
/turf/open/indestructible/dark/textured{
	force_no_gravity = 1;
	name = "Dark Tiling"
	},
/area/misc/condo)
"CM" = (
/obj/structure/cable,
/obj/machinery/atmospherics/pipe/smart/manifold/supply/hidden/layer2,
/obj/machinery/atmospherics/pipe/smart/manifold/scrubbers/hidden/layer4,
/obj/machinery/door/airlock/maintenance_hatch,
/obj/machinery/door/firedoor/closed,
/turf/open/indestructible/dark/textured{
	force_no_gravity = 1;
	name = "Dark Tiling"
	},
/area/misc/condo)
"Dc" = (
/obj/structure/trash_pile,
/turf/open/indestructible/plating{
	force_no_gravity = 1
	},
/area/misc/condo)
"DS" = (
/obj/structure/cable,
/obj/machinery/atmospherics/pipe/smart/manifold/supply/hidden/layer2,
/obj/machinery/atmospherics/pipe/smart/manifold/scrubbers/hidden/layer4,
/turf/open/indestructible/plating{
	force_no_gravity = 1
	},
/area/misc/condo)
"Ed" = (
/obj/effect/mapping_helpers/broken_floor,
/turf/open/indestructible/dark/textured{
	force_no_gravity = 1;
	name = "Dark Tiling"
	},
/area/misc/condo)
"Ew" = (
/obj/effect/mapping_helpers/burnt_floor,
/obj/machinery/hydroponics/constructable,
/obj/effect/mapping_helpers/broken_machine,
/turf/open/indestructible/dark/textured{
	force_no_gravity = 1;
	name = "Dark Tiling"
	},
/area/misc/condo)
"EB" = (
/obj/effect/decal/cleanable/dirt,
/turf/open/indestructible/plating{
	force_no_gravity = 1
	},
/area/misc/condo)
"Fc" = (
/obj/structure/closet/l3closet/scientist{
	anchored = 1
	},
/turf/open/indestructible/dark/textured{
	force_no_gravity = 1;
	name = "Dark Tiling"
	},
/area/misc/condo)
"FB" = (
/obj/machinery/light/red/dim/directional/south,
/turf/open/indestructible/dark/textured{
	force_no_gravity = 1;
	name = "Dark Tiling"
	},
/area/misc/condo)
"Gq" = (
/obj/effect/spawner/structure/window/reinforced/plasma,
/obj/structure/grille/broken,
/obj/structure/cable,
/turf/open/indestructible/plating{
	force_no_gravity = 1
	},
/area/misc/condo)
"Ht" = (
/obj/machinery/atmospherics/pipe/smart/manifold/scrubbers/hidden/layer4,
/obj/machinery/atmospherics/pipe/smart/manifold/supply/hidden/layer2,
/obj/structure/cable,
/obj/machinery/light/red/dim/directional/south,
/turf/open/indestructible/dark/textured{
	force_no_gravity = 1;
	name = "Dark Tiling"
	},
/area/misc/condo)
"IN" = (
/obj/effect/spawner/structure/window/reinforced/plasma,
/obj/machinery/atmospherics/pipe/smart/manifold/scrubbers/hidden/layer4,
/obj/machinery/atmospherics/pipe/smart/manifold/supply/hidden/layer2,
/obj/structure/cable,
/turf/open/indestructible/dark/textured{
	force_no_gravity = 1;
	name = "Dark Tiling"
	},
/area/misc/condo)
"IP" = (
/obj/structure/cable,
/obj/machinery/atmospherics/pipe/smart/manifold/supply/hidden/layer2,
/obj/machinery/atmospherics/pipe/smart/manifold/scrubbers/hidden/layer4,
/obj/effect/decal/cleanable/dirt,
/turf/open/indestructible/plating{
	force_no_gravity = 1
	},
/area/misc/condo)
"IY" = (
/obj/item/crowbar/large,
/turf/open/indestructible/dark/textured{
	force_no_gravity = 1;
	name = "Dark Tiling"
	},
/area/misc/condo)
"Jr" = (
/turf/closed/indestructible/titanium,
/area/misc/condo)
"Ju" = (
/obj/item/clothing/shoes/magboots/advance,
/obj/item/clothing/shoes/magboots/advance{
	pixel_x = 4;
	pixel_y = -8
	},
/turf/open/indestructible/dark/textured{
	force_no_gravity = 1;
	name = "Dark Tiling"
	},
/area/misc/condo)
"Ka" = (
/turf/open/indestructible/hotelwood{
	force_no_gravity = 1
	},
/area/misc/condo)
"KJ" = (
/obj/machinery/atmospherics/pipe/smart/manifold/scrubbers/hidden/layer4,
/obj/machinery/atmospherics/pipe/smart/manifold/supply/hidden/layer2,
/obj/structure/cable,
/obj/structure/sign/departments/maint/directional/south,
/turf/open/indestructible/dark/textured{
	force_no_gravity = 1;
	name = "Dark Tiling"
	},
/area/misc/condo)
"Lo" = (
/obj/effect/decal/cleanable/dirt,
/obj/machinery/door/airlock/engineering,
/obj/machinery/door/firedoor/closed,
/turf/open/indestructible/plating{
	force_no_gravity = 1
	},
/area/misc/condo)
"Lz" = (
/obj/structure/dresser,
/turf/open/indestructible/hotelwood{
	force_no_gravity = 1
	},
/area/misc/condo)
"Mc" = (
/turf/open/space/basic,
/area/misc/condo)
"My" = (
/obj/item/stack/sheet/mineral/titanium{
	pixel_x = -7;
	pixel_y = 5
	},
/obj/structure/cable,
/turf/closed/indestructible/titanium{
	baseturfs = /turf/open/indestructible/plating
	},
/area/misc/condo)
"ME" = (
/obj/effect/mapping_helpers/broken_floor,
/obj/structure/reagent_dispensers/watertank,
/turf/open/indestructible/plating{
	force_no_gravity = 1
	},
/area/misc/condo)
"MK" = (
/obj/effect/decal/cleanable/dirt,
/turf/closed/indestructible/hoteldoor{
	icon_state = "closed";
	icon = 'modular_skyrat/modules/aesthetics/airlock/icons/airlocks/station2/glass.dmi';
	baseturfs = /turf/open/indestructible/plating
	},
/area/misc/condo)
"Nb" = (
/obj/item/stack/rods{
	amount = 8
	},
/obj/effect/spawner/structure/window/reinforced/plasma,
/obj/structure/cable,
/obj/effect/mapping_helpers/damaged_window,
/turf/open/indestructible/plating{
	force_no_gravity = 1
	},
/area/misc/condo)
"Oe" = (
/obj/effect/spawner/structure/window/reinforced/plasma,
/obj/effect/mapping_helpers/damaged_window,
/turf/open/indestructible/plating,
/area/misc/condo)
"PC" = (
/obj/machinery/firealarm/directional/north{
	soundloop = /datum/looping_sound/firealarm;
	appearance_power_state = 0;
	is_operational = 0
	},
/obj/machinery/atmospherics/components/unary/vent_scrubber/on/layer4,
/turf/open/indestructible/dark/textured{
	force_no_gravity = 1;
	name = "Dark Tiling"
	},
/area/misc/condo)
"PP" = (
/obj/effect/mapping_helpers/broken_floor,
/obj/machinery/atmospherics/pipe/smart/manifold/scrubbers/hidden/layer4,
/obj/machinery/atmospherics/pipe/smart/manifold/supply/hidden/layer2,
/obj/structure/cable,
/turf/open/indestructible/dark/textured{
	force_no_gravity = 1;
	name = "Dark Tiling"
	},
/area/misc/condo)
"QK" = (
/obj/machinery/atmospherics/pipe/smart/manifold/scrubbers/hidden/layer4,
/turf/closed/indestructible/titanium,
/area/misc/condo)
"QO" = (
/obj/machinery/door/airlock/multi_tile/metal,
/obj/machinery/atmospherics/pipe/smart/manifold/scrubbers/hidden/layer4,
/obj/machinery/atmospherics/pipe/smart/manifold/supply/hidden/layer2,
/obj/structure/cable,
/turf/open/indestructible/dark/textured{
	force_no_gravity = 1;
	name = "Dark Tiling"
	},
/area/misc/condo)
"Re" = (
/obj/effect/mapping_helpers/burnt_floor,
/obj/machinery/hydroponics/constructable,
/turf/open/indestructible/dark/textured{
	force_no_gravity = 1;
	name = "Dark Tiling"
	},
/area/misc/condo)
"Rt" = (
/turf/closed/indestructible/titanium{
	baseturfs = /turf/open/indestructible/plating
	},
/area/misc/condo)
"SL" = (
/obj/effect/spawner/structure/window/reinforced/plasma,
/turf/open/indestructible/plating,
/area/misc/condo)
"Tx" = (
/obj/structure/girder/reinforced,
/obj/item/stack/sheet/mineral/titanium{
	pixel_x = 4;
	pixel_y = 4
	},
/obj/effect/mapping_helpers/broken_floor,
/turf/open/indestructible/plating,
/area/misc/condo)
"TR" = (
/obj/effect/decal/cleanable/dirt,
/obj/machinery/atmospherics/pipe/smart/manifold/supply/hidden/layer2,
/obj/machinery/door/airlock/maintenance_hatch,
/obj/machinery/door/firedoor/closed,
/turf/open/indestructible/plating{
	force_no_gravity = 1
	},
/area/misc/condo)
"TY" = (
/obj/effect/mapping_helpers/broken_floor,
/obj/effect/decal/cleanable/glass/plasma,
/turf/open/indestructible/plating{
	force_no_gravity = 1
	},
/area/misc/condo)
"Ul" = (
/obj/machinery/hydroponics/constructable,
/obj/machinery/atmospherics/pipe/smart/manifold/scrubbers/hidden/layer4,
/obj/machinery/atmospherics/pipe/smart/manifold/supply/hidden/layer2,
/obj/structure/cable,
/turf/open/indestructible/dark/textured{
	force_no_gravity = 1;
	name = "Dark Tiling"
	},
/area/misc/condo)
"Uw" = (
/turf/open/indestructible/dark/textured{
	icon = 'modular_zubbers/icons/space/space.dmi';
	icon_state = "space";
	name = "space"
	},
/area/misc/condo)
"UN" = (
/obj/structure/cable,
/obj/structure/closet/secure_closet/engineering_welding{
	anchored = 1
	},
/turf/open/indestructible/plating{
	force_no_gravity = 1
	},
/area/misc/condo)
"UO" = (
/obj/effect/decal/cleanable/dirt,
/obj/machinery/firealarm/directional/west{
	soundloop = /datum/looping_sound/firealarm;
	appearance_power_state = 0;
	is_operational = 0
	},
/turf/open/indestructible/plating{
	force_no_gravity = 1
	},
/area/misc/condo)
"Vh" = (
/obj/structure/cable,
/obj/effect/decal/cleanable/dirt,
/obj/structure/closet/secure_closet/engineering_electrical{
	anchored = 1
	},
/turf/open/indestructible/plating{
	force_no_gravity = 1
	},
/area/misc/condo)
"Vj" = (
/obj/effect/spawner/random/trash/grime,
/turf/open/indestructible/plating{
	force_no_gravity = 1
	},
/area/misc/condo)
"Wd" = (
/obj/structure/girder/reinforced,
/obj/item/stack/sheet/mineral/titanium{
	pixel_x = -7;
	pixel_y = 5
	},
/obj/effect/mapping_helpers/broken_floor,
/turf/open/indestructible/plating,
/area/misc/condo)
"Wm" = (
/obj/item/flashlight,
/turf/open/indestructible/dark/textured{
	force_no_gravity = 1;
	name = "Dark Tiling"
	},
/area/misc/condo)
"WL" = (
/obj/machinery/atmospherics/pipe/smart/manifold/scrubbers/hidden/layer4,
/obj/machinery/atmospherics/pipe/smart/manifold/supply/hidden/layer2,
/obj/structure/cable,
/turf/open/indestructible/dark/textured{
	force_no_gravity = 1;
	name = "Dark Tiling"
	},
/area/misc/condo)
"Xm" = (
/obj/effect/decal/cleanable/glass/plasma,
/turf/open/indestructible/dark/textured{
	force_no_gravity = 1;
	name = "Dark Tiling"
	},
/area/misc/condo)
"Xt" = (
/obj/item/stack/rods{
	amount = 12
	},
/obj/effect/spawner/structure/window/reinforced/plasma,
/obj/structure/cable,
/obj/effect/mapping_helpers/damaged_window,
/turf/open/indestructible/plating{
	force_no_gravity = 1
	},
/area/misc/condo)
"Xy" = (
/obj/effect/mob_spawn/corpse/human/scientist,
/turf/open/indestructible/dark/textured{
	force_no_gravity = 1;
	name = "Dark Tiling"
	},
/area/misc/condo)
"Yh" = (
/obj/structure/grille/broken,
/obj/effect/decal/cleanable/glass/plasma,
/turf/open/indestructible/plating{
	force_no_gravity = 1
	},
/area/misc/condo)
"Yk" = (
/obj/machinery/hydroponics/constructable,
/turf/open/indestructible/dark/textured{
	force_no_gravity = 1;
	name = "Dark Tiling"
	},
/area/misc/condo)
"Zf" = (
/obj/effect/mapping_helpers/broken_floor,
/obj/effect/decal/cleanable/glass/plasma,
/obj/structure/frame/machine/secured,
/turf/open/indestructible/plating,
/area/misc/condo)
"Zh" = (
/obj/effect/spawner/structure/window/reinforced/plasma,
/obj/structure/cable,
/turf/open/indestructible/plating,
/area/misc/condo)
"Zk" = (
/obj/machinery/atmospherics/components/unary/vent_pump/on/layer2,
/turf/open/indestructible/plating{
	force_no_gravity = 1
	},
/area/misc/condo)
"Zs" = (
/obj/machinery/gulag_teleporter{
	is_operational = 0;
	name = "Cloning Chamber";
	desc = "A deactivated Cloning Pod designed for the Hydroponics Research Wing."
	},
/turf/open/indestructible/dark/textured{
	force_no_gravity = 1;
	name = "Dark Tiling"
	},
/area/misc/condo)
"ZQ" = (
/obj/machinery/cryopod{
	dir = 1
	},
/turf/open/indestructible/dark/textured{
	force_no_gravity = 1;
	name = "Dark Tiling"
	},
/area/misc/condo)

(1,1,1) = {"
vJ
vJ
Zh
nx
Rt
Rt
Rt
Rt
Rt
Rt
Rt
Rt
Rt
Mc
Mc
"}
(2,1,1) = {"
vJ
Zs
Ju
AA
fM
rX
Fc
Rt
Bl
UO
uG
mH
QK
gG
Rt
"}
(3,1,1) = {"
Zh
eM
Wm
IY
mL
cO
ZQ
Rt
Vh
EB
Zk
kX
TR
DS
Rt
"}
(4,1,1) = {"
nx
dY
jp
mv
nV
yT
BE
nx
UN
lz
lz
yZ
nx
DS
SL
"}
(5,1,1) = {"
rs
nx
Wd
Tx
Cq
aG
Rt
Rt
Rt
Lo
Rt
Rt
Rt
DS
Oe
"}
(6,1,1) = {"
Mc
Zh
uL
zG
zG
wr
jp
jp
vI
jp
ms
wn
Rt
DS
SL
"}
(7,1,1) = {"
Mc
vJ
Xy
tb
WL
wr
jp
jp
jp
jp
Ed
me
Rt
DS
Rt
"}
(8,1,1) = {"
rs
nx
Yh
Oe
IN
Jr
Jr
jp
jp
Rt
Rt
Rt
Rt
DS
Rt
"}
(9,1,1) = {"
ia
jp
Xm
jp
WL
jp
Jr
dS
oW
CM
DS
DS
IP
oe
Rt
"}
(10,1,1) = {"
Ax
rV
Yk
dS
Ul
jp
Jr
PC
KJ
Rt
Au
Vj
ay
Dc
Rt
"}
(11,1,1) = {"
Rt
jK
Ew
nV
Ul
FB
Jr
vu
WL
Rt
Rt
Rt
Rt
Rt
Rt
"}
(12,1,1) = {"
My
TY
ME
qg
PP
WL
QO
WL
Ht
kG
kg
kg
pz
aj
Rt
"}
(13,1,1) = {"
Cd
Gq
Zf
zG
Re
qg
qg
jp
jp
Bu
Ka
yg
qm
eZ
Rt
"}
(14,1,1) = {"
tY
Xt
jV
aD
cA
cK
Jr
bl
jp
Rt
Ka
uN
Ak
Ka
Rt
"}
(15,1,1) = {"
Mc
Uw
jx
Nb
TY
ua
Rt
sH
MK
Rt
qA
Lz
qp
kJ
Rt
"}
(16,1,1) = {"
Mc
Mc
Mc
Cd
Cd
nx
Rt
Mc
Mc
Rt
Rt
Rt
Rt
Rt
Rt
"}
