//MAP CONVERTED BY dmm2tgm.py THIS HEADER COMMENT PREVENTS RECONVERSION, DO NOT REMOVE
"ad" = (
/obj/structure/table/wood/fancy/royalblack,
/turf/open/floor/carpet/red,
/area/misc/hilbertshotel)
"ay" = (
/obj/effect/turf_decal/siding/wood{
	dir = 6
	},
/obj/structure/table/wood/poker,
/obj/effect/spawner/random/entertainment/dice,
/obj/item/gun/ballistic/revolver/russian{
	pixel_y = 16
	},
/turf/open/floor/wood/large,
/area/misc/hilbertshotel)
"aC" = (
/obj/structure/chair/sofa/left/brown{
	dir = 1
	},
/turf/open/floor/carpet/black,
/area/misc/hilbertshotel)
"aQ" = (
/obj/effect/turf_decal/siding/wood{
	dir = 1
	},
/turf/open/floor/wood/large,
/area/misc/hilbertshotel)
"bG" = (
/obj/structure/hedge,
/obj/machinery/light/small/directional/east,
/turf/open/floor/carpet/black,
/area/misc/hilbertshotel)
"bI" = (
/obj/structure/chair/sofa/middle/brown{
	dir = 8
	},
/turf/open/floor/carpet/black,
/area/misc/hilbertshotel)
"cl" = (
/turf/open/floor/carpet/red,
/area/misc/hilbertshotel)
"cn" = (
/obj/structure/table/reinforced,
/obj/item/storage/box/drinkingglasses,
/turf/open/floor/wood/large,
/area/misc/hilbertshotel)
"cy" = (
/obj/effect/turf_decal/siding/wood{
	dir = 1
	},
/turf/open/floor/wood/parquet,
/area/misc/hilbertshotel)
"dC" = (
/turf/open/floor/carpet/black,
/area/misc/hilbertshotel)
"dO" = (
/obj/effect/turf_decal/siding/wood/corner{
	dir = 1
	},
/turf/open/floor/wood/large,
/area/misc/hilbertshotel)
"dY" = (
/obj/effect/turf_decal/siding/wood{
	dir = 10
	},
/obj/effect/turf_decal/siding/wood/corner{
	dir = 4
	},
/obj/item/kirbyplants/organic/plant21,
/turf/open/floor/wood/large,
/area/misc/hilbertshotel)
"fH" = (
/obj/structure/table/reinforced,
/obj/item/toy/plush/skyrat/fox,
/turf/open/floor/wood/large,
/area/misc/hilbertshotel)
"fQ" = (
/obj/structure/chair/comfy/brown{
	dir = 8
	},
/obj/item/toy/plush/skyrat/plushie_chiara{
	pixel_y = 5
	},
/turf/open/floor/carpet/green,
/area/misc/hilbertshotel)
"gb" = (
/obj/structure/chair/sofa/middle/brown{
	dir = 2
	},
/turf/open/floor/carpet/black,
/area/misc/hilbertshotel)
"gJ" = (
/obj/effect/turf_decal/siding/wood{
	dir = 1
	},
/obj/machinery/barsign/all_access/directional/north,
/turf/open/floor/wood/parquet,
/area/misc/hilbertshotel)
"gO" = (
/obj/effect/turf_decal/siding/wood{
	dir = 4
	},
/obj/effect/turf_decal/siding/wood{
	dir = 8
	},
/turf/open/floor/wood/large,
/area/misc/hilbertshotel)
"gU" = (
/obj/structure/hedge,
/obj/machinery/light/small/directional/west,
/turf/open/floor/carpet/black,
/area/misc/hilbertshotel)
"iH" = (
/obj/structure/chair/sofa/corp/right{
	dir = 4
	},
/obj/effect/turf_decal/siding/wood{
	dir = 8
	},
/turf/open/floor/wood/parquet,
/area/misc/hilbertshotel)
"jw" = (
/obj/effect/turf_decal/siding/wood{
	dir = 5
	},
/obj/effect/turf_decal/siding/wood{
	dir = 8
	},
/obj/effect/turf_decal/siding/wood/corner{
	dir = 1
	},
/turf/open/floor/wood/large,
/area/misc/hilbertshotel)
"jD" = (
/obj/effect/turf_decal/siding/wood{
	dir = 1
	},
/obj/effect/turf_decal/siding/wood,
/obj/effect/turf_decal/siding/wood/corner,
/turf/open/floor/wood/large,
/area/misc/hilbertshotel)
"jT" = (
/obj/effect/turf_decal/siding/wood{
	dir = 4
	},
/obj/structure/table/wood/poker,
/obj/effect/spawner/random/entertainment/deck,
/turf/open/floor/wood/large,
/area/misc/hilbertshotel)
"ke" = (
/obj/effect/turf_decal/siding/wood{
	dir = 8
	},
/obj/effect/turf_decal/siding/wood/corner{
	dir = 4
	},
/turf/open/floor/wood/large,
/area/misc/hilbertshotel)
"km" = (
/obj/structure/chair/sofa/right/brown,
/turf/open/floor/carpet/black,
/area/misc/hilbertshotel)
"kU" = (
/obj/structure/chair/comfy/beige{
	dir = 8
	},
/turf/open/floor/carpet/black,
/area/misc/hilbertshotel)
"lO" = (
/obj/structure/chair/sofa/corp/right{
	dir = 8
	},
/obj/effect/turf_decal/siding/wood{
	dir = 4
	},
/turf/open/floor/wood/parquet,
/area/misc/hilbertshotel)
"mc" = (
/obj/structure/hedge,
/turf/open/floor/carpet/black,
/area/misc/hilbertshotel)
"mu" = (
/obj/structure/chair/comfy/brown{
	dir = 4
	},
/turf/open/floor/wood/large,
/area/misc/hilbertshotel)
"mY" = (
/obj/structure/chair/stool/bar/directional/west,
/obj/effect/turf_decal/siding/wood{
	dir = 8
	},
/turf/open/floor/wood/parquet,
/area/misc/hilbertshotel)
"nW" = (
/obj/effect/turf_decal/siding/wood,
/turf/open/floor/wood/large,
/area/misc/hilbertshotel)
"ok" = (
/obj/effect/spawner/random/entertainment/arcade{
	dir = 8
	},
/obj/machinery/light/directional/east,
/turf/open/floor/carpet/black,
/area/misc/hilbertshotel)
"oT" = (
/obj/structure/chair/sofa/corner/brown,
/turf/open/floor/carpet/black,
/area/misc/hilbertshotel)
"pu" = (
/obj/structure/chair/comfy/beige{
	dir = 4
	},
/turf/open/floor/carpet/black,
/area/misc/hilbertshotel)
"pT" = (
/turf/closed/indestructible/wood,
/area/misc/hilbertshotel)
"qr" = (
/obj/effect/turf_decal/siding/wood{
	dir = 6
	},
/obj/effect/turf_decal/siding/wood/corner{
	dir = 1
	},
/turf/open/floor/wood/large,
/area/misc/hilbertshotel)
"qv" = (
/obj/item/kirbyplants/organic/plant22,
/obj/machinery/light/small/directional/north,
/turf/open/floor/carpet/black,
/area/misc/hilbertshotel)
"rp" = (
/obj/effect/turf_decal/siding/wood{
	dir = 9
	},
/turf/open/floor/wood/parquet,
/area/misc/hilbertshotel)
"rr" = (
/obj/structure/table/reinforced/rglass,
/obj/machinery/chem_dispenser/drinks/fullupgrade{
	pixel_y = 7
	},
/turf/open/floor/wood/large,
/area/misc/hilbertshotel)
"rU" = (
/obj/structure/table/reinforced,
/turf/open/floor/wood/large,
/area/misc/hilbertshotel)
"tk" = (
/obj/structure/chair/wood{
	dir = 8
	},
/turf/open/floor/carpet/black,
/area/misc/hilbertshotel)
"tn" = (
/obj/item/reagent_containers/cup/glass/drinkingglass/shotglass{
	pixel_y = 16;
	pixel_x = -10
	},
/obj/item/reagent_containers/cup/glass/bottle/small{
	pixel_y = 20;
	pixel_x = 9
	},
/obj/item/reagent_containers/cup/glass/drinkingglass{
	pixel_y = 18
	},
/obj/machinery/vending/boozeomat,
/turf/open/floor/wood/large,
/area/misc/hilbertshotel)
"ub" = (
/obj/structure/chair/wood/wings{
	dir = 8
	},
/turf/open/floor/carpet/black,
/area/misc/hilbertshotel)
"vb" = (
/obj/effect/turf_decal/siding/wood{
	dir = 1
	},
/obj/effect/turf_decal/siding/wood,
/obj/effect/turf_decal/siding/wood/corner{
	dir = 8
	},
/turf/open/floor/wood/large,
/area/misc/hilbertshotel)
"vr" = (
/obj/structure/decorative/shelf/alcohol,
/turf/closed/indestructible/wood,
/area/misc/hilbertshotel)
"vJ" = (
/obj/structure/chair/stool/directional/east,
/obj/effect/turf_decal/siding/wood{
	dir = 5
	},
/turf/open/floor/wood/parquet,
/area/misc/hilbertshotel)
"wd" = (
/obj/structure/chair/wood{
	dir = 4
	},
/turf/open/floor/carpet/black,
/area/misc/hilbertshotel)
"wX" = (
/obj/effect/turf_decal/tile/dark/opposingcorners,
/obj/structure/table/reinforced/rglass,
/obj/machinery/light/directional/east,
/obj/machinery/chem_dispenser/drinks/beer/fullupgrade{
	pixel_y = 7
	},
/turf/open/floor/wood/large,
/area/misc/hilbertshotel)
"xo" = (
/obj/structure/reagent_dispensers/beerkeg,
/obj/machinery/light/small/dim/directional/west,
/turf/open/floor/wood/large,
/area/misc/hilbertshotel)
"yj" = (
/obj/effect/turf_decal/siding/wood{
	dir = 1
	},
/obj/effect/turf_decal/siding/wood/corner{
	dir = 8
	},
/turf/open/floor/wood/large,
/area/misc/hilbertshotel)
"zN" = (
/obj/structure/table/wood,
/obj/effect/decal/cleanable/cobweb,
/turf/open/floor/wood/large,
/area/misc/hilbertshotel)
"Aa" = (
/obj/structure/table/wood/fancy/red,
/turf/open/floor/wood/parquet,
/area/misc/hilbertshotel)
"Ah" = (
/obj/effect/turf_decal/siding/wood{
	dir = 4
	},
/turf/open/floor/wood/parquet,
/area/misc/hilbertshotel)
"AQ" = (
/obj/effect/turf_decal/siding/wood{
	dir = 8
	},
/obj/effect/turf_decal/siding/wood{
	dir = 4
	},
/obj/machinery/light/directional/east,
/turf/open/floor/wood/large,
/area/misc/hilbertshotel)
"Bb" = (
/obj/structure/chair/stool/bar/directional/north,
/obj/effect/turf_decal/siding/wood{
	dir = 1
	},
/turf/open/floor/wood/parquet,
/area/misc/hilbertshotel)
"CC" = (
/obj/structure/curtain/cloth/fancy,
/turf/open/floor/carpet/black,
/area/misc/hilbertshotel)
"Dy" = (
/obj/structure/table/wood,
/turf/open/floor/carpet/black,
/area/misc/hilbertshotel)
"DS" = (
/obj/effect/turf_decal/siding/wood/corner{
	dir = 1
	},
/obj/item/kirbyplants/organic/plant21,
/turf/open/floor/wood/parquet,
/area/misc/hilbertshotel)
"Fs" = (
/obj/structure/chair/wood/wings{
	dir = 1
	},
/turf/open/floor/carpet/black,
/area/misc/hilbertshotel)
"FD" = (
/obj/structure/chair/sofa/corp/left{
	dir = 4
	},
/obj/effect/turf_decal/siding/wood{
	dir = 8
	},
/turf/open/floor/wood/parquet,
/area/misc/hilbertshotel)
"FN" = (
/turf/closed/indestructible/rock,
/area/misc/hilbertshotel)
"Gm" = (
/obj/effect/turf_decal/siding/wood,
/obj/effect/turf_decal/siding/wood{
	dir = 1
	},
/obj/effect/turf_decal/siding/wood{
	dir = 1
	},
/turf/open/floor/wood/large,
/area/misc/hilbertshotel)
"GQ" = (
/obj/item/kirbyplants/organic/plant22,
/obj/machinery/light/small/directional/south,
/turf/open/floor/carpet/black,
/area/misc/hilbertshotel)
"HN" = (
/obj/machinery/light/small/directional/east,
/turf/open/floor/carpet/green,
/area/misc/hilbertshotel)
"Ix" = (
/obj/effect/turf_decal/siding/wood{
	dir = 1
	},
/obj/effect/turf_decal/siding/wood,
/turf/open/floor/wood/large,
/area/misc/hilbertshotel)
"IR" = (
/obj/structure/chair/stool/directional/east,
/obj/effect/turf_decal/siding/wood{
	dir = 4
	},
/obj/effect/turf_decal/siding/wood,
/turf/open/floor/wood/parquet,
/area/misc/hilbertshotel)
"Jw" = (
/obj/effect/turf_decal/siding/wood{
	dir = 1
	},
/obj/structure/chair/comfy/brown{
	dir = 4
	},
/turf/open/floor/wood/large,
/area/misc/hilbertshotel)
"JW" = (
/obj/structure/table/wood/fancy/red,
/obj/machinery/light/directional/south,
/turf/open/floor/wood/parquet,
/area/misc/hilbertshotel)
"Ki" = (
/turf/open/floor/carpet/green,
/area/misc/hilbertshotel)
"KI" = (
/obj/effect/turf_decal/siding/wood{
	dir = 9
	},
/obj/item/kirbyplants/organic/plant21,
/turf/open/floor/wood/parquet,
/area/misc/hilbertshotel)
"KQ" = (
/obj/structure/closet/secure_closet/bar,
/turf/open/floor/wood/large,
/area/misc/hilbertshotel)
"Ms" = (
/obj/structure/chair/wood,
/turf/open/floor/carpet/black,
/area/misc/hilbertshotel)
"Mz" = (
/obj/structure/table/wood/fancy/blue,
/turf/open/floor/wood/parquet,
/area/misc/hilbertshotel)
"MG" = (
/obj/structure/table/reinforced,
/obj/structure/desk_bell{
	pixel_x = 5;
	pixel_y = 3
	},
/turf/open/floor/wood/large,
/area/misc/hilbertshotel)
"NR" = (
/obj/structure/decorative/shelf/alcohol_assortment,
/turf/closed/indestructible/wood,
/area/misc/hilbertshotel)
"NY" = (
/obj/machinery/vending/wardrobe/bar_wardrobe/ghost_cafe,
/turf/closed/indestructible/wood,
/area/misc/hilbertshotel)
"Oq" = (
/obj/machinery/computer/slot_machine,
/turf/open/floor/carpet/black,
/area/misc/hilbertshotel)
"OJ" = (
/obj/structure/chair/sofa/corp/left{
	dir = 8
	},
/obj/effect/turf_decal/siding/wood{
	dir = 4
	},
/turf/open/floor/wood/parquet,
/area/misc/hilbertshotel)
"Pl" = (
/obj/machinery/reagentgrinder,
/obj/item/reagent_containers/cup/glass/shaker{
	pixel_y = 3;
	pixel_x = -10
	},
/obj/structure/table/reinforced/rglass,
/obj/machinery/light/directional/west,
/turf/open/floor/wood/large,
/area/misc/hilbertshotel)
"QQ" = (
/obj/effect/turf_decal/siding/wood{
	dir = 9
	},
/obj/effect/turf_decal/siding/wood{
	dir = 4
	},
/obj/effect/turf_decal/siding/wood/corner{
	dir = 4
	},
/turf/open/floor/wood/large,
/area/misc/hilbertshotel)
"Rz" = (
/obj/effect/turf_decal/siding/wood{
	dir = 8
	},
/obj/effect/turf_decal/siding/wood{
	dir = 4
	},
/turf/open/floor/wood/large,
/area/misc/hilbertshotel)
"SQ" = (
/obj/effect/turf_decal/siding/wood,
/obj/effect/turf_decal/siding/wood{
	dir = 1
	},
/turf/open/floor/wood/large,
/area/misc/hilbertshotel)
"SS" = (
/turf/closed/indestructible/hoteldoor{
	icon_state = "door_closed";
	icon = 'icons/obj/doors/puzzledoor/default.dmi'
	},
/area/misc/hilbertshotel)
"Te" = (
/obj/structure/chair/wood{
	dir = 1
	},
/turf/open/floor/carpet/black,
/area/misc/hilbertshotel)
"TO" = (
/obj/structure/table/wood/fancy/blue,
/obj/machinery/light/directional/south,
/turf/open/floor/wood/parquet,
/area/misc/hilbertshotel)
"Ug" = (
/obj/effect/turf_decal/siding/wood{
	dir = 8
	},
/obj/effect/turf_decal/siding/wood/corner,
/turf/open/floor/wood/large,
/area/misc/hilbertshotel)
"Up" = (
/obj/structure/table/wood,
/obj/item/storage/box/drinkingglasses,
/turf/open/floor/wood/large,
/area/misc/hilbertshotel)
"UG" = (
/obj/effect/turf_decal/siding/wood,
/obj/structure/chair/comfy/brown{
	dir = 4
	},
/turf/open/floor/wood/large,
/area/misc/hilbertshotel)
"Vj" = (
/obj/effect/turf_decal/siding/wood,
/mob/living/basic/pet/fox/docile,
/obj/structure/bed/dogbed,
/turf/open/floor/wood/large,
/area/misc/hilbertshotel)
"Vl" = (
/obj/structure/chair/sofa/corner/brown{
	dir = 8
	},
/turf/open/floor/carpet/black,
/area/misc/hilbertshotel)
"Wz" = (
/turf/open/floor/wood/large,
/area/misc/hilbertshotel)
"WQ" = (
/obj/structure/chair/wood/wings,
/turf/open/floor/carpet/black,
/area/misc/hilbertshotel)
"Xc" = (
/obj/structure/chair/sofa/middle/brown{
	dir = 1
	},
/turf/open/floor/carpet/black,
/area/misc/hilbertshotel)
"Yj" = (
/obj/effect/turf_decal/siding/wood{
	dir = 4
	},
/obj/effect/turf_decal/siding/wood{
	dir = 8
	},
/obj/machinery/light/directional/west,
/turf/open/floor/wood/large,
/area/misc/hilbertshotel)
"Yn" = (
/obj/machinery/door/airlock/wood,
/turf/open/floor/wood/large,
/area/misc/hilbertshotel)
"YP" = (
/obj/effect/turf_decal/siding/wood{
	dir = 1
	},
/obj/effect/turf_decal/siding/wood{
	dir = 8
	},
/obj/effect/turf_decal/siding/wood/corner,
/turf/open/floor/wood/large,
/area/misc/hilbertshotel)
"ZH" = (
/obj/effect/turf_decal/siding/wood{
	dir = 4
	},
/obj/effect/turf_decal/siding/wood/corner{
	dir = 1
	},
/obj/structure/table/wood/poker,
/obj/item/storage/fancy/cigarettes/cigars,
/obj/item/storage/box/matches,
/turf/open/floor/wood/large,
/area/misc/hilbertshotel)

(1,1,1) = {"
pT
pT
pT
pT
pT
pT
pT
SS
pT
pT
pT
pT
pT
FN
FN
"}
(2,1,1) = {"
pT
zN
KQ
xo
Wz
Yn
rp
YP
gO
Yj
gO
dY
pT
pT
pT
"}
(3,1,1) = {"
pT
Up
Wz
Wz
Wz
pT
gJ
SQ
dC
wd
dC
Ix
FD
iH
pT
"}
(4,1,1) = {"
pT
NY
pT
pT
Yn
pT
cy
SQ
WQ
Dy
Te
Ix
Aa
JW
pT
"}
(5,1,1) = {"
FN
FN
vr
Pl
Wz
fH
Bb
SQ
dC
tk
dC
jD
lO
OJ
pT
"}
(6,1,1) = {"
FN
FN
NR
rr
Wz
rU
Bb
Gm
dC
dC
dC
aQ
nW
mc
pT
"}
(7,1,1) = {"
FN
FN
vr
tn
Wz
rU
Bb
SQ
dC
wd
dC
aQ
nW
mc
pT
"}
(8,1,1) = {"
FN
FN
NR
wX
Wz
rU
Bb
SQ
Ms
Dy
Fs
vb
FD
iH
pT
"}
(9,1,1) = {"
FN
FN
pT
pT
cn
MG
Bb
SQ
dC
ub
dC
Ix
Mz
TO
pT
"}
(10,1,1) = {"
pT
pT
pT
KI
mY
mY
DS
yj
Ug
AQ
Rz
qr
lO
OJ
pT
"}
(11,1,1) = {"
pT
gU
pu
jw
gO
gO
ke
dO
Vj
pT
pT
CC
CC
pT
pT
"}
(12,1,1) = {"
pT
mc
dC
dC
dC
dC
Jw
mu
UG
pT
qv
cl
cl
GQ
pT
"}
(13,1,1) = {"
pT
bG
kU
QQ
gO
gO
ZH
jT
ay
pT
km
ad
ad
aC
pT
"}
(14,1,1) = {"
pT
pT
pT
vJ
Ah
IR
Ki
fQ
HN
pT
gb
ad
ad
Xc
pT
"}
(15,1,1) = {"
FN
FN
pT
Oq
ok
Oq
pT
pT
pT
pT
oT
bI
bI
Vl
pT
"}
(16,1,1) = {"
FN
FN
pT
pT
pT
pT
pT
FN
FN
pT
pT
pT
pT
pT
pT
"}
