//MAP CONVERTED BY dmm2tgm.py THIS HEADER COMMENT PREVENTS RECONVERSION, DO NOT REMOVE
"bK" = (
/obj/structure/flora/bush/flowers_yw,
/turf/open/floor/grass,
/area/misc/condo)
"bM" = (
/turf/open/floor/mineral/titanium,
/area/misc/condo)
"cn" = (
/obj/effect/spawner/liquids_spawner,
/obj/structure/flora/ocean/coral,
/turf/open/misc/asteroid,
/area/misc/condo)
"cL" = (
/obj/structure/flora/tree/jungle/small/style_5,
/turf/open/floor/grass,
/area/misc/condo)
"du" = (
/obj/structure/flora/bush/pale/style_random,
/turf/open/floor/grass,
/area/misc/condo)
"er" = (
/obj/effect/spawner/liquids_spawner,
/turf/open/floor/iron/pool,
/area/misc/condo)
"eQ" = (
/obj/machinery/oven,
/turf/open/floor/wood,
/area/misc/condo)
"eR" = (
/obj/structure/flora/bush/flowers_pp,
/turf/open/floor/grass,
/area/misc/condo)
"fA" = (
/turf/cordon,
/area/misc/condo)
"fB" = (
/obj/effect/planetary_turf_atmos_helper,
/turf/closed/indestructible/wood,
/area/misc/condo)
"fD" = (
/obj/effect/spawner/liquids_spawner,
/obj/structure/flora/ocean/glowweed,
/turf/open/misc/asteroid,
/area/misc/condo)
"gn" = (
/obj/structure/table/reinforced/plastitaniumglass,
/obj/effect/turf_decal/siding/wood{
	dir = 1
	},
/obj/machinery/light/directional/north,
/turf/open/floor/wood,
/area/misc/condo)
"gL" = (
/turf/closed/indestructible/wood,
/area/misc/condo)
"ha" = (
/obj/structure/chair/wood,
/turf/open/floor/carpet/lone/star,
/area/misc/condo)
"hT" = (
/turf/closed/indestructible/sandstone,
/area/misc/condo)
"iA" = (
/obj/structure/toilet,
/turf/open/indestructible/hoteltile,
/area/misc/condo)
"jK" = (
/turf/open/floor/wood,
/area/misc/condo)
"kl" = (
/obj/effect/turf_decal/siding/wood{
	dir = 1
	},
/obj/structure/railing{
	dir = 1
	},
/obj/structure/chair/plastic{
	dir = 4
	},
/turf/open/floor/wood/parquet,
/area/misc/condo)
"lx" = (
/obj/structure/flora/bush/flowers_pp/style_2,
/turf/open/floor/grass,
/area/misc/condo)
"mu" = (
/obj/structure/chair/sofa/middle{
	dir = 8
	},
/obj/machinery/light/directional/east,
/turf/open/floor/carpet/lone/star,
/area/misc/condo)
"os" = (
/obj/effect/spawner/liquids_spawner,
/obj/structure/flora/ocean/longseaweed,
/turf/open/misc/asteroid,
/area/misc/condo)
"sk" = (
/obj/effect/turf_decal/siding/wood{
	dir = 8
	},
/turf/open/floor/carpet/lone/star,
/area/misc/condo)
"sl" = (
/obj/effect/turf_decal/siding/wood{
	dir = 8
	},
/obj/structure/chair/sofa/left{
	dir = 1
	},
/turf/open/floor/carpet/lone/star,
/area/misc/condo)
"sz" = (
/obj/effect/turf_decal/siding/wood{
	dir = 1
	},
/obj/structure/railing/corner/end/flip{
	dir = 4
	},
/turf/open/floor/wood/parquet,
/area/misc/condo)
"sC" = (
/turf/open/floor/wood/parquet,
/area/misc/condo)
"tR" = (
/obj/effect/turf_decal/siding/wood{
	dir = 1
	},
/obj/structure/railing/corner/end{
	dir = 8
	},
/turf/open/floor/wood/parquet,
/area/misc/condo)
"ua" = (
/obj/effect/turf_decal/siding/wood{
	dir = 4
	},
/turf/open/floor/wood,
/area/misc/condo)
"uu" = (
/obj/effect/turf_decal/siding/wood{
	dir = 1
	},
/obj/machinery/computer/security/telescreen/entertainment/directional/west,
/obj/item/kirbyplants/random,
/turf/open/floor/mineral/titanium,
/area/misc/condo)
"uL" = (
/obj/structure/flora/bush/lavendergrass/style_2,
/obj/effect/light_emitter/fake_outdoors,
/turf/open/floor/grass,
/area/misc/condo)
"uW" = (
/obj/structure/chair/wood{
	dir = 1
	},
/turf/open/floor/carpet/lone/star,
/area/misc/condo)
"vz" = (
/obj/structure/table/wood,
/obj/machinery/light/directional/east,
/obj/item/toy/cards/deck/kotahi{
	pixel_y = 8
	},
/turf/open/floor/carpet/lone/star,
/area/misc/condo)
"vH" = (
/turf/closed/indestructible/hoteldoor/fakedoor,
/area/misc/condo)
"vN" = (
/obj/effect/turf_decal/siding/wood{
	dir = 4
	},
/obj/structure/mineral_door/wood{
	name = "Bathroom"
	},
/obj/effect/turf_decal/siding/white/corner{
	dir = 8
	},
/turf/open/indestructible/hoteltile,
/area/misc/condo)
"wb" = (
/obj/effect/turf_decal/siding/wood{
	dir = 1
	},
/obj/structure/railing{
	dir = 1
	},
/obj/structure/table/glass,
/turf/open/floor/wood/parquet,
/area/misc/condo)
"xj" = (
/obj/effect/turf_decal/siding/white,
/obj/machinery/door/window/right/directional/south,
/turf/open/indestructible/hoteltile,
/area/misc/condo)
"xz" = (
/obj/machinery/light_switch/directional/east,
/turf/open/floor/mineral/titanium,
/area/misc/condo)
"xZ" = (
/obj/structure/sink/kitchen/directional/south,
/turf/open/floor/wood,
/area/misc/condo)
"yc" = (
/obj/effect/turf_decal/siding/white,
/obj/machinery/door/window/left/directional/south,
/obj/machinery/light/directional/west,
/turf/open/indestructible/hoteltile,
/area/misc/condo)
"yC" = (
/turf/closed/indestructible/hotelwall,
/area/misc/condo)
"Dm" = (
/obj/structure/flora/bush/flowers_br/style_random,
/turf/open/floor/grass,
/area/misc/condo)
"Ep" = (
/obj/structure/table/reinforced/plastitaniumglass,
/obj/machinery/microwave{
	pixel_y = 8
	},
/obj/effect/turf_decal/siding/wood{
	dir = 1
	},
/turf/open/floor/wood,
/area/misc/condo)
"EG" = (
/obj/effect/planetary_turf_atmos_helper,
/turf/closed/indestructible/hotelwall,
/area/misc/condo)
"FW" = (
/obj/effect/turf_decal/siding/wood{
	dir = 1
	},
/turf/open/floor/wood/parquet,
/area/misc/condo)
"Ge" = (
/obj/structure/table/reinforced/plastitaniumglass,
/obj/effect/turf_decal/siding/wood{
	dir = 5
	},
/turf/open/floor/wood,
/area/misc/condo)
"Ie" = (
/obj/effect/turf_decal/siding/wood{
	dir = 1
	},
/obj/effect/turf_decal/siding/wood,
/obj/machinery/door/airlock/material/glass{
	name = "Backyard"
	},
/obj/structure/curtain/cloth/fancy,
/turf/open/floor/wood/large,
/area/misc/condo)
"Ja" = (
/obj/item/emergency_bed{
	pixel_y = 10;
	pixel_x = 3
	},
/obj/structure/rack,
/obj/item/emergency_bed,
/turf/open/floor/mineral/titanium,
/area/misc/condo)
"Mk" = (
/obj/structure/chair/sofa/corner{
	dir = 8
	},
/turf/open/floor/carpet/lone/star,
/area/misc/condo)
"Nr" = (
/obj/item/storage/cans/sixsoda,
/obj/structure/closet/crate/freezer,
/turf/open/floor/wood/parquet,
/area/misc/condo)
"NU" = (
/obj/structure/flora/bush/jungle/a/style_random,
/turf/open/floor/grass,
/area/misc/condo)
"Pw" = (
/obj/structure/chair/sofa/corner,
/turf/open/floor/carpet/lone/star,
/area/misc/condo)
"RE" = (
/obj/structure/flora/bush/grassy/style_4,
/turf/open/floor/grass,
/area/misc/condo)
"RP" = (
/turf/open/floor/carpet/lone/star,
/area/misc/condo)
"Sv" = (
/obj/effect/turf_decal/siding/wood{
	dir = 1
	},
/turf/open/floor/mineral/titanium,
/area/misc/condo)
"SE" = (
/obj/effect/turf_decal/siding/wood{
	dir = 8
	},
/obj/structure/chair/sofa/right,
/turf/open/floor/carpet/lone/star,
/area/misc/condo)
"SI" = (
/obj/effect/spawner/liquids_spawner,
/obj/machinery/shower/directional/west,
/turf/open/floor/iron/pool,
/area/misc/condo)
"Tk" = (
/obj/machinery/light/directional/west,
/turf/open/floor/mineral/titanium,
/area/misc/condo)
"TM" = (
/obj/structure/curtain/cloth/fancy,
/turf/closed/indestructible/fakeglass,
/area/misc/condo)
"Vk" = (
/obj/structure/table/reinforced/plastitaniumglass,
/obj/effect/turf_decal/siding/wood{
	dir = 4
	},
/turf/open/floor/wood,
/area/misc/condo)
"Wb" = (
/turf/closed/indestructible/fakeglass,
/area/misc/condo)
"WD" = (
/obj/structure/closet/secure_closet/freezer/fridge/preopen,
/turf/open/floor/wood,
/area/misc/condo)
"WH" = (
/turf/open/floor/grass,
/area/misc/condo)
"XO" = (
/obj/structure/flora/bush/flowers_br,
/turf/open/floor/grass,
/area/misc/condo)
"Yk" = (
/obj/structure/table/glass,
/turf/open/floor/wood/parquet,
/area/misc/condo)
"Zc" = (
/obj/structure/mirror/directional/east,
/obj/structure/sink/directional/west,
/turf/open/indestructible/hoteltile,
/area/misc/condo)
"ZZ" = (
/obj/structure/chair/wood{
	dir = 4
	},
/turf/open/floor/carpet/lone/star,
/area/misc/condo)

(1,1,1) = {"
fB
gL
gL
gL
gL
gL
yC
yC
yC
yC
yC
hT
hT
hT
yC
yC
yC
yC
EG
"}
(2,1,1) = {"
gL
XO
WH
eR
kl
Nr
yC
cn
fD
os
yC
Ep
eQ
WD
yC
iA
yc
er
yC
"}
(3,1,1) = {"
gL
RE
WH
eR
tR
sC
yC
Wb
Wb
Wb
yC
gn
xZ
jK
yC
Zc
xj
SI
yC
"}
(4,1,1) = {"
gL
bK
lx
uL
FW
sC
Ie
RP
RP
RP
uu
Ge
Vk
ua
yC
yC
vN
yC
yC
"}
(5,1,1) = {"
gL
WH
cL
Dm
sz
sC
TM
RP
ZZ
RP
Sv
bM
bM
bM
Tk
bM
bM
vH
fA
"}
(6,1,1) = {"
gL
NU
du
WH
wb
Yk
TM
ha
vz
uW
Sv
bM
bM
bM
xz
bM
Ja
yC
fA
"}
(7,1,1) = {"
gL
gL
gL
gL
gL
gL
yC
yC
yC
yC
yC
SE
sk
sl
yC
yC
yC
yC
fA
"}
(8,1,1) = {"
fA
fA
fA
fA
fA
fA
fA
fA
fA
fA
yC
Pw
mu
Mk
yC
fA
fA
fA
fA
"}
(9,1,1) = {"
fA
fA
fA
fA
fA
fA
fA
fA
fA
fA
yC
yC
yC
yC
yC
fA
fA
fA
fA
"}
