//MAP CONVERTED BY dmm2tgm.py THIS HEADER COMMENT PREVENTS RECONVERSION, DO NOT REMOVE
"ae" = (
/obj/machinery/light/small/directional/north,
/obj/structure/table/reinforced,
/turf/open/indestructible/hoteltile,
/area/misc/condo)
"ag" = (
/turf/open/indestructible/hoteltile,
/area/misc/condo)
"aI" = (
/obj/item/bikehorn/rubberducky,
/obj/machinery/light/small/directional/east,
/turf/open/indestructible/hoteltile,
/area/misc/condo)
"aP" = (
/obj/structure/mineral_door/paperframe,
/obj/effect/turf_decal/siding/wood,
/turf/open/indestructible/hotelwood,
/area/misc/condo)
"bz" = (
/obj/structure/table/wood/fancy,
/obj/structure/sign/calendar/directional/north,
/turf/open/indestructible/hotelwood,
/area/misc/condo)
"bT" = (
/obj/structure/table/wood/fancy,
/obj/item/flashlight/lamp/green{
	pixel_y = 3
	},
/turf/open/indestructible/hotelwood,
/area/misc/condo)
"cW" = (
/turf/open/space/bluespace,
/area/misc/condo)
"de" = (
/obj/machinery/light/small/directional/west,
/turf/open/indestructible/hoteltile,
/area/misc/condo)
"dP" = (
/obj/structure/railing{
	dir = 1
	},
/turf/open/indestructible/hoteltile,
/area/misc/condo)
"dW" = (
/obj/structure/railing/corner/end/flip{
	dir = 4
	},
/turf/open/indestructible/hoteltile,
/area/misc/condo)
"ek" = (
/obj/structure/chair/stool/bar/directional/south,
/turf/open/indestructible/hotelwood,
/area/misc/condo)
"ez" = (
/turf/closed/indestructible/hotelwall,
/area/misc/condo)
"fD" = (
/obj/machinery/light/small/directional/west,
/turf/open/indestructible/hotelwood,
/area/misc/condo)
"gx" = (
/turf/open/indestructible/dark,
/area/misc/condo)
"hQ" = (
/obj/structure/table/reinforced,
/obj/machinery/light/small/directional/south,
/turf/open/indestructible/dark,
/area/misc/condo)
"jf" = (
/obj/structure/table/reinforced,
/obj/machinery/microwave,
/turf/open/indestructible/dark,
/area/misc/condo)
"lb" = (
/obj/structure/bed/double,
/obj/effect/spawner/random/bedsheet/any/double,
/turf/open/indestructible/hotelwood,
/area/misc/condo)
"ol" = (
/obj/machinery/light_switch/directional/west,
/turf/open/indestructible/hotelwood,
/area/misc/condo)
"rq" = (
/obj/structure/mineral_door/wood,
/turf/open/indestructible/hotelwood,
/area/misc/condo)
"sb" = (
/obj/structure/table/wood/fancy,
/obj/machinery/light/small/directional/north,
/turf/open/indestructible/hotelwood,
/area/misc/condo)
"tb" = (
/obj/structure/chair/sofa/left/brown{
	dir = 1
	},
/turf/open/indestructible/hotelwood,
/area/misc/condo)
"ub" = (
/obj/structure/extinguisher_cabinet/directional/east,
/turf/open/indestructible/hotelwood,
/area/misc/condo)
"ue" = (
/obj/structure/chair/comfy/brown{
	dir = 8
	},
/obj/machinery/light/small/directional/east,
/turf/open/indestructible/hotelwood,
/area/misc/condo)
"vT" = (
/obj/machinery/light_switch/directional/east,
/turf/open/indestructible/hotelwood,
/area/misc/condo)
"zo" = (
/obj/effect/turf_decal/siding/wood,
/obj/machinery/door/window/left/directional/south,
/turf/open/indestructible/hotelwood,
/area/misc/condo)
"Av" = (
/obj/structure/toilet{
	dir = 4
	},
/obj/machinery/light/small/directional/west,
/turf/open/indestructible/hoteltile,
/area/misc/condo)
"Bb" = (
/obj/structure/closet/crate/bin,
/obj/machinery/light/small/directional/east,
/turf/open/indestructible/hotelwood,
/area/misc/condo)
"Ca" = (
/obj/structure/mirror/directional/north,
/obj/structure/sink/directional/south,
/turf/open/indestructible/hoteltile,
/area/misc/condo)
"Dp" = (
/obj/structure/table/reinforced,
/turf/open/indestructible/dark,
/area/misc/condo)
"Eg" = (
/obj/item/kirbyplants/random/fullysynthetic,
/turf/open/indestructible/hotelwood,
/area/misc/condo)
"Fq" = (
/obj/machinery/smartfridge/food,
/turf/open/indestructible/dark,
/area/misc/condo)
"Fx" = (
/obj/structure/table/wood/fancy,
/obj/item/food/grown/poppy{
	pixel_y = 8
	},
/turf/open/indestructible/hotelwood,
/area/misc/condo)
"Hh" = (
/obj/structure/curtain,
/turf/open/indestructible/hoteltile,
/area/misc/condo)
"HF" = (
/obj/structure/table/reinforced,
/turf/open/indestructible/hoteltile,
/area/misc/condo)
"IV" = (
/obj/machinery/light/small/directional/south,
/turf/open/indestructible/hotelwood,
/area/misc/condo)
"Jj" = (
/obj/structure/table/wood,
/obj/effect/turf_decal/siding/wood{
	dir = 8
	},
/obj/structure/sign/clock/directional/north,
/turf/open/indestructible/dark,
/area/misc/condo)
"Jp" = (
/obj/structure/table/wood/fancy,
/obj/structure/mirror/directional/north,
/turf/open/indestructible/hotelwood,
/area/misc/condo)
"Kd" = (
/obj/structure/dresser,
/turf/open/indestructible/hotelwood,
/area/misc/condo)
"LG" = (
/obj/structure/table/wood,
/obj/structure/showcase/machinery/tv{
	pixel_y = 8
	},
/turf/open/indestructible/hotelwood,
/area/misc/condo)
"Me" = (
/obj/structure/table/wood,
/obj/effect/turf_decal/siding/wood,
/obj/item/phone{
	pixel_y = 8
	},
/turf/open/indestructible/dark,
/area/misc/condo)
"Ms" = (
/obj/structure/closet/cabinet{
	anchored = 1
	},
/turf/open/indestructible/hotelwood,
/area/misc/condo)
"MN" = (
/obj/effect/turf_decal/siding/wood{
	dir = 8
	},
/obj/structure/chair/office/light{
	dir = 4
	},
/turf/open/indestructible/dark,
/area/misc/condo)
"NV" = (
/obj/machinery/light/small/directional/west,
/turf/open/indestructible/dark,
/area/misc/condo)
"NX" = (
/obj/structure/table/wood,
/turf/open/indestructible/dark,
/area/misc/condo)
"Oa" = (
/turf/open/indestructible/hotelwood,
/area/misc/condo)
"Os" = (
/obj/structure/table/reinforced,
/obj/effect/turf_decal/siding/wood,
/turf/open/indestructible/hotelwood,
/area/misc/condo)
"PA" = (
/obj/effect/planetary_turf_atmos_helper,
/turf/closed/indestructible/hotelwall,
/area/misc/condo)
"QN" = (
/obj/effect/turf_decal/siding/wood{
	dir = 10
	},
/turf/open/indestructible/dark,
/area/misc/condo)
"RT" = (
/obj/structure/chair/sofa/right/brown{
	dir = 1
	},
/turf/open/indestructible/hotelwood,
/area/misc/condo)
"SO" = (
/obj/structure/table/wood/poker,
/turf/open/indestructible/hotelwood,
/area/misc/condo)
"VQ" = (
/obj/structure/table/wood,
/obj/machinery/light/small/directional/north,
/turf/open/indestructible/hotelwood,
/area/misc/condo)
"Yi" = (
/obj/machinery/light/small/directional/east,
/obj/structure/sink/kitchen/directional/west,
/turf/open/indestructible/dark,
/area/misc/condo)
"YA" = (
/turf/closed/indestructible/hoteldoor,
/area/misc/condo)
"YU" = (
/obj/structure/rack,
/turf/open/indestructible/hoteltile,
/area/misc/condo)
"ZI" = (
/obj/machinery/light/small/directional/south,
/turf/open/indestructible/hoteltile,
/area/misc/condo)
"ZV" = (
/obj/machinery/shower/directional/west,
/turf/open/indestructible/hoteltile,
/area/misc/condo)

(1,1,1) = {"
cW
cW
cW
cW
cW
cW
cW
cW
cW
cW
cW
cW
cW
cW
cW
"}
(2,1,1) = {"
cW
PA
ez
ez
ez
ez
ez
ez
ez
ez
ez
ez
ez
ez
cW
"}
(3,1,1) = {"
cW
YA
Oa
Oa
fD
Oa
Oa
fD
Oa
zo
NV
jf
Dp
ez
cW
"}
(4,1,1) = {"
cW
ez
Eg
Oa
Oa
Oa
Oa
Oa
ek
Os
gx
gx
Dp
ez
cW
"}
(5,1,1) = {"
cW
ez
VQ
Oa
SO
tb
Oa
Oa
ek
Os
gx
gx
hQ
ez
cW
"}
(6,1,1) = {"
cW
ez
LG
Oa
SO
RT
Oa
Oa
ek
Os
gx
gx
Dp
ez
cW
"}
(7,1,1) = {"
cW
ez
Oa
Oa
ue
Oa
vT
Bb
ub
Os
Yi
gx
Fq
ez
cW
"}
(8,1,1) = {"
cW
ez
ez
ez
ez
rq
ez
ez
ez
ez
ez
ez
ez
ez
cW
"}
(9,1,1) = {"
cW
ez
Kd
Oa
fD
Oa
ol
aP
ag
Av
ez
de
ag
ez
cW
"}
(10,1,1) = {"
cW
ez
bz
Oa
Oa
Oa
Oa
ez
Ca
ag
Hh
ag
ZI
ez
cW
"}
(11,1,1) = {"
cW
ez
Jp
Oa
Oa
Oa
IV
ez
ae
HF
ez
ag
YU
ez
cW
"}
(12,1,1) = {"
cW
ez
sb
Oa
Oa
Oa
Ms
ez
ez
ez
ez
Hh
ez
ez
cW
"}
(13,1,1) = {"
cW
ez
Jj
MN
QN
Oa
Fx
ez
dW
ag
ag
ag
ag
ez
cW
"}
(14,1,1) = {"
cW
ez
NX
NX
Me
lb
bT
ez
dP
ZV
aI
ZV
ag
ez
cW
"}
(15,1,1) = {"
cW
ez
ez
ez
ez
ez
ez
ez
ez
ez
ez
ez
ez
ez
cW
"}
(16,1,1) = {"
cW
cW
cW
cW
cW
cW
cW
cW
cW
cW
cW
cW
cW
cW
cW
"}
