//MAP CONVERTED BY dmm2tgm.py THIS HEADER COMMENT PREVENTS RECONVERSION, DO NOT REMOVE
"ar" = (
/obj/structure/table/wood/fancy,
/obj/structure/sign/painting/library{
	pixel_x = -32
	},
/turf/open/floor/wood,
/area/misc/condo)
"aC" = (
/obj/effect/turf_decal/siding/wood/end{
	dir = 4
	},
/turf/open/floor/wood,
/area/misc/condo)
"aM" = (
/obj/structure/displaycase/trophy,
/turf/open/floor/carpet/red,
/area/misc/condo)
"aS" = (
/obj/structure/bookcase/random/nonfiction,
/turf/open/floor/wood,
/area/misc/condo)
"bw" = (
/obj/structure/sign/painting/large/library{
	pixel_y = -37
	},
/obj/effect/turf_decal/siding/wood{
	dir = 1
	},
/obj/effect/turf_decal/siding/wood,
/obj/item/kirbyplants/random,
/turf/open/floor/wood,
/area/misc/condo)
"bz" = (
/obj/structure/chair/office{
	dir = 8
	},
/turf/open/floor/wood,
/area/misc/condo)
"cy" = (
/obj/structure/easel,
/obj/effect/turf_decal/siding/wood{
	dir = 5
	},
/obj/effect/turf_decal/siding/wood/corner{
	dir = 8
	},
/obj/item/canvas/twentythree_twentythree,
/obj/item/canvas/twentythree_twentythree,
/obj/item/canvas/twentythree_nineteen,
/obj/item/canvas/fortyfive_twentyseven{
	pixel_x = 4;
	pixel_y = 4
	},
/obj/item/canvas/nineteen_nineteen,
/obj/structure/sign/painting/library{
	pixel_x = 32
	},
/turf/open/floor/wood,
/area/misc/condo)
"cz" = (
/obj/structure/table/wood,
/obj/effect/turf_decal/siding/wood{
	dir = 1
	},
/obj/item/storage/dice{
	pixel_x = 8;
	pixel_y = 6
	},
/obj/item/storage/dice{
	pixel_x = -5;
	pixel_y = 6
	},
/turf/open/floor/carpet/black,
/area/misc/condo)
"cD" = (
/obj/machinery/door/airlock/wood/glass,
/turf/open/floor/wood,
/area/misc/condo)
"dw" = (
/obj/structure/table/wood,
/obj/item/stack/sheet/mineral/sandstone/thirty,
/obj/item/stack/sheet/mineral/gold,
/obj/item/stack/sheet/mineral/gold,
/obj/item/stack/sheet/mineral/silver,
/obj/item/stack/sheet/mineral/silver,
/obj/item/stack/sheet/mineral/gold,
/obj/item/stack/sheet/mineral/silver,
/obj/item/stack/sheet/mineral/diamond/five,
/turf/open/floor/iron/sepia,
/area/misc/condo)
"dS" = (
/obj/effect/turf_decal/siding/wood{
	dir = 4
	},
/obj/effect/turf_decal/siding/wood{
	dir = 8
	},
/obj/machinery/light/small/dim/directional/west,
/turf/open/floor/wood,
/area/misc/condo)
"dT" = (
/obj/effect/turf_decal/siding/wood/end{
	dir = 8
	},
/turf/open/floor/wood,
/area/misc/condo)
"eO" = (
/turf/open/floor/carpet/red,
/area/misc/condo)
"fa" = (
/turf/closed/indestructible/wood,
/area/misc/condo)
"fi" = (
/obj/effect/turf_decal/siding/wood{
	dir = 9
	},
/obj/effect/turf_decal/siding/wood/corner,
/turf/open/floor/wood,
/area/misc/condo)
"gQ" = (
/obj/effect/turf_decal/siding/wood{
	dir = 1
	},
/obj/effect/turf_decal/siding/wood,
/turf/open/floor/wood,
/area/misc/condo)
"ho" = (
/obj/effect/turf_decal/siding/wood{
	dir = 8
	},
/turf/open/floor/carpet/black,
/area/misc/condo)
"ik" = (
/obj/structure/table/wood,
/obj/machinery/computer/libraryconsole/bookmanagement,
/obj/effect/turf_decal/siding/wood,
/obj/effect/turf_decal/siding/wood{
	dir = 1
	},
/turf/open/floor/iron/grimy,
/area/misc/condo)
"iL" = (
/obj/structure/easel,
/obj/effect/turf_decal/siding/wood{
	dir = 4
	},
/obj/effect/turf_decal/siding/wood{
	dir = 8
	},
/obj/item/canvas/twentythree_twentythree,
/obj/item/canvas/twentythree_twentythree,
/obj/item/canvas/twentythree_nineteen,
/obj/item/canvas/fortyfive_twentyseven{
	pixel_x = 4;
	pixel_y = 4
	},
/obj/item/canvas/nineteen_nineteen,
/obj/machinery/light/directional/east,
/turf/open/floor/wood,
/area/misc/condo)
"jr" = (
/obj/structure/bookcase/random/fiction,
/turf/open/floor/wood,
/area/misc/condo)
"jx" = (
/obj/structure/table/wood,
/obj/item/pen/fourcolor,
/turf/open/floor/wood,
/area/misc/condo)
"jT" = (
/obj/machinery/bookbinder,
/obj/machinery/light/directional/south,
/turf/open/floor/carpet/red,
/area/misc/condo)
"kh" = (
/obj/machinery/libraryscanner,
/turf/open/floor/carpet/green,
/area/misc/condo)
"kD" = (
/obj/effect/turf_decal/siding/wood{
	dir = 9
	},
/turf/open/floor/carpet/black,
/area/misc/condo)
"kS" = (
/obj/effect/turf_decal/siding/wood{
	dir = 8
	},
/obj/structure/chair/comfy/brown{
	buildstackamount = 0;
	color = "#c45c57";
	dir = 8;
	pixel_y = -8
	},
/turf/open/floor/carpet/black,
/area/misc/condo)
"kW" = (
/obj/machinery/vending/games,
/obj/structure/sign/painting/library{
	pixel_y = 33
	},
/obj/effect/turf_decal/siding/wood{
	dir = 9
	},
/obj/effect/turf_decal/siding/wood/corner,
/turf/open/floor/wood,
/area/misc/condo)
"lY" = (
/obj/effect/turf_decal/siding/wood,
/obj/effect/turf_decal/siding/wood{
	dir = 1
	},
/obj/machinery/photocopier/gratis/infinite,
/turf/open/floor/wood,
/area/misc/condo)
"md" = (
/obj/structure/table/wood,
/obj/effect/turf_decal/siding/wood/end,
/obj/item/paper_bin/carbon{
	pixel_x = -6
	},
/obj/item/paper_bin/carbon{
	pixel_x = 7
	},
/turf/open/floor/iron/grimy,
/area/misc/condo)
"mK" = (
/obj/structure/bookcase/random/religion,
/turf/open/floor/wood,
/area/misc/condo)
"nA" = (
/obj/structure/chair/comfy/beige{
	dir = 4
	},
/obj/effect/turf_decal/siding/wood/end{
	dir = 8
	},
/turf/open/floor/wood,
/area/misc/condo)
"oZ" = (
/obj/effect/turf_decal/siding/wood{
	dir = 1
	},
/obj/structure/chair/office,
/turf/open/floor/wood,
/area/misc/condo)
"pm" = (
/obj/structure/chair/comfy/brown{
	dir = 4
	},
/obj/effect/turf_decal/siding/wood,
/turf/open/floor/wood,
/area/misc/condo)
"pv" = (
/obj/effect/turf_decal/siding/wood,
/obj/effect/turf_decal/siding/wood{
	dir = 1
	},
/obj/structure/chair/office,
/turf/open/floor/wood,
/area/misc/condo)
"pD" = (
/obj/effect/turf_decal/siding/wood{
	dir = 1
	},
/obj/effect/turf_decal/siding/wood,
/obj/structure/chair/office{
	dir = 1
	},
/obj/machinery/light/small/dim/directional/south,
/turf/open/floor/wood,
/area/misc/condo)
"qn" = (
/obj/structure/table/wood,
/turf/open/floor/wood,
/area/misc/condo)
"st" = (
/obj/structure/table/wood,
/obj/effect/turf_decal/siding/wood,
/obj/item/toy/figure/wizard{
	pixel_y = -2;
	pixel_x = -8
	},
/obj/item/toy/figure/ninja{
	pixel_y = -2
	},
/obj/item/toy/figure/secofficer{
	pixel_y = -2;
	pixel_x = 8
	},
/obj/item/toy/figure/cmo{
	pixel_y = 13
	},
/obj/item/toy/figure/curator{
	pixel_y = 13;
	pixel_x = 8
	},
/turf/open/floor/carpet/black,
/area/misc/condo)
"tZ" = (
/obj/machinery/light/directional/north,
/obj/machinery/photocopier/gratis/infinite,
/turf/open/floor/iron/grimy,
/area/misc/condo)
"uX" = (
/obj/structure/table/wood,
/obj/item/reagent_containers/cup/glass/coffee,
/turf/open/floor/wood,
/area/misc/condo)
"wb" = (
/obj/structure/table/wood,
/obj/effect/turf_decal/siding/wood,
/obj/effect/spawner/random/entertainment/money_large,
/obj/effect/spawner/random/entertainment/money_large,
/obj/machinery/light/directional/south,
/turf/open/floor/wood,
/area/misc/condo)
"wl" = (
/obj/structure/chair/comfy/beige{
	dir = 8
	},
/obj/effect/turf_decal/siding/wood,
/obj/effect/turf_decal/siding/wood{
	dir = 1
	},
/turf/open/floor/wood,
/area/misc/condo)
"wu" = (
/obj/item/kirbyplants/random,
/turf/open/floor/iron/grimy,
/area/misc/condo)
"wS" = (
/obj/structure/table/wood,
/turf/open/floor/carpet/red,
/area/misc/condo)
"xT" = (
/obj/machinery/modular_computer/preset/curator{
	dir = 1
	},
/obj/machinery/light/directional/east,
/turf/open/floor/carpet/green,
/area/misc/condo)
"zY" = (
/obj/structure/table/wood,
/obj/effect/turf_decal/siding/wood{
	dir = 9
	},
/obj/effect/turf_decal/siding/wood/corner,
/turf/open/floor/iron/grimy,
/area/misc/condo)
"Ae" = (
/obj/structure/easel,
/obj/item/canvas/twentythree_twentythree,
/obj/item/canvas/twentythree_twentythree,
/obj/item/canvas/twentythree_nineteen,
/obj/item/canvas/fortyfive_twentyseven{
	pixel_x = 4;
	pixel_y = 4
	},
/obj/effect/turf_decal/siding/wood/corner{
	dir = 1
	},
/obj/effect/turf_decal/siding/wood{
	dir = 6
	},
/obj/item/canvas/nineteen_nineteen,
/obj/structure/sign/painting/library{
	pixel_x = 32
	},
/turf/open/floor/wood,
/area/misc/condo)
"AE" = (
/obj/structure/table/wood,
/obj/effect/turf_decal/siding/wood,
/obj/effect/turf_decal/siding/wood{
	dir = 1
	},
/obj/item/reagent_containers/cup/glass/coffee,
/turf/open/floor/wood,
/area/misc/condo)
"AO" = (
/obj/effect/turf_decal/siding/wood,
/turf/open/floor/wood,
/area/misc/condo)
"BF" = (
/obj/structure/bookcase/random/adult,
/turf/open/floor/wood,
/area/misc/condo)
"BR" = (
/turf/closed/indestructible/rock,
/area/misc/condo)
"Dc" = (
/turf/open/floor/wood,
/area/misc/condo)
"DX" = (
/obj/machinery/bookbinder,
/obj/effect/turf_decal/siding/wood,
/obj/effect/turf_decal/siding/wood{
	dir = 1
	},
/turf/open/floor/wood,
/area/misc/condo)
"Ea" = (
/obj/structure/table/wood,
/obj/item/paper_bin/carbon{
	pixel_y = 1
	},
/obj/item/pen,
/turf/open/floor/carpet/black,
/area/misc/condo)
"EX" = (
/obj/effect/turf_decal/siding/wood,
/obj/effect/turf_decal/siding/wood{
	dir = 1
	},
/obj/structure/chair/office{
	dir = 1
	},
/turf/open/floor/wood,
/area/misc/condo)
"Fl" = (
/obj/structure/table/wood,
/obj/item/paper_bin/carbon{
	pixel_y = 2;
	pixel_x = 6
	},
/obj/item/pen/fourcolor{
	pixel_x = 6;
	pixel_y = 2
	},
/turf/open/floor/iron/grimy,
/area/misc/condo)
"FN" = (
/turf/open/floor/iron/sepia,
/area/misc/condo)
"Gv" = (
/obj/effect/turf_decal/siding/wood{
	dir = 1
	},
/obj/effect/turf_decal/siding/wood,
/obj/structure/chair/office{
	dir = 1
	},
/turf/open/floor/wood,
/area/misc/condo)
"HL" = (
/obj/structure/sign/painting/library{
	pixel_y = -32
	},
/obj/effect/turf_decal/siding/wood{
	dir = 1
	},
/obj/effect/turf_decal/siding/wood,
/turf/open/floor/wood,
/area/misc/condo)
"HO" = (
/obj/effect/turf_decal/siding/wood,
/obj/effect/turf_decal/siding/wood{
	dir = 1
	},
/obj/structure/sign/painting/large/library{
	dir = 1
	},
/obj/item/kirbyplants/random,
/turf/open/floor/wood,
/area/misc/condo)
"Ib" = (
/obj/structure/table/wood,
/obj/effect/turf_decal/siding/wood{
	dir = 8
	},
/obj/effect/turf_decal/siding/wood{
	dir = 4
	},
/obj/item/pen/fountain,
/turf/open/floor/iron/grimy,
/area/misc/condo)
"Ix" = (
/obj/structure/table/wood,
/obj/item/papercutter{
	pixel_x = 4;
	pixel_y = 4
	},
/obj/item/storage/crayons{
	pixel_x = 1;
	pixel_y = -1
	},
/obj/item/storage/crayons{
	pixel_x = -2;
	pixel_y = -5
	},
/obj/item/wirecutters,
/turf/open/floor/carpet/blue,
/area/misc/condo)
"Je" = (
/obj/structure/chair/comfy/brown{
	dir = 8
	},
/obj/effect/turf_decal/siding/wood,
/turf/open/floor/wood,
/area/misc/condo)
"JW" = (
/obj/effect/turf_decal/siding/wood,
/obj/effect/turf_decal/siding/wood{
	dir = 1
	},
/turf/open/floor/wood,
/area/misc/condo)
"LC" = (
/obj/effect/turf_decal/siding/wood{
	dir = 8
	},
/turf/open/floor/wood,
/area/misc/condo)
"Mf" = (
/obj/machinery/computer/libraryconsole/bookmanagement,
/obj/structure/table/wood,
/turf/open/floor/iron/grimy,
/area/misc/condo)
"Mj" = (
/obj/structure/fireplace{
	pixel_y = 0;
	pixel_x = 0
	},
/obj/effect/turf_decal/siding/wood{
	dir = 1
	},
/obj/effect/turf_decal/siding/wood,
/obj/structure/chair/office,
/obj/machinery/light/small/dim/directional/north,
/turf/open/floor/wood,
/area/misc/condo)
"Mk" = (
/obj/structure/table/wood,
/obj/item/paper_bin/carbon{
	pixel_y = 10;
	pixel_x = -8
	},
/obj/item/pen{
	pixel_y = 10;
	pixel_x = -7
	},
/turf/open/floor/wood,
/area/misc/condo)
"Mp" = (
/obj/structure/sign/painting/library{
	pixel_y = -32
	},
/obj/effect/turf_decal/siding/wood{
	dir = 10
	},
/obj/effect/turf_decal/siding/wood/corner{
	dir = 4
	},
/turf/open/floor/wood,
/area/misc/condo)
"MO" = (
/obj/machinery/vending/coffee{
	default_price = 0
	},
/turf/open/floor/carpet/red,
/area/misc/condo)
"Np" = (
/obj/structure/table/wood,
/obj/item/dice/d20{
	pixel_y = -10
	},
/turf/open/floor/carpet/red,
/area/misc/condo)
"NX" = (
/obj/effect/turf_decal/siding/wood,
/obj/effect/turf_decal/siding/wood,
/obj/structure/chair/office,
/turf/open/floor/wood,
/area/misc/condo)
"Oh" = (
/obj/structure/table/wood/fancy,
/obj/effect/spawner/random/decoration/statue{
	spawn_loot_chance = 35
	},
/obj/structure/sign/painting/library{
	pixel_x = -32
	},
/obj/machinery/light/directional/south,
/turf/open/floor/wood,
/area/misc/condo)
"Py" = (
/turf/open/floor/iron/grimy,
/area/misc/condo)
"PK" = (
/obj/effect/turf_decal/siding/wood{
	dir = 10
	},
/turf/open/floor/carpet/black,
/area/misc/condo)
"QJ" = (
/obj/effect/turf_decal/siding/wood/end{
	dir = 4
	},
/turf/open/floor/iron/grimy,
/area/misc/condo)
"Rr" = (
/obj/structure/table/wood/fancy,
/obj/effect/spawner/random/decoration/statue{
	spawn_loot_chance = 35
	},
/obj/structure/sign/painting/library{
	pixel_x = -32
	},
/obj/machinery/light/directional/north,
/turf/open/floor/wood,
/area/misc/condo)
"RM" = (
/obj/effect/spawner/structure/window,
/turf/open/floor/plating,
/area/misc/condo)
"RP" = (
/obj/structure/chair/office{
	dir = 8
	},
/turf/open/floor/carpet/green,
/area/misc/condo)
"SS" = (
/obj/structure/table/wood,
/obj/item/paper_bin/carbon{
	pixel_y = 2;
	pixel_x = 6
	},
/obj/item/pen/fountain{
	pixel_y = -2;
	pixel_x = -9
	},
/obj/item/pen{
	pixel_x = 6;
	pixel_y = 3
	},
/obj/machinery/light/directional/north,
/turf/open/floor/iron/grimy,
/area/misc/condo)
"Tj" = (
/obj/structure/chair/office{
	dir = 4
	},
/obj/effect/turf_decal/siding/wood{
	dir = 8
	},
/turf/open/floor/wood,
/area/misc/condo)
"Tu" = (
/obj/effect/turf_decal/siding/wood{
	dir = 4
	},
/obj/effect/turf_decal/siding/wood{
	dir = 8
	},
/turf/open/floor/wood,
/area/misc/condo)
"Ul" = (
/obj/structure/table/wood,
/obj/effect/turf_decal/siding/wood{
	dir = 8
	},
/obj/effect/turf_decal/siding/wood{
	dir = 4
	},
/obj/item/toy/eldritch_book,
/turf/open/floor/iron/grimy,
/area/misc/condo)
"UQ" = (
/obj/structure/table/wood,
/obj/item/toy/crayon/spraycan{
	pixel_x = 4;
	pixel_y = 8
	},
/obj/item/chisel{
	pixel_x = -15;
	pixel_y = 6
	},
/obj/item/toy/crayon/spraycan{
	pixel_x = -4;
	pixel_y = 8
	},
/obj/item/toy/crayon/spraycan{
	pixel_y = 6
	},
/obj/item/paint_palette,
/turf/open/floor/carpet/blue,
/area/misc/condo)
"UU" = (
/obj/structure/table/wood,
/obj/item/paper_bin/carbon{
	pixel_y = -7
	},
/obj/item/pen/fourcolor{
	pixel_y = -7
	},
/obj/machinery/light/directional/east,
/turf/open/floor/carpet/black,
/area/misc/condo)
"Wh" = (
/turf/open/floor/carpet/green,
/area/misc/condo)
"Wl" = (
/obj/machinery/door/airlock/wood,
/turf/open/floor/wood,
/area/misc/condo)
"Wt" = (
/obj/effect/turf_decal/siding/wood{
	dir = 10
	},
/obj/effect/turf_decal/siding/wood/corner{
	dir = 4
	},
/turf/open/floor/wood,
/area/misc/condo)
"WI" = (
/obj/effect/turf_decal/siding/wood{
	dir = 1
	},
/obj/effect/turf_decal/siding/wood/corner{
	dir = 8
	},
/turf/open/floor/wood,
/area/misc/condo)
"WN" = (
/obj/effect/turf_decal/siding/wood{
	dir = 1
	},
/turf/open/floor/wood,
/area/misc/condo)
"WX" = (
/obj/structure/sign/painting/large/library{
	pixel_y = -37
	},
/obj/effect/turf_decal/siding/wood{
	dir = 1
	},
/obj/effect/turf_decal/siding/wood,
/turf/open/floor/wood,
/area/misc/condo)
"YW" = (
/turf/closed/indestructible/hoteldoor/fakedoor,
/area/misc/condo)
"Zq" = (
/obj/effect/turf_decal/siding/wood,
/obj/effect/turf_decal/siding/wood/corner{
	dir = 1
	},
/turf/open/floor/wood,
/area/misc/condo)

(1,1,1) = {"
BR
BR
BR
BR
fa
fa
YW
fa
fa
fa
fa
fa
fa
fa
fa
"}
(2,1,1) = {"
fa
fa
fa
fa
fa
MO
eO
jT
fa
fa
Rr
ar
ar
Oh
fa
"}
(3,1,1) = {"
fa
BF
dT
jr
dT
eO
eO
eO
nA
fa
kW
Tu
Tu
Mp
fa
"}
(4,1,1) = {"
fa
BF
gQ
jr
gQ
eO
aM
eO
AE
RM
DX
FN
dw
WX
fa
"}
(5,1,1) = {"
fa
BF
gQ
jr
gQ
eO
aM
eO
wl
RM
lY
FN
Ix
gQ
fa
"}
(6,1,1) = {"
fa
Mf
gQ
wu
gQ
eO
eO
eO
JW
cD
JW
FN
UQ
HL
fa
"}
(7,1,1) = {"
fa
SS
gQ
Py
WI
Tj
Tj
LC
Zq
fa
HO
FN
FN
bw
fa
"}
(8,1,1) = {"
fa
BF
gQ
jr
oZ
uX
qn
Dc
pm
fa
cy
iL
Tu
Ae
fa
"}
(9,1,1) = {"
fa
BF
gQ
jr
oZ
jx
Mk
Dc
wb
fa
fa
fa
Wl
fa
fa
"}
(10,1,1) = {"
fa
BF
gQ
jr
WN
bz
bz
Dc
Je
fa
fi
dS
Tu
Wt
fa
"}
(11,1,1) = {"
fa
Fl
gQ
Py
WN
Dc
Dc
Dc
AO
Wl
pv
wS
wS
Gv
fa
"}
(12,1,1) = {"
fa
tZ
gQ
wu
WN
zY
Ul
Ib
md
fa
Mj
Np
wS
pD
fa
"}
(13,1,1) = {"
fa
mK
gQ
aS
WN
ik
RP
Wh
kh
fa
NX
wS
wS
EX
fa
"}
(14,1,1) = {"
fa
mK
gQ
aS
WN
QJ
Wh
Wh
xT
fa
kD
kS
ho
PK
fa
"}
(15,1,1) = {"
fa
mK
aC
aS
aC
fa
fa
fa
fa
fa
cz
UU
Ea
st
fa
"}
(16,1,1) = {"
fa
fa
fa
fa
fa
fa
BR
BR
BR
fa
fa
fa
fa
fa
fa
"}
