//MAP CONVERTED BY dmm2tgm.py THIS HEADER COMMENT PREVENTS RECONVERSION, DO NOT REMOVE
"a" = (
/turf/cordon,
/area/misc/condo)
"b" = (
/turf/open/floor/iron/showroomfloor,
/area/misc/condo)
"c" = (
/turf/closed/indestructible/wood,
/area/misc/condo)
"d" = (
/obj/structure/chair/wood/wings{
	dir = 8
	},
/turf/open/floor/wood/large,
/area/misc/condo)
"e" = (
/obj/effect/turf_decal/siding/white{
	dir = 8
	},
/obj/effect/turf_decal/tile/blue{
	dir = 4
	},
/turf/open/floor/iron/showroomfloor,
/area/misc/condo)
"f" = (
/obj/structure/displaycase/trophy,
/turf/open/floor/wood/large,
/area/misc/condo)
"g" = (
/turf/closed/indestructible/fakeglass,
/area/misc/condo)
"h" = (
/turf/open/misc/asteroid/snow/standard_air,
/area/misc/condo)
"i" = (
/obj/effect/turf_decal/siding/wideplating_new{
	dir = 8
	},
/obj/effect/turf_decal/siding/wideplating_new{
	dir = 4
	},
/obj/machinery/door/airlock/grunge{
	dir = 4;
	name = "Pool"
	},
/turf/open/floor/iron/smooth_large,
/area/misc/condo)
"j" = (
/obj/structure/bed/pod,
/turf/open/floor/iron/showroomfloor,
/area/misc/condo)
"k" = (
/obj/machinery/light_switch/directional/east,
/turf/open/floor/iron/showroomfloor,
/area/misc/condo)
"l" = (
/turf/open/floor/fakeice,
/area/misc/condo)
"m" = (
/turf/closed/indestructible/sandstone,
/area/misc/condo)
"n" = (
/turf/closed/indestructible/rock,
/area/misc/condo)
"o" = (
/obj/effect/turf_decal/siding/white{
	dir = 8
	},
/obj/effect/turf_decal/tile/blue,
/obj/effect/turf_decal/siding/white{
	dir = 4
	},
/obj/structure/railing{
	dir = 4
	},
/obj/structure/chair/comfy/shuttle{
	dir = 8
	},
/turf/open/floor/iron/showroomfloor,
/area/misc/condo)
"p" = (
/obj/structure/flora/tree/dead/style_2,
/turf/open/misc/asteroid/snow/standard_air,
/area/misc/condo)
"r" = (
/obj/effect/turf_decal/siding/white{
	dir = 8
	},
/obj/effect/turf_decal/tile/blue,
/obj/effect/turf_decal/siding/white{
	dir = 4
	},
/obj/structure/railing{
	dir = 4
	},
/turf/open/floor/iron/showroomfloor,
/area/misc/condo)
"s" = (
/obj/structure/rack,
/turf/open/floor/iron/showroomfloor,
/area/misc/condo)
"t" = (
/obj/machinery/light/directional/west,
/turf/open/floor/carpet/red,
/area/misc/condo)
"u" = (
/obj/effect/turf_decal/siding/wideplating_new/terracotta{
	dir = 1
	},
/obj/effect/turf_decal/weather/snow,
/obj/effect/turf_decal/weather/snow/corner{
	dir = 5
	},
/turf/open/floor/iron/terracotta/diagonal,
/area/misc/condo)
"w" = (
/obj/effect/spawner/liquids_spawner,
/turf/open/floor/iron/pool,
/area/misc/condo)
"x" = (
/obj/machinery/light/directional/east,
/obj/effect/turf_decal/siding/white,
/turf/open/floor/iron/showroomfloor,
/area/misc/condo)
"y" = (
/obj/structure/chair/wood/wings{
	dir = 8
	},
/obj/structure/sign/painting/library{
	pixel_x = 32
	},
/turf/open/floor/wood/large,
/area/misc/condo)
"z" = (
/obj/structure/fluff/fake_vent,
/turf/open/floor/iron/showroomfloor,
/area/misc/condo)
"A" = (
/obj/structure/flora/rock/pile/icy/style_2,
/turf/open/misc/asteroid/snow/standard_air,
/area/misc/condo)
"B" = (
/obj/machinery/light_switch/directional/west,
/turf/open/floor/carpet/red,
/area/misc/condo)
"C" = (
/turf/open/floor/carpet/red,
/area/misc/condo)
"E" = (
/obj/structure/fluff/fake_scrubber,
/obj/effect/turf_decal/siding/white,
/turf/open/floor/iron/showroomfloor,
/area/misc/condo)
"G" = (
/obj/structure/flora/rock/pile/icy,
/turf/open/misc/asteroid/snow/standard_air,
/area/misc/condo)
"H" = (
/obj/structure/table/wood,
/obj/structure/sign/painting/library{
	pixel_x = 32
	},
/turf/open/floor/wood/large,
/area/misc/condo)
"I" = (
/turf/closed/indestructible/hoteldoor/fakedoor,
/area/misc/condo)
"L" = (
/obj/effect/spawner/liquids_spawner,
/obj/machinery/light/directional/west,
/turf/open/floor/iron/pool,
/area/misc/condo)
"M" = (
/obj/effect/turf_decal/siding/white{
	dir = 8
	},
/obj/effect/turf_decal/tile/blue,
/obj/effect/turf_decal/siding/white/corner,
/obj/structure/railing/corner/end/flip,
/turf/open/floor/iron/showroomfloor,
/area/misc/condo)
"N" = (
/obj/effect/light_emitter/fake_outdoors,
/turf/open/misc/asteroid/snow/standard_air,
/area/misc/condo)
"O" = (
/obj/structure/flora/tree/dead/style_5,
/turf/open/misc/asteroid/snow/standard_air,
/area/misc/condo)
"P" = (
/obj/machinery/light/directional/east,
/obj/item/kirbyplants/random,
/turf/open/floor/wood/large,
/area/misc/condo)
"Q" = (
/obj/effect/planetary_turf_atmos_helper,
/turf/closed/indestructible/sandstone,
/area/misc/condo)
"R" = (
/obj/structure/flora/tree/dead/style_3,
/turf/open/misc/asteroid/snow/standard_air,
/area/misc/condo)
"T" = (
/obj/structure/table/wood,
/turf/open/floor/wood/large,
/area/misc/condo)
"U" = (
/obj/effect/turf_decal/siding/wideplating_new/terracotta{
	dir = 1
	},
/obj/effect/turf_decal/weather/snow,
/obj/effect/turf_decal/weather/snow/corner{
	dir = 1
	},
/turf/open/floor/iron/terracotta/diagonal,
/area/misc/condo)
"V" = (
/obj/effect/turf_decal/siding/wideplating_new/terracotta{
	dir = 1
	},
/obj/effect/turf_decal/weather/snow,
/obj/effect/turf_decal/weather/snow/corner{
	dir = 9
	},
/turf/open/floor/iron/terracotta/diagonal,
/area/misc/condo)
"W" = (
/turf/closed/indestructible/rock/snow,
/area/misc/condo)
"X" = (
/obj/effect/turf_decal/siding/wood,
/obj/machinery/door/airlock/public/glass{
	name = "Lodge Exterior"
	},
/obj/effect/turf_decal/siding/wood{
	dir = 1
	},
/turf/open/floor/wood/large,
/area/misc/condo)
"Y" = (
/obj/effect/spawner/liquids_spawner,
/turf/open/floor/iron/lowered,
/area/misc/condo)
"Z" = (
/obj/structure/flora/tree/dead/style_6,
/turf/open/misc/asteroid/snow/standard_air,
/area/misc/condo)

(1,1,1) = {"
a
a
a
a
a
a
a
n
n
m
m
m
m
m
m
Q
"}
(2,1,1) = {"
a
a
a
a
a
a
a
n
w
w
w
L
w
w
w
m
"}
(3,1,1) = {"
a
a
a
a
a
a
a
n
w
w
w
w
w
w
w
m
"}
(4,1,1) = {"
a
a
a
a
a
a
a
n
w
w
w
w
w
w
w
m
"}
(5,1,1) = {"
a
a
a
W
W
W
W
n
n
w
w
w
w
w
w
m
"}
(6,1,1) = {"
a
W
W
W
l
h
W
W
n
e
e
e
M
r
o
m
"}
(7,1,1) = {"
W
W
l
l
h
h
G
W
n
j
z
j
E
Y
Y
c
"}
(8,1,1) = {"
W
l
l
l
h
O
W
W
n
s
k
b
x
Y
Y
c
"}
(9,1,1) = {"
W
l
l
R
h
h
W
c
c
c
c
i
c
g
g
c
"}
(10,1,1) = {"
W
l
l
N
h
h
V
c
C
t
C
C
B
C
C
c
"}
(11,1,1) = {"
W
l
l
h
p
h
U
X
C
C
C
C
C
C
C
I
"}
(12,1,1) = {"
W
l
A
h
h
h
u
c
T
H
d
y
f
P
f
c
"}
(13,1,1) = {"
W
W
l
Z
h
h
W
c
c
c
c
c
c
c
c
c
"}
(14,1,1) = {"
a
W
W
h
h
W
W
a
a
a
a
a
a
a
a
a
"}
(15,1,1) = {"
a
a
W
W
W
W
a
a
a
a
a
a
a
a
a
a
"}
