//MAP CONVERTED BY dmm2tgm.py THIS HEADER COMMENT PREVENTS RECONVERSION, DO NOT REMOVE
"aa" = (
/obj/structure/bookcase/random/fiction,
/obj/effect/turf_decal/siding/wood,
/obj/structure/sign/painting/library{
	pixel_y = 32
	},
/turf/open/floor/wood/large,
/area/misc/condo)
"aF" = (
/obj/structure/flora/bush/reed/style_random,
/turf/open/misc/dirt/jungle,
/area/misc/condo)
"bp" = (
/obj/structure/flora/bush/lavendergrass/style_random,
/turf/open/misc/grass/jungle/station,
/area/misc/condo)
"bZ" = (
/obj/effect/turf_decal/siding/wideplating_new/corner{
	dir = 4
	},
/turf/open/floor/stone,
/area/misc/condo)
"ci" = (
/obj/structure/hedge,
/turf/open/misc/grass/jungle/station,
/area/misc/condo)
"cT" = (
/turf/open/misc/grass/jungle/station,
/area/misc/condo)
"dV" = (
/obj/effect/turf_decal/siding/wood{
	dir = 1
	},
/obj/item/kirbyplants/random,
/obj/machinery/light/directional/south,
/turf/open/floor/wood/large,
/area/misc/condo)
"ev" = (
/obj/structure/flora/bush/flowers_br/style_random,
/turf/open/misc/dirt/jungle,
/area/misc/condo)
"fa" = (
/obj/structure/fireplace{
	dir = 4;
	pixel_x = -7;
	pixel_y = -1
	},
/turf/open/floor/wood/tile,
/area/misc/condo)
"fP" = (
/turf/open/floor/stone,
/area/misc/condo)
"gf" = (
/turf/closed/indestructible/sandstone,
/area/misc/condo)
"ix" = (
/obj/structure/sign/clock/directional/north,
/turf/open/floor/carpet/blue,
/area/misc/condo)
"ji" = (
/obj/effect/turf_decal/siding/wood,
/obj/structure/table/wood/fancy,
/obj/item/reagent_containers/cup/glass/mug/tea{
	pixel_x = -6
	},
/turf/open/floor/wood/large,
/area/misc/condo)
"jr" = (
/obj/effect/turf_decal/siding/wood,
/obj/structure/chair/comfy/beige,
/turf/open/floor/wood/large,
/area/misc/condo)
"mX" = (
/obj/structure/flora/bush/flowers_pp/style_random,
/turf/open/misc/grass/jungle/station,
/area/misc/condo)
"nu" = (
/turf/open/floor/carpet/red,
/area/misc/condo)
"or" = (
/turf/open/misc/dirt/jungle,
/area/misc/condo)
"oG" = (
/obj/effect/turf_decal/siding/wideplating_new/corner{
	dir = 1
	},
/turf/open/floor/stone,
/area/misc/condo)
"pI" = (
/obj/effect/turf_decal/siding/wideplating_new{
	dir = 9
	},
/turf/open/floor/stone,
/area/misc/condo)
"ql" = (
/obj/effect/turf_decal/siding/wood{
	dir = 1
	},
/obj/structure/closet/cabinet,
/turf/open/floor/wood/large,
/area/misc/condo)
"rk" = (
/obj/structure/flora/tree/jungle/style_4,
/turf/open/misc/grass/jungle/station,
/area/misc/condo)
"rQ" = (
/obj/structure/flora/bush/reed/style_random,
/turf/open/misc/dirt/jungle/dark,
/area/misc/condo)
"su" = (
/obj/item/kirbyplants/random,
/obj/effect/turf_decal/siding/wood{
	dir = 1
	},
/obj/machinery/light/directional/south,
/turf/open/floor/wood/large,
/area/misc/condo)
"tt" = (
/obj/structure/curtain/cloth,
/turf/closed/indestructible/fakeglass,
/area/misc/condo)
"xi" = (
/obj/structure/chair/wood/wings,
/turf/open/floor/wood/tile,
/area/misc/condo)
"zf" = (
/obj/effect/light_emitter/fake_outdoors,
/turf/open/water/jungle,
/area/misc/condo)
"zp" = (
/obj/effect/planetary_turf_atmos_helper,
/turf/closed/indestructible/sandstone,
/area/misc/condo)
"zW" = (
/obj/effect/turf_decal/siding/wideplating_new,
/turf/open/floor/stone,
/area/misc/condo)
"AI" = (
/turf/open/water/jungle,
/area/misc/condo)
"AL" = (
/turf/closed/indestructible/hoteldoor/fakedoor,
/area/misc/condo)
"Bn" = (
/obj/structure/bookcase/random/adult,
/obj/effect/turf_decal/siding/wood,
/turf/open/floor/wood/large,
/area/misc/condo)
"BL" = (
/obj/effect/turf_decal/siding/wideplating_new{
	dir = 5
	},
/turf/open/floor/stone,
/area/misc/condo)
"Dl" = (
/obj/structure/flora/bush/generic/style_random,
/turf/open/misc/grass/jungle/station,
/area/misc/condo)
"Do" = (
/obj/effect/turf_decal/siding/wood,
/obj/structure/table/wood,
/obj/item/reagent_containers/cup/bowl{
	pixel_y = 8
	},
/turf/open/floor/wood/large,
/area/misc/condo)
"DQ" = (
/obj/structure/hedge,
/turf/open/misc/beach/sand,
/area/misc/condo)
"Er" = (
/obj/structure/chair/wood/wings{
	dir = 8
	},
/turf/open/floor/wood/tile,
/area/misc/condo)
"ED" = (
/turf/open/misc/dirt/jungle/dark,
/area/misc/condo)
"Fe" = (
/obj/structure/flora/tree/jungle/small/style_4,
/turf/open/misc/grass/jungle/station,
/area/misc/condo)
"GB" = (
/obj/effect/turf_decal/siding/wood,
/obj/structure/displaycase/trophy,
/turf/open/floor/wood/large,
/area/misc/condo)
"Hj" = (
/obj/structure/flora/bush/flowers_yw/style_random,
/turf/open/misc/grass/jungle/station,
/area/misc/condo)
"Hq" = (
/turf/open/floor/wood/parquet,
/area/misc/condo)
"IB" = (
/turf/closed/indestructible/rock,
/area/misc/condo)
"Ji" = (
/obj/machinery/door/airlock/multi_tile/public/glass{
	name = "Garden"
	},
/turf/open/floor/stone,
/area/misc/condo)
"Jn" = (
/turf/cordon,
/area/misc/condo)
"Nx" = (
/turf/open/floor/carpet/orange,
/area/misc/condo)
"Od" = (
/obj/effect/turf_decal/siding/wood{
	dir = 1
	},
/obj/structure/table/wood,
/obj/item/plate{
	pixel_y = 8
	},
/turf/open/floor/wood/large,
/area/misc/condo)
"Pk" = (
/turf/open/floor/carpet/blue,
/area/misc/condo)
"Rq" = (
/obj/effect/light_emitter/fake_outdoors,
/turf/open/misc/grass/jungle/station,
/area/misc/condo)
"SB" = (
/turf/closed/indestructible/weeb,
/area/misc/condo)
"SE" = (
/obj/effect/turf_decal/siding/wood{
	dir = 1
	},
/obj/structure/table/wood,
/obj/item/flashlight/lamp/green{
	pixel_y = 6;
	pixel_x = -7
	},
/turf/open/floor/wood/large,
/area/misc/condo)
"SI" = (
/obj/structure/table/wood,
/obj/item/book/random{
	pixel_x = -7;
	pixel_y = 5
	},
/obj/effect/turf_decal/siding/wood{
	dir = 1
	},
/turf/open/floor/wood/large,
/area/misc/condo)
"SU" = (
/turf/closed/indestructible/hoteldoor/fakedoor{
	dir = 4
	},
/area/misc/condo)
"Uq" = (
/obj/structure/mirror/directional/east,
/turf/open/floor/carpet/orange,
/area/misc/condo)
"UQ" = (
/obj/structure/table/wood,
/obj/item/phone{
	pixel_y = 1;
	pixel_x = 8
	},
/obj/effect/turf_decal/siding/wood{
	dir = 1
	},
/turf/open/floor/wood/large,
/area/misc/condo)
"Wi" = (
/turf/open/floor/wood/tile,
/area/misc/condo)
"WG" = (
/turf/open/misc/beach/sand,
/area/misc/condo)
"WK" = (
/obj/effect/turf_decal/siding/wood,
/obj/item/bouquet/sunflower{
	pixel_y = 6
	},
/obj/structure/table/wood,
/turf/open/floor/wood/large,
/area/misc/condo)
"WZ" = (
/obj/structure/dresser,
/obj/effect/turf_decal/siding/wood{
	dir = 1
	},
/turf/open/floor/wood/large,
/area/misc/condo)
"Yt" = (
/obj/machinery/light/directional/west,
/turf/open/floor/carpet/red,
/area/misc/condo)

(1,1,1) = {"
Jn
Jn
Jn
Jn
IB
IB
IB
IB
gf
gf
SU
gf
gf
Jn
"}
(2,1,1) = {"
Jn
Jn
Jn
IB
IB
ci
ci
gf
gf
fa
Nx
Nx
gf
zp
"}
(3,1,1) = {"
Jn
Jn
IB
IB
ci
ci
cT
gf
Bn
Hq
Nx
Nx
su
gf
"}
(4,1,1) = {"
Jn
IB
IB
ci
ci
mX
cT
tt
WK
Wi
Hq
xi
SI
SB
"}
(5,1,1) = {"
Jn
IB
ci
ci
cT
Rq
cT
tt
Do
Hq
Wi
Hq
UQ
SB
"}
(6,1,1) = {"
IB
IB
ci
WG
cT
rk
Dl
gf
aa
Wi
Hq
Wi
WZ
gf
"}
(7,1,1) = {"
IB
rQ
or
or
bp
cT
pI
gf
gf
Pk
Pk
Pk
gf
gf
"}
(8,1,1) = {"
IB
AI
zf
AI
ED
pI
oG
Ji
zW
nu
nu
nu
Yt
AL
"}
(9,1,1) = {"
IB
AI
AI
AI
cT
BL
bZ
fP
zW
nu
nu
nu
nu
AL
"}
(10,1,1) = {"
IB
or
ED
AI
aF
WG
BL
gf
gf
ix
Pk
Pk
gf
gf
"}
(11,1,1) = {"
IB
IB
ev
ED
or
Fe
cT
gf
GB
Wi
Hq
Wi
ql
gf
"}
(12,1,1) = {"
Jn
IB
ci
DQ
cT
Rq
cT
tt
jr
Hq
Wi
Hq
SE
SB
"}
(13,1,1) = {"
Jn
IB
IB
ci
ci
cT
Hj
tt
ji
Wi
Hq
xi
Od
SB
"}
(14,1,1) = {"
Jn
Jn
IB
IB
ci
ci
cT
gf
jr
Hq
Nx
Nx
dV
gf
"}
(15,1,1) = {"
Jn
Jn
Jn
IB
IB
ci
ci
gf
gf
Er
Nx
Uq
gf
gf
"}
(16,1,1) = {"
Jn
Jn
Jn
Jn
IB
IB
IB
IB
gf
gf
SU
gf
gf
Jn
"}
