//MAP CONVERTED BY dmm2tgm.py THIS HEADER COMMENT PREVENTS RECONVERSION, DO NOT REMOVE
"bR" = (
/obj/structure/flora/rock/pile,
/turf/open/floor/fakebasalt,
/area/misc/condo)
"ca" = (
/obj/structure/stone_tile,
/obj/structure/stone_tile{
	dir = 8
	},
/obj/structure/stone_tile{
	dir = 1
	},
/obj/structure/stone_tile/cracked{
	dir = 4
	},
/obj/item/flashlight/flare/torch,
/turf/open/indestructible/boss/air,
/area/misc/condo)
"fL" = (
/obj/structure/curtain/bounty/start_closed,
/turf/open/indestructible/boss/air,
/area/misc/condo)
"gk" = (
/turf/closed/indestructible/riveted/boss,
/area/misc/condo)
"hf" = (
/obj/structure/flora/rock/style_4,
/turf/open/floor/fakebasalt,
/area/misc/condo)
"hK" = (
/obj/structure/stone_tile/surrounding_tile,
/obj/structure/stone_tile/surrounding_tile/burnt{
	dir = 4
	},
/turf/open/floor/fakebasalt,
/area/misc/condo)
"hM" = (
/obj/structure/stone_tile/block/cracked{
	dir = 4
	},
/turf/open/floor/fakebasalt,
/area/misc/condo)
"iF" = (
/obj/structure/stone_tile/surrounding_tile/cracked,
/obj/structure/stone_tile/center,
/obj/structure/stone_tile/surrounding_tile{
	dir = 1
	},
/obj/structure/stone_tile/surrounding_tile{
	dir = 8
	},
/turf/open/lava/smooth,
/area/misc/condo)
"kY" = (
/obj/structure/flora/rock/pile/style_2,
/turf/open/floor/fakebasalt,
/area/misc/condo)
"lm" = (
/turf/closed/indestructible/wood,
/area/misc/condo)
"mq" = (
/obj/structure/stone_tile/block{
	dir = 4
	},
/obj/structure/stone_tile{
	dir = 8
	},
/obj/structure/stone_tile{
	dir = 4
	},
/turf/open/indestructible/boss/air,
/area/misc/condo)
"mY" = (
/obj/structure/stone_tile/block/cracked{
	dir = 1
	},
/obj/structure/stone_tile{
	dir = 8
	},
/obj/structure/stone_tile,
/turf/open/indestructible/boss/air,
/area/misc/condo)
"nw" = (
/turf/cordon,
/area/misc/condo)
"pV" = (
/obj/structure/chair/stool/directional/east,
/obj/effect/turf_decal/siding/wood{
	dir = 4
	},
/obj/structure/mirror/directional/west,
/turf/open/floor/wood,
/area/misc/condo)
"qW" = (
/obj/structure/stone_tile/surrounding_tile/cracked,
/obj/structure/stone_tile/surrounding_tile/cracked{
	dir = 4
	},
/obj/structure/stone_tile/center,
/obj/structure/stone_tile/surrounding_tile{
	dir = 8
	},
/turf/open/lava/smooth,
/area/misc/condo)
"rh" = (
/obj/structure/stone_tile/surrounding_tile/cracked{
	dir = 1
	},
/obj/structure/stone_tile/surrounding_tile/burnt{
	dir = 8
	},
/turf/open/floor/fakebasalt,
/area/misc/condo)
"rm" = (
/obj/structure/stone_tile/block{
	dir = 1
	},
/turf/open/lava/smooth,
/area/misc/condo)
"rS" = (
/obj/structure/stone_tile,
/obj/structure/stone_tile{
	dir = 8
	},
/obj/structure/stone_tile/cracked{
	dir = 4
	},
/obj/structure/stone_tile/cracked{
	dir = 1
	},
/obj/item/flashlight/flare/torch,
/turf/open/indestructible/boss/air,
/area/misc/condo)
"se" = (
/obj/structure/railing/wooden_fence{
	dir = 8
	},
/turf/open/floor/fakebasalt,
/area/misc/condo)
"so" = (
/turf/closed/indestructible/hoteldoor/fakedoor,
/area/misc/condo)
"sp" = (
/obj/structure/stone_tile/surrounding_tile/cracked{
	dir = 8
	},
/obj/structure/stone_tile/center,
/obj/structure/stone_tile/surrounding_tile{
	dir = 1
	},
/obj/structure/stone_tile/surrounding_tile{
	dir = 4
	},
/turf/open/lava/smooth,
/area/misc/condo)
"us" = (
/obj/structure/stone_tile,
/obj/structure/stone_tile{
	dir = 1
	},
/obj/structure/stone_tile/cracked{
	dir = 4
	},
/obj/structure/stone_tile/cracked{
	dir = 8
	},
/obj/item/flashlight/flare/torch,
/turf/open/indestructible/boss/air,
/area/misc/condo)
"ux" = (
/turf/closed/indestructible/rock,
/area/misc/condo)
"wg" = (
/obj/structure/railing/corner/end/wooden_fence,
/turf/open/floor/fakebasalt,
/area/misc/condo)
"ws" = (
/obj/structure/stone_tile/block{
	dir = 8
	},
/obj/structure/stone_tile/cracked{
	dir = 1
	},
/obj/structure/stone_tile,
/turf/open/indestructible/boss/air,
/area/misc/condo)
"wv" = (
/obj/structure/stone_tile/surrounding,
/obj/structure/fluff/standalone_wooden_post,
/obj/effect/light_emitter/tendril,
/turf/open/indestructible/boss/air,
/area/misc/condo)
"xk" = (
/obj/structure/stone_tile/block/burnt{
	dir = 8
	},
/turf/open/floor/fakebasalt,
/area/misc/condo)
"xn" = (
/obj/structure/stone_tile/block/cracked{
	dir = 4
	},
/turf/open/lava/smooth,
/area/misc/condo)
"xx" = (
/obj/structure/stone_tile,
/obj/structure/stone_tile{
	dir = 8
	},
/obj/structure/stone_tile{
	dir = 1
	},
/obj/structure/stone_tile{
	dir = 4
	},
/obj/item/flashlight/flare/torch,
/turf/open/indestructible/boss/air,
/area/misc/condo)
"yE" = (
/obj/structure/stone_tile/block,
/obj/structure/stone_tile{
	dir = 1
	},
/obj/structure/stone_tile{
	dir = 4
	},
/turf/open/indestructible/boss/air,
/area/misc/condo)
"zt" = (
/obj/structure/bonfire/prelit,
/obj/structure/stone_tile/slab/burnt,
/turf/open/indestructible/boss/air,
/area/misc/condo)
"Be" = (
/obj/structure/flora/rock/style_2,
/turf/open/floor/fakebasalt,
/area/misc/condo)
"BC" = (
/obj/structure/stone_tile/block{
	dir = 8
	},
/turf/open/floor/fakebasalt,
/area/misc/condo)
"BS" = (
/obj/structure/stone_tile/block,
/turf/open/floor/fakebasalt,
/area/misc/condo)
"Db" = (
/obj/structure/stone_tile/block{
	dir = 8
	},
/obj/structure/stone_tile,
/obj/structure/stone_tile{
	dir = 1
	},
/turf/open/indestructible/boss/air,
/area/misc/condo)
"Ee" = (
/obj/structure/railing/wooden_fence,
/turf/open/floor/fakebasalt,
/area/misc/condo)
"Ff" = (
/obj/structure/stone_tile/surrounding_tile/burnt{
	dir = 4
	},
/obj/structure/stone_tile/surrounding_tile/burnt,
/turf/open/floor/fakebasalt,
/area/misc/condo)
"Fz" = (
/obj/effect/planetary_turf_atmos_helper,
/turf/closed/indestructible/riveted/boss,
/area/misc/condo)
"Hg" = (
/obj/structure/chair/stool/directional/east,
/obj/effect/turf_decal/siding/wood{
	dir = 4
	},
/turf/open/floor/wood,
/area/misc/condo)
"HC" = (
/obj/structure/stone_tile/center/burnt,
/obj/structure/stone_tile/surrounding_tile,
/obj/structure/stone_tile/surrounding_tile/burnt{
	dir = 4
	},
/obj/structure/stone_tile/surrounding_tile{
	dir = 1
	},
/turf/open/indestructible/boss/air,
/area/misc/condo)
"IN" = (
/obj/structure/stone_tile/slab/cracked,
/turf/open/indestructible/boss/air,
/area/misc/condo)
"Jy" = (
/obj/structure/stone_tile/block/cracked{
	dir = 4
	},
/obj/structure/stone_tile/cracked{
	dir = 4
	},
/obj/structure/stone_tile{
	dir = 8
	},
/turf/open/indestructible/boss/air,
/area/misc/condo)
"JO" = (
/obj/structure/necropolis_gate,
/obj/structure/stone_tile/block{
	dir = 4
	},
/obj/structure/stone_tile/block/cracked{
	dir = 8
	},
/obj/structure/fans/tiny/invisible,
/turf/open/indestructible/boss/air,
/area/misc/condo)
"Ki" = (
/obj/structure/stone_tile/block/cracked,
/turf/open/lava/smooth,
/area/misc/condo)
"LS" = (
/obj/structure/stone_tile/block/cracked,
/turf/open/floor/fakebasalt,
/area/misc/condo)
"Mu" = (
/obj/structure/stone_tile/block{
	dir = 1
	},
/turf/open/floor/fakebasalt,
/area/misc/condo)
"Nm" = (
/obj/structure/stone_tile/center/burnt,
/obj/structure/stone_tile/surrounding_tile/cracked{
	dir = 4
	},
/obj/structure/stone_tile/surrounding_tile/cracked,
/obj/structure/stone_tile/surrounding_tile{
	dir = 8
	},
/obj/structure/closet/secure_closet/personal/cabinet,
/obj/machinery/light/directional/north,
/turf/open/indestructible/boss/air,
/area/misc/condo)
"ND" = (
/obj/structure/stone_tile/surrounding_tile/cracked{
	dir = 8
	},
/obj/structure/stone_tile/surrounding_tile/burnt{
	dir = 1
	},
/turf/open/floor/fakebasalt,
/area/misc/condo)
"NZ" = (
/obj/structure/stone_tile/surrounding_tile/cracked{
	dir = 4
	},
/obj/structure/stone_tile/center/cracked,
/obj/structure/stone_tile/surrounding_tile,
/obj/structure/stone_tile/surrounding_tile{
	dir = 1
	},
/turf/open/lava/smooth,
/area/misc/condo)
"Ol" = (
/obj/structure/flora/rock,
/turf/open/floor/fakebasalt,
/area/misc/condo)
"Oq" = (
/obj/structure/stone_tile/block,
/obj/structure/stone_tile/cracked{
	dir = 1
	},
/obj/structure/stone_tile{
	dir = 4
	},
/turf/open/indestructible/boss/air,
/area/misc/condo)
"RQ" = (
/obj/structure/stone_tile/block/cracked{
	dir = 8
	},
/obj/structure/stone_tile/cracked{
	dir = 1
	},
/obj/structure/stone_tile,
/turf/open/indestructible/boss/air,
/area/misc/condo)
"Su" = (
/obj/structure/stone_tile/block{
	dir = 1
	},
/obj/structure/stone_tile/cracked,
/obj/structure/stone_tile{
	dir = 8
	},
/turf/open/indestructible/boss/air,
/area/misc/condo)
"SY" = (
/obj/structure/stone_tile/center/cracked,
/obj/structure/stone_tile/surrounding_tile/burnt{
	dir = 1
	},
/obj/structure/stone_tile/surrounding_tile/burnt{
	dir = 8
	},
/obj/structure/stone_tile/surrounding_tile{
	dir = 4
	},
/obj/structure/rack/skeletal,
/turf/open/indestructible/boss/air,
/area/misc/condo)
"WF" = (
/obj/structure/stone_tile/block/burnt{
	dir = 4
	},
/turf/open/floor/fakebasalt,
/area/misc/condo)
"Xl" = (
/obj/structure/stone_tile/center,
/obj/structure/stone_tile/surrounding_tile{
	dir = 8
	},
/obj/structure/stone_tile/surrounding_tile/burnt{
	dir = 1
	},
/obj/structure/stone_tile/surrounding_tile,
/turf/open/indestructible/boss/air,
/area/misc/condo)
"Yh" = (
/obj/structure/stone_tile/block{
	dir = 8
	},
/turf/open/lava/smooth,
/area/misc/condo)
"YK" = (
/obj/structure/lavaland/ash_walker_fake,
/obj/structure/stone_tile/block/burnt,
/turf/open/lava/smooth,
/area/misc/condo)
"ZJ" = (
/turf/open/floor/fakebasalt,
/area/misc/condo)

(1,1,1) = {"
Fz
lm
gk
gk
ux
ux
ux
ux
ux
ux
nw
nw
nw
nw
"}
(2,1,1) = {"
gk
pV
Hg
gk
ux
ZJ
Ol
Ee
zt
ux
nw
nw
nw
nw
"}
(3,1,1) = {"
so
Xl
HC
fL
ZJ
ZJ
ZJ
wg
se
ux
ux
nw
nw
nw
"}
(4,1,1) = {"
lm
Nm
SY
gk
ZJ
bR
ZJ
ZJ
ZJ
ZJ
ux
ux
nw
nw
"}
(5,1,1) = {"
gk
gk
gk
gk
gk
gk
gk
ZJ
kY
ZJ
ZJ
ux
nw
nw
"}
(6,1,1) = {"
gk
rS
Jy
mq
mq
xx
gk
ZJ
ZJ
xk
ZJ
ux
ux
nw
"}
(7,1,1) = {"
gk
yE
iF
xn
NZ
Su
gk
ZJ
Ff
WF
ND
ZJ
ux
ux
"}
(8,1,1) = {"
gk
yE
Ki
YK
rm
IN
JO
ZJ
LS
wv
Mu
BS
ZJ
ux
"}
(9,1,1) = {"
gk
Oq
qW
Yh
sp
mY
gk
ZJ
rh
BC
hK
ZJ
hf
ux
"}
(10,1,1) = {"
gk
us
RQ
Db
ws
ca
gk
ux
ZJ
hM
ZJ
ZJ
ux
ux
"}
(11,1,1) = {"
gk
gk
gk
gk
gk
gk
gk
ux
ux
Be
ZJ
ux
ux
nw
"}
(12,1,1) = {"
nw
nw
nw
nw
nw
nw
nw
nw
ux
ux
ux
ux
nw
nw
"}
