//MAP CONVERTED BY dmm2tgm.py THIS HEADER COMMENT PREVENTS RECONVERSION, DO NOT REMOVE
"aq" = (
/turf/open/floor/fakespace,
/area/misc/condo)
"aC" = (
/turf/open/floor/iron/dark,
/area/misc/condo)
"aF" = (
/obj/structure/chair/sofa/corp/left{
	dir = 8
	},
/turf/open/floor/iron/dark,
/area/misc/condo)
"bS" = (
/obj/structure/table/reinforced,
/obj/machinery/jukebox,
/obj/structure/musician/piano/minimoog{
	pixel_x = 15
	},
/obj/structure/railing{
	dir = 8
	},
/turf/open/floor/light,
/area/misc/condo)
"cs" = (
/turf/open/floor/light/colour_cycle,
/area/misc/condo)
"cy" = (
/turf/open/floor/carpet/purple,
/area/misc/condo)
"cz" = (
/obj/structure/railing{
	dir = 10
	},
/turf/open/floor/light/colour_cycle/dancefloor_b,
/area/misc/condo)
"dV" = (
/obj/machinery/light/dim/directional/west{
	alpha = 0
	},
/turf/open/floor/fakespace,
/area/misc/condo)
"ep" = (
/obj/structure/table/reinforced,
/obj/item/instrument/piano_synth,
/obj/item/instrument/eguitar,
/obj/item/instrument/saxophone,
/turf/open/floor/iron/dark,
/area/misc/condo)
"eG" = (
/turf/closed/indestructible/steel,
/area/misc/condo)
"eR" = (
/obj/structure/chair/sofa/corp/right,
/turf/open/floor/iron/dark,
/area/misc/condo)
"fa" = (
/obj/structure/chair/sofa/corp/corner{
	dir = 1
	},
/turf/open/floor/iron/dark,
/area/misc/condo)
"fJ" = (
/obj/structure/disposalpipe/segment{
	dir = 4
	},
/turf/open/floor/iron/dark,
/area/misc/condo)
"fZ" = (
/obj/structure/chair/sofa/corp/right{
	dir = 8
	},
/obj/item/clothing/sextoy/condom,
/turf/open/floor/iron/dark,
/area/misc/condo)
"gL" = (
/obj/structure/chair/stool/bar/directional/north,
/turf/open/floor/carpet/purple,
/area/misc/condo)
"hH" = (
/obj/structure/railing,
/turf/open/floor/light/colour_cycle/dancefloor_b,
/area/misc/condo)
"id" = (
/turf/open/floor/iron/stairs{
	dir = 1
	},
/area/misc/condo)
"jc" = (
/obj/structure/table/reinforced/plasmarglass,
/obj/machinery/reagentgrinder,
/turf/open/floor/light,
/area/misc/condo)
"jr" = (
/obj/structure/sink/directional/west,
/obj/machinery/light/small/dim/directional/south,
/obj/machinery/dryer{
	dir = 8;
	pixel_x = 6;
	pixel_y = 17
	},
/obj/structure/disposalpipe/segment{
	dir = 10
	},
/turf/open/floor/iron/freezer,
/area/misc/condo)
"jT" = (
/obj/structure/table/reinforced,
/turf/open/floor/iron,
/area/misc/condo)
"mp" = (
/obj/structure/chair/stool/bar/directional/west,
/obj/structure/disposalpipe/junction{
	dir = 2
	},
/turf/open/floor/carpet/purple,
/area/misc/condo)
"oH" = (
/obj/structure/railing{
	dir = 8
	},
/turf/open/floor/light/colour_cycle,
/area/misc/condo)
"oN" = (
/obj/structure/table/reinforced,
/obj/structure/railing{
	dir = 10
	},
/turf/open/floor/light,
/area/misc/condo)
"pd" = (
/obj/structure/railing,
/turf/open/floor/light/colour_cycle,
/area/misc/condo)
"qE" = (
/obj/structure/disposalpipe/segment,
/turf/closed/indestructible/steel,
/area/misc/condo)
"rb" = (
/obj/structure/railing{
	dir = 4
	},
/turf/open/floor/light/colour_cycle,
/area/misc/condo)
"tH" = (
/turf/open/floor/iron/stairs{
	dir = 8
	},
/area/misc/condo)
"uK" = (
/obj/machinery/barsign/all_access,
/turf/closed/indestructible/steel,
/area/misc/condo)
"uM" = (
/obj/structure/chair/sofa/corp/corner{
	dir = 8
	},
/turf/open/floor/iron/dark,
/area/misc/condo)
"vk" = (
/obj/structure/chair/comfy/brown{
	color = "#596479";
	dir = 2
	},
/turf/open/floor/iron/dark,
/area/misc/condo)
"vz" = (
/obj/structure/table/reinforced/plasmarglass,
/obj/structure/disposalpipe/segment{
	dir = 4
	},
/turf/open/floor/light,
/area/misc/condo)
"vM" = (
/obj/machinery/disposal/bin,
/obj/structure/disposalpipe/trunk{
	dir = 2
	},
/turf/open/floor/iron/dark,
/area/misc/condo)
"wv" = (
/obj/machinery/chem_dispenser/drinks/fullupgrade{
	pixel_y = 32
	},
/obj/structure/table/reinforced/plasmarglass,
/obj/item/soap/deluxe,
/turf/open/floor/light,
/area/misc/condo)
"yF" = (
/obj/structure/chair/sofa/corp/right{
	dir = 4
	},
/turf/open/floor/iron/dark,
/area/misc/condo)
"Ah" = (
/obj/structure/disposalpipe/segment{
	dir = 5
	},
/turf/open/floor/iron/dark,
/area/misc/condo)
"AM" = (
/obj/machinery/light/directional/west,
/obj/machinery/disposal/bin,
/obj/structure/disposalpipe/trunk{
	dir = 2
	},
/obj/item/wrench,
/turf/open/floor/carpet/purple,
/area/misc/condo)
"Cc" = (
/obj/structure/railing{
	dir = 5
	},
/turf/open/floor/light/colour_cycle/dancefloor_b,
/area/misc/condo)
"CZ" = (
/obj/machinery/door/airlock/bathroom{
	name = "Restroom"
	},
/obj/structure/disposalpipe/segment{
	dir = 4
	},
/turf/open/floor/iron/dark,
/area/misc/condo)
"DR" = (
/obj/structure/table/wood/fancy/purple,
/obj/item/bdsm_candle{
	pixel_y = 6
	},
/turf/open/floor/light,
/area/misc/condo)
"Ed" = (
/obj/structure/railing{
	dir = 4
	},
/turf/open/floor/light/colour_cycle/dancefloor_b,
/area/misc/condo)
"Ep" = (
/obj/structure/table/reinforced/plasmarglass,
/obj/item/stack/spacecash/c5000{
	pixel_y = 15;
	pixel_x = 4
	},
/turf/open/floor/light,
/area/misc/condo)
"ED" = (
/obj/structure/chair/stool/bar/directional/west,
/obj/structure/disposalpipe/segment,
/turf/open/floor/carpet/purple,
/area/misc/condo)
"Fk" = (
/turf/open/floor/iron/stairs,
/area/misc/condo)
"Fp" = (
/obj/item/food/syndicake,
/obj/item/food/syndicake,
/obj/item/food/syndicake,
/obj/item/food/syndicake,
/obj/item/food/syndicake,
/obj/item/food/syndicake,
/obj/item/food/syndicake,
/obj/item/toy/crayon/spraycan/infinite,
/obj/structure/closet/crate/freezer,
/turf/open/floor/iron/dark,
/area/misc/condo)
"FD" = (
/obj/structure/table/reinforced/plasmarglass,
/turf/open/floor/light,
/area/misc/condo)
"Gb" = (
/obj/structure/railing{
	dir = 8
	},
/turf/open/floor/light/colour_cycle/dancefloor_b,
/area/misc/condo)
"Gv" = (
/obj/structure/table/reinforced/plasmarglass,
/obj/item/stack/spacecash/c200{
	pixel_y = -11;
	pixel_x = 7
	},
/turf/open/floor/light,
/area/misc/condo)
"HQ" = (
/obj/machinery/vending/boozeomat{
	pixel_y = 32
	},
/obj/structure/table/reinforced/plasmarglass,
/obj/item/reagent_containers/cup/glass/shaker{
	pixel_x = 4
	},
/turf/open/floor/light,
/area/misc/condo)
"HZ" = (
/turf/closed/wall/space{
	space_lit = 1
	},
/area/misc/condo)
"IS" = (
/obj/structure/railing{
	dir = 1
	},
/turf/open/floor/iron/stairs{
	dir = 8;
	initial_gas_mix = "TEMP=2.7"
	},
/area/misc/condo)
"Jc" = (
/obj/structure/railing{
	dir = 6
	},
/turf/open/floor/light/colour_cycle/dancefloor_b,
/area/misc/condo)
"JR" = (
/obj/structure/toilet{
	pixel_y = 13
	},
/turf/open/floor/iron/freezer,
/area/misc/condo)
"Ke" = (
/obj/structure/table/reinforced/plasmarglass,
/obj/item/storage/box/drinkingglasses,
/turf/open/floor/light,
/area/misc/condo)
"KF" = (
/obj/structure/railing{
	dir = 1
	},
/turf/open/floor/light/colour_cycle,
/area/misc/condo)
"KH" = (
/obj/structure/chair/sofa/corp/left{
	dir = 4
	},
/turf/open/floor/iron/dark,
/area/misc/condo)
"KO" = (
/obj/structure/railing{
	dir = 1
	},
/turf/open/floor/iron/stairs{
	dir = 4
	},
/area/misc/condo)
"La" = (
/obj/structure/railing{
	dir = 9
	},
/turf/open/floor/light/colour_cycle/dancefloor_b,
/area/misc/condo)
"Mj" = (
/obj/structure/table/reinforced/plasmarglass,
/obj/item/stack/spacecash/c1000{
	pixel_x = -10
	},
/turf/open/floor/light,
/area/misc/condo)
"Mw" = (
/obj/structure/chair/sofa/corp/left{
	dir = 1
	},
/turf/open/floor/iron/dark,
/area/misc/condo)
"Mx" = (
/turf/open/floor/light/colour_cycle/dancefloor_b,
/area/misc/condo)
"MA" = (
/obj/structure/chair/sofa/corp/left,
/turf/open/floor/iron/dark,
/area/misc/condo)
"NQ" = (
/turf/open/floor/light/colour_cycle/dancefloor_a,
/area/misc/condo)
"NW" = (
/obj/structure/disposalpipe/trunk{
	dir = 1
	},
/turf/closed/indestructible/steel,
/area/misc/condo)
"PZ" = (
/obj/structure/chair/comfy/brown{
	color = "#596479";
	dir = 8
	},
/turf/open/floor/iron/dark,
/area/misc/condo)
"Qd" = (
/turf/open/floor/iron,
/area/misc/condo)
"Qu" = (
/obj/structure/table/reinforced/plasmarglass,
/obj/structure/stripper_pole,
/turf/open/floor/light,
/area/misc/condo)
"QT" = (
/obj/machinery/door/airlock/grunge,
/turf/open/floor/iron/dark,
/area/misc/condo)
"Rt" = (
/obj/structure/table/reinforced,
/obj/structure/railing{
	dir = 9
	},
/turf/open/floor/light,
/area/misc/condo)
"Ry" = (
/obj/structure/table/reinforced,
/obj/item/toy/crayon/spraycan/infinite,
/turf/open/floor/iron,
/area/misc/condo)
"Se" = (
/obj/machinery/jukebox/disco{
	anchored = 1
	},
/turf/open/floor/light/colour_cycle/dancefloor_a,
/area/misc/condo)
"Si" = (
/obj/item/toy/plush/lizard_plushie/space,
/obj/machinery/light/dim/directional/north{
	alpha = 0
	},
/turf/open/floor/fakespace,
/area/misc/condo)
"Sp" = (
/obj/structure/table/reinforced/plasmarglass,
/obj/item/stack/spacecash/c500{
	pixel_y = 2;
	pixel_x = -6
	},
/turf/open/floor/light,
/area/misc/condo)
"SS" = (
/turf/closed/indestructible/hoteldoor/fakedoor,
/area/misc/condo)
"Tr" = (
/obj/machinery/vending/dorms,
/turf/open/floor/light,
/area/misc/condo)
"UT" = (
/obj/structure/chair/sofa/corp/right{
	dir = 1
	},
/turf/open/floor/iron/dark,
/area/misc/condo)
"VB" = (
/obj/structure/chair/sofa/corp/corner,
/turf/open/floor/iron/dark,
/area/misc/condo)
"VK" = (
/obj/structure/chair/comfy/brown{
	color = "#596479";
	dir = 1
	},
/turf/open/floor/iron/dark,
/area/misc/condo)
"Xz" = (
/obj/structure/railing{
	dir = 1
	},
/turf/open/floor/iron,
/area/misc/condo)
"YN" = (
/obj/structure/chair/sofa/corp/corner{
	dir = 4
	},
/turf/open/floor/iron/dark,
/area/misc/condo)
"Zf" = (
/obj/structure/table/reinforced/plasmarglass,
/obj/item/stack/spacecash/c500,
/turf/open/floor/light,
/area/misc/condo)
"Zz" = (
/obj/structure/disposalpipe/segment,
/turf/open/floor/carpet/purple,
/area/misc/condo)
"ZW" = (
/obj/machinery/chem_dispenser/drinks/beer/fullupgrade{
	pixel_y = 32
	},
/obj/structure/table/reinforced/plasmarglass,
/obj/item/rag,
/turf/open/floor/light,
/area/misc/condo)

(1,1,1) = {"
eG
eG
eG
eG
eG
eG
SS
eG
eG
eG
eG
eG
eG
eG
eG
"}
(2,1,1) = {"
eG
FD
wv
aC
aC
eG
cy
cy
vk
DR
VK
vk
DR
VK
eG
"}
(3,1,1) = {"
eG
FD
ZW
aC
aC
QT
cy
cy
aC
PZ
aC
aC
PZ
aC
eG
"}
(4,1,1) = {"
eG
FD
HQ
aC
aC
FD
gL
cy
aC
aC
aC
aC
aC
aC
eG
"}
(5,1,1) = {"
eG
jc
Ke
aC
aC
FD
gL
cy
aC
La
oH
Gb
oH
cz
eG
"}
(6,1,1) = {"
eG
Fp
aC
aC
aC
FD
gL
cy
IS
KF
NQ
cs
NQ
pd
eG
"}
(7,1,1) = {"
eG
vM
Ah
aC
aC
FD
gL
cy
Xz
Mx
cs
Se
cs
hH
eG
"}
(8,1,1) = {"
eG
eG
vz
FD
FD
uK
cy
cy
KO
KF
NQ
cs
NQ
pd
eG
"}
(9,1,1) = {"
eG
AM
mp
ED
ED
qE
Zz
Zz
Ah
Cc
rb
Ed
rb
Jc
eG
"}
(10,1,1) = {"
eG
cy
cy
cy
cy
cy
cy
cy
fJ
aC
aC
aC
aC
aC
eG
"}
(11,1,1) = {"
eG
YN
yF
tH
KH
fa
aC
aC
fJ
aC
Rt
bS
oN
aC
eG
"}
(12,1,1) = {"
eG
MA
Gv
Zf
FD
UT
aC
aC
fJ
id
Qd
Qd
Qd
Fk
eG
"}
(13,1,1) = {"
eG
aC
FD
Qu
Mj
aC
aC
Tr
fJ
eG
ep
jT
Ry
eG
eG
"}
(14,1,1) = {"
eG
eR
Sp
FD
Ep
Mw
eG
eG
CZ
eG
eG
eG
eG
eG
HZ
"}
(15,1,1) = {"
eG
VB
aF
aC
fZ
uM
eG
JR
jr
NW
Si
aq
aq
dV
HZ
"}
(16,1,1) = {"
eG
eG
eG
eG
eG
eG
eG
eG
eG
eG
HZ
HZ
HZ
HZ
HZ
"}
