//MAP CONVERTED BY dmm2tgm.py THIS HEADER COMMENT PREVENTS RECONVERSION, DO NOT REMOVE
"ak" = (
/obj/effect/turf_decal/weather/sand{
	dir = 10
	},
/turf/open/floor/grass,
/area/misc/condo)
"aC" = (
/turf/closed/indestructible/sandstone,
/area/misc/condo)
"aS" = (
/obj/structure/flora/tree/palm{
	pixel_y = 11;
	density = 0
	},
/obj/effect/turf_decal/weather/sand{
	dir = 10
	},
/obj/structure/flora/coconuts{
	pixel_y = 7
	},
/turf/open/floor/grass,
/area/misc/condo)
"aU" = (
/obj/structure/flora/rock/pile/jungle/style_random,
/turf/open/floor/grass,
/area/misc/condo)
"cy" = (
/obj/structure/flora/bush/jungle/b/style_random,
/obj/effect/light_emitter/interlink{
	light_color = "#2e2e2e"
	},
/turf/open/misc/beach/sand,
/area/misc/condo)
"cA" = (
/turf/open/floor/carpet/orange,
/area/misc/condo)
"db" = (
/obj/structure/flora/bush/sparsegrass/style_random,
/turf/open/misc/beach/sand,
/area/misc/condo)
"dJ" = (
/obj/effect/turf_decal/weather/sand{
	dir = 9
	},
/obj/structure/flora/rock/pile/jungle/style_random,
/turf/open/floor/grass,
/area/misc/condo)
"dR" = (
/obj/effect/turf_decal/weather/sand{
	dir = 6
	},
/turf/open/water{
	icon_state = "pool_1"
	},
/area/misc/condo)
"ge" = (
/obj/item/kirbyplants/random,
/obj/machinery/light_switch/directional/west,
/turf/open/floor/iron/terracotta,
/area/misc/condo)
"ha" = (
/obj/effect/turf_decal/weather/sand{
	dir = 8
	},
/obj/effect/turf_decal/weather/sand{
	dir = 4
	},
/turf/open/floor/grass,
/area/misc/condo)
"hN" = (
/obj/effect/turf_decal/weather/sand{
	dir = 5
	},
/turf/open/water{
	icon_state = "pool_1"
	},
/area/misc/condo)
"iZ" = (
/obj/structure/flora/tree/palm{
	pixel_y = -9;
	density = 0
	},
/obj/effect/turf_decal/weather/sand{
	dir = 5
	},
/turf/open/floor/grass,
/area/misc/condo)
"jq" = (
/obj/structure/flora/bush/jungle/a/style_random,
/turf/open/misc/beach/sand,
/area/misc/condo)
"jT" = (
/turf/open/misc/beach/sand,
/area/misc/condo)
"kI" = (
/obj/effect/turf_decal/weather/sand{
	dir = 1;
	pixel_y = 1
	},
/obj/structure/flora/rock/pile/jungle/style_random,
/turf/open/floor/grass,
/area/misc/condo)
"kX" = (
/obj/structure/fluff/beach_umbrella/engine{
	pixel_x = 11;
	pixel_y = 9
	},
/obj/effect/light_emitter/interlink{
	light_color = "#2e2e2e"
	},
/turf/open/misc/beach/sand,
/area/misc/condo)
"lJ" = (
/turf/closed/indestructible/hoteldoor/fakedoor,
/area/misc/condo)
"lO" = (
/obj/structure/flora/tree/palm{
	density = 0
	},
/obj/effect/turf_decal/weather/sand{
	dir = 5
	},
/obj/structure/flora/coconuts{
	pixel_y = -6
	},
/turf/open/floor/grass,
/area/misc/condo)
"ml" = (
/obj/structure/dresser{
	pixel_y = 4
	},
/turf/open/floor/iron/terracotta,
/area/misc/condo)
"mJ" = (
/obj/effect/turf_decal/weather/sand{
	dir = 6
	},
/obj/structure/flora/bush/jungle/a/style_random,
/turf/open/floor/grass,
/area/misc/condo)
"nd" = (
/obj/structure/flora/bush/large/style_random,
/turf/open/misc/beach/sand,
/area/misc/condo)
"nn" = (
/obj/effect/light_emitter/interlink{
	light_color = "#2e2e2e"
	},
/turf/open/misc/beach/sand,
/area/misc/condo)
"nS" = (
/obj/effect/turf_decal/weather/sand,
/turf/open/floor/grass,
/area/misc/condo)
"ph" = (
/obj/structure/flora/bush/jungle/a/style_random,
/obj/effect/light_emitter/interlink{
	light_color = "#2e2e2e"
	},
/turf/open/floor/grass,
/area/misc/condo)
"px" = (
/obj/effect/turf_decal/weather/sand{
	dir = 9
	},
/obj/structure/flora/bush/jungle/b/style_random,
/turf/open/floor/grass,
/area/misc/condo)
"qL" = (
/obj/effect/turf_decal/weather/sand{
	dir = 8
	},
/obj/structure/flora/bush/fullgrass/style_random,
/turf/open/floor/grass,
/area/misc/condo)
"se" = (
/turf/open/water{
	icon_state = "pool_1"
	},
/area/misc/condo)
"si" = (
/obj/effect/light_emitter/interlink{
	light_color = "#2e2e2e"
	},
/turf/open/water{
	icon_state = "pool_1"
	},
/area/misc/condo)
"vJ" = (
/obj/machinery/door/airlock/sandstone,
/turf/open/floor/iron/terracotta,
/area/misc/condo)
"wI" = (
/obj/structure/flora/tree/palm/style_2{
	density = 0
	},
/obj/structure/flora/coconuts{
	pixel_y = -5;
	pixel_x = 3
	},
/turf/open/misc/beach/sand,
/area/misc/condo)
"xp" = (
/obj/structure/flora/tree/palm/style_2{
	pixel_y = 14;
	density = 0
	},
/obj/effect/turf_decal/weather/sand{
	dir = 10
	},
/turf/open/floor/grass,
/area/misc/condo)
"zh" = (
/obj/machinery/light_switch/directional/north,
/turf/open/floor/iron/terracotta,
/area/misc/condo)
"AX" = (
/obj/structure/flora/tree/palm{
	density = 0
	},
/obj/structure/flora/coconuts{
	pixel_y = -5;
	pixel_x = 3
	},
/turf/open/misc/beach/sand,
/area/misc/condo)
"BC" = (
/obj/structure/flora/tree/palm{
	density = 0
	},
/turf/open/misc/beach/sand,
/area/misc/condo)
"Cc" = (
/obj/effect/turf_decal/weather/sand{
	dir = 9
	},
/turf/open/water{
	icon_state = "pool_1"
	},
/area/misc/condo)
"Dj" = (
/obj/effect/turf_decal/weather/sand{
	dir = 6
	},
/obj/structure/flora/bush/jungle/c/style_random,
/turf/open/floor/grass,
/area/misc/condo)
"EQ" = (
/obj/effect/turf_decal/weather/sand{
	dir = 6
	},
/obj/effect/turf_decal/weather/sand{
	dir = 8
	},
/turf/open/floor/grass,
/area/misc/condo)
"Fa" = (
/obj/effect/turf_decal/weather/sand{
	dir = 10
	},
/turf/open/water{
	icon_state = "pool_1"
	},
/area/misc/condo)
"FN" = (
/turf/closed/indestructible/rock,
/area/misc/condo)
"Gc" = (
/obj/structure/flora/bush/fullgrass/style_random,
/obj/effect/light_emitter/interlink{
	light_color = "#2e2e2e"
	},
/turf/open/misc/beach/sand,
/area/misc/condo)
"GW" = (
/obj/structure/flora/coconuts{
	pixel_y = 15
	},
/turf/open/floor/grass,
/area/misc/condo)
"HI" = (
/obj/structure/bed/double{
	dir = 4
	},
/obj/effect/spawner/random/bedsheet/double{
	dir = 4
	},
/turf/open/floor/iron/terracotta,
/area/misc/condo)
"IH" = (
/obj/structure/closet/mini_fridge,
/obj/structure/table/wood,
/obj/item/pizzabox/pineapple,
/obj/item/storage/cans/sixbeer,
/obj/machinery/light/warm/directional/east,
/turf/open/floor/iron/terracotta,
/area/misc/condo)
"IQ" = (
/obj/effect/turf_decal/weather/sand{
	dir = 10
	},
/obj/structure/flora/bush/fullgrass/style_random,
/turf/open/floor/grass,
/area/misc/condo)
"JA" = (
/turf/open/floor/iron/terracotta,
/area/misc/condo)
"KG" = (
/obj/structure/flora/tree/palm/style_2{
	density = 0
	},
/turf/open/floor/grass,
/area/misc/condo)
"KL" = (
/obj/structure/flora/bush/fullgrass/style_random,
/turf/open/misc/beach/sand,
/area/misc/condo)
"Li" = (
/obj/structure/table/wood,
/obj/item/flashlight/flare/candle/infinite,
/turf/open/floor/iron/terracotta,
/area/misc/condo)
"OK" = (
/obj/structure/flora/tree/palm/style_2{
	density = 0
	},
/turf/open/misc/beach/sand,
/area/misc/condo)
"PW" = (
/obj/machinery/light/small/dim/directional/east,
/turf/open/misc/beach/sand,
/area/misc/condo)
"Qg" = (
/obj/effect/turf_decal/weather/sand{
	dir = 8
	},
/turf/open/water{
	icon_state = "pool_1"
	},
/area/misc/condo)
"Rq" = (
/obj/effect/turf_decal/weather/sand{
	dir = 5
	},
/obj/structure/flora/bush/jungle/c/style_random,
/turf/open/floor/grass,
/area/misc/condo)
"Ry" = (
/obj/structure/curtain/cloth/fancy,
/turf/closed/indestructible/fakeglass,
/area/misc/condo)
"SS" = (
/turf/closed/indestructible/hoteldoor{
	icon_state = "door_closed";
	icon = 'icons/obj/doors/puzzledoor/default.dmi'
	},
/area/misc/condo)
"TD" = (
/obj/structure/chair/wood{
	dir = 4
	},
/turf/open/floor/iron/terracotta,
/area/misc/condo)
"Uc" = (
/obj/structure/flora/tree/palm/style_2{
	pixel_y = 0;
	density = 0
	},
/obj/effect/turf_decal/weather/sand{
	dir = 1;
	pixel_y = 1
	},
/obj/structure/flora/coconuts{
	pixel_y = -7;
	pixel_x = 4
	},
/turf/open/floor/grass,
/area/misc/condo)
"Ug" = (
/obj/machinery/light/warm/directional/east,
/turf/open/floor/iron/terracotta,
/area/misc/condo)
"Ui" = (
/obj/structure/chair/wood{
	dir = 8
	},
/turf/open/floor/iron/terracotta,
/area/misc/condo)
"Vw" = (
/obj/effect/turf_decal/weather/sand{
	dir = 6
	},
/obj/structure/flora/bush/jungle/a/style_random,
/obj/effect/light_emitter/interlink{
	light_color = "#2e2e2e"
	},
/turf/open/floor/grass,
/area/misc/condo)
"Wz" = (
/obj/structure/table/wood,
/obj/item/storage/cans/sixbeer,
/obj/item/toy/plush/lizard_plushie,
/turf/open/floor/iron/terracotta,
/area/misc/condo)
"WD" = (
/turf/open/floor/carpet/purple,
/area/misc/condo)
"Xj" = (
/obj/structure/flora/bush/fullgrass/style_random,
/obj/effect/light_emitter/interlink{
	light_color = "#2e2e2e"
	},
/turf/open/floor/grass,
/area/misc/condo)
"YO" = (
/obj/structure/flora/bush/sparsegrass/style_random,
/obj/effect/light_emitter/interlink{
	light_color = "#2e2e2e"
	},
/turf/open/misc/beach/sand,
/area/misc/condo)
"Ze" = (
/obj/effect/turf_decal/weather/sand{
	dir = 9
	},
/obj/structure/flora/bush/jungle/b/style_random,
/obj/effect/light_emitter/interlink{
	light_color = "#2e2e2e"
	},
/turf/open/floor/grass,
/area/misc/condo)
"ZA" = (
/obj/effect/turf_decal/weather/sand{
	dir = 6
	},
/turf/open/floor/grass,
/area/misc/condo)
"ZU" = (
/obj/structure/flora/tree/palm{
	pixel_x = 8;
	pixel_y = 4;
	density = 0
	},
/obj/effect/turf_decal/weather/sand{
	dir = 9
	},
/obj/structure/flora/coconuts{
	pixel_y = -3;
	pixel_x = 5
	},
/turf/open/floor/grass,
/area/misc/condo)

(1,1,1) = {"
FN
FN
FN
FN
FN
FN
FN
lJ
FN
FN
FN
FN
FN
FN
FN
"}
(2,1,1) = {"
FN
FN
jT
wI
jT
jT
jT
KL
jT
jT
jT
jT
OK
FN
FN
"}
(3,1,1) = {"
FN
db
jT
nn
KL
jT
cy
jT
jT
Ze
xp
KL
nn
nd
FN
"}
(4,1,1) = {"
FN
jT
nd
jT
ZU
ha
Cc
Qg
se
Fa
Rq
aS
jT
jT
FN
"}
(5,1,1) = {"
FN
AX
KL
dJ
Dj
Cc
se
se
se
se
Fa
kI
IQ
jT
FN
"}
(6,1,1) = {"
FN
jT
px
Xj
Cc
se
si
se
se
si
se
Uc
Vw
jT
FN
"}
(7,1,1) = {"
FN
jT
KG
nS
se
se
se
se
se
se
dR
mJ
jT
jT
FN
"}
(8,1,1) = {"
FN
jT
iZ
GW
hN
se
se
se
se
dR
db
jT
nd
jT
FN
"}
(9,1,1) = {"
FN
jT
KL
ph
ak
hN
si
se
dR
Gc
jT
jT
nn
db
FN
"}
(10,1,1) = {"
FN
jT
jT
lO
aU
qL
EQ
jT
jT
jq
jT
jT
jT
AX
FN
"}
(11,1,1) = {"
FN
wI
jT
KL
Rq
ZA
KL
jT
jT
jT
PW
aC
Ry
aC
aC
"}
(12,1,1) = {"
FN
jT
jT
kX
jT
nd
nn
aC
aC
vJ
aC
aC
Wz
ml
aC
"}
(13,1,1) = {"
FN
jT
jT
cA
db
jT
jT
aC
TD
WD
ge
aC
zh
HI
aC
"}
(14,1,1) = {"
FN
jT
BC
cA
jT
jT
jT
Ry
Li
JA
JA
vJ
JA
Ug
aC
"}
(15,1,1) = {"
FN
FN
jT
nn
jT
AX
YO
aC
Ui
JA
IH
aC
aC
aC
aC
"}
(16,1,1) = {"
FN
FN
FN
FN
FN
FN
FN
aC
aC
SS
aC
aC
FN
FN
FN
"}
