//MAP CONVERTED BY dmm2tgm.py THIS HEADER COMMENT PREVENTS RECONVERSION, DO NOT REMOVE
"a" = (
/turf/cordon,
/area/misc/condo)
"b" = (
/obj/structure/dresser,
/turf/open/floor/iron/dark/diagonal,
/area/misc/condo)
"c" = (
/turf/closed/indestructible/reinforced,
/area/misc/condo)
"e" = (
/obj/machinery/light/floor,
/turf/open/floor/iron/dark/textured_edge,
/area/misc/condo)
"f" = (
/obj/structure/flora/ocean/glowweed,
/turf/open/misc/ocean,
/area/misc/condo)
"g" = (
/obj/structure/flora/ocean/longseaweed,
/turf/open/misc/ironsand/ocean,
/area/misc/condo)
"h" = (
/turf/closed/indestructible/fakeglass,
/area/misc/condo)
"i" = (
/obj/structure/flora/scrap,
/turf/open/misc/ironsand/ocean,
/area/misc/condo)
"j" = (
/obj/structure/flora/rock/pile/style_3,
/turf/open/misc/ocean,
/area/misc/condo)
"l" = (
/obj/effect/light_emitter/fake_outdoors,
/obj/structure/flora/rock/pile/style_2,
/turf/open/misc/ocean,
/area/misc/condo)
"n" = (
/obj/structure/flora/ocean/longseaweed,
/turf/open/misc/ocean,
/area/misc/condo)
"o" = (
/obj/machinery/light/directional/east,
/obj/structure/closet/secure_closet/personal/cabinet,
/turf/open/floor/iron/dark/diagonal,
/area/misc/condo)
"p" = (
/obj/effect/turf_decal/siding/wideplating_new/dark{
	dir = 8
	},
/turf/open/floor/iron/dark/herringbone,
/area/misc/condo)
"q" = (
/obj/structure/flora/ocean/seaweed,
/turf/open/misc/ironsand/ocean,
/area/misc/condo)
"r" = (
/obj/machinery/light/directional/west,
/obj/structure/closet/mini_fridge,
/obj/item/reagent_containers/cup/glass/waterbottle/large,
/turf/open/floor/iron/dark/diagonal,
/area/misc/condo)
"s" = (
/obj/structure/flora/ocean/seaweed,
/turf/open/misc/ocean,
/area/misc/condo)
"t" = (
/obj/effect/light_emitter/fake_outdoors,
/obj/structure/flora/rock,
/turf/open/misc/ocean,
/area/misc/condo)
"u" = (
/obj/structure/table/wood,
/obj/item/flashlight/lamp/green{
	pixel_y = 16;
	pixel_x = -7
	},
/obj/item/folder/blue{
	pixel_y = 4
	},
/obj/item/pen{
	pixel_y = 4
	},
/turf/open/floor/iron/dark/diagonal,
/area/misc/condo)
"v" = (
/turf/closed/indestructible/hoteldoor/fakedoor,
/area/misc/condo)
"w" = (
/turf/open/misc/ocean/rock/warm/fissure,
/area/misc/condo)
"x" = (
/obj/structure/lattice,
/turf/open/misc/ocean,
/area/misc/condo)
"y" = (
/obj/effect/turf_decal/siding/wideplating_new/dark{
	dir = 4
	},
/turf/open/floor/iron/dark/herringbone,
/area/misc/condo)
"z" = (
/obj/structure/flora/ocean/coral,
/turf/open/misc/ocean,
/area/misc/condo)
"B" = (
/obj/structure/table/wood,
/obj/effect/turf_decal/tile/dark_blue/diagonal_centre,
/turf/open/floor/iron/dark/diagonal,
/area/misc/condo)
"C" = (
/obj/effect/turf_decal/siding/wideplating_new/dark{
	dir = 5
	},
/turf/open/floor/iron/dark/herringbone,
/area/misc/condo)
"D" = (
/obj/effect/light_emitter/fake_outdoors,
/turf/open/misc/ocean,
/area/misc/condo)
"E" = (
/obj/effect/light_emitter/fake_outdoors,
/turf/open/misc/ironsand/ocean,
/area/misc/condo)
"F" = (
/obj/effect/turf_decal/siding/wideplating_new/dark{
	dir = 1
	},
/turf/open/floor/iron/dark/textured_edge,
/area/misc/condo)
"G" = (
/obj/structure/flora/rock/style_4,
/turf/open/misc/ironsand/ocean,
/area/misc/condo)
"H" = (
/obj/structure/flora/rock/pile,
/turf/open/misc/ocean,
/area/misc/condo)
"I" = (
/obj/effect/turf_decal/sand,
/obj/machinery/power/solar/fake,
/turf/open/floor/iron/solarpanel/ocean,
/area/misc/condo)
"J" = (
/turf/open/misc/ironsand/ocean,
/area/misc/condo)
"K" = (
/turf/closed/wall,
/area/misc/condo)
"L" = (
/turf/open/misc/ocean,
/area/misc/condo)
"M" = (
/obj/effect/turf_decal/siding/wideplating_new/dark{
	dir = 9
	},
/turf/open/floor/iron/dark/herringbone,
/area/misc/condo)
"N" = (
/obj/structure/flora/ocean/coral,
/turf/open/misc/ironsand/ocean,
/area/misc/condo)
"O" = (
/obj/effect/planetary_turf_atmos_helper,
/turf/closed/indestructible/reinforced,
/area/misc/condo)
"S" = (
/turf/open/floor/iron/dark/textured_edge,
/area/misc/condo)
"T" = (
/obj/effect/turf_decal/sand/plating,
/turf/open/floor/plating/ocean_plating,
/area/misc/condo)
"U" = (
/turf/open/floor/iron/dark/diagonal,
/area/misc/condo)
"V" = (
/obj/structure/chair/office{
	dir = 8
	},
/turf/open/floor/iron/dark/diagonal,
/area/misc/condo)
"W" = (
/obj/structure/flora/ocean/glowweed,
/turf/open/misc/ironsand/ocean,
/area/misc/condo)
"X" = (
/turf/closed/indestructible/rock,
/area/misc/condo)
"Y" = (
/obj/effect/turf_decal/tile/dark_blue/diagonal_centre,
/turf/open/floor/iron/dark/diagonal,
/area/misc/condo)
"Z" = (
/obj/structure/bed/double,
/obj/effect/spawner/random/bedsheet/double,
/turf/open/floor/iron/dark/diagonal,
/area/misc/condo)

(1,1,1) = {"
a
a
a
a
a
X
X
X
X
a
X
X
X
X
X
X
"}
(2,1,1) = {"
a
a
a
a
X
X
L
L
X
X
X
n
L
L
X
X
"}
(3,1,1) = {"
a
a
a
a
X
L
t
z
L
L
L
L
l
f
L
X
"}
(4,1,1) = {"
a
a
a
X
X
L
n
L
L
s
j
L
L
w
w
X
"}
(5,1,1) = {"
a
a
a
X
s
f
L
h
h
h
c
c
w
w
X
X
"}
(6,1,1) = {"
a
a
X
X
H
L
h
h
u
B
r
c
h
h
c
c
"}
(7,1,1) = {"
a
X
X
L
n
L
h
U
B
V
Y
C
y
y
y
c
"}
(8,1,1) = {"
a
K
x
x
I
I
h
Y
U
Y
U
F
S
S
e
v
"}
(9,1,1) = {"
X
X
L
D
T
T
h
b
Y
U
Y
M
p
p
p
c
"}
(10,1,1) = {"
X
L
n
L
I
I
h
h
Z
B
o
c
h
h
c
O
"}
(11,1,1) = {"
X
X
X
s
x
L
L
h
h
h
c
c
L
J
X
X
"}
(12,1,1) = {"
a
a
X
X
K
z
D
L
L
g
J
J
N
L
X
X
"}
(13,1,1) = {"
a
a
a
a
X
X
J
s
W
J
q
J
E
J
G
X
"}
(14,1,1) = {"
a
a
a
a
a
X
X
i
J
X
X
X
J
g
X
X
"}
(15,1,1) = {"
a
a
a
a
a
a
X
X
X
X
a
X
X
X
X
X
"}
