//MAP CONVERTED BY dmm2tgm.py THIS HEADER COMMENT PREVENTS RECONVERSION, DO NOT REMOVE
"a" = (
/turf/closed/indestructible/normal_wall,
/area/misc/condo)
"e" = (
/obj/structure/fluff/fake_scrubber,
/turf/open/floor/iron,
/area/misc/condo)
"f" = (
/obj/effect/planetary_turf_atmos_helper,
/turf/closed/indestructible/normal_wall,
/area/misc/condo)
"n" = (
/obj/structure/chair/comfy{
	dir = 8
	},
/turf/open/floor/wood,
/area/misc/condo)
"r" = (
/obj/structure/fluff/fake_vent,
/turf/open/floor/wood,
/area/misc/condo)
"w" = (
/obj/machinery/light/small/directional/east,
/turf/open/floor/wood,
/area/misc/condo)
"C" = (
/turf/cordon,
/area/misc/condo)
"F" = (
/obj/effect/turf_decal/siding/wood,
/obj/structure/dresser,
/obj/item/kirbyplants/organic/plant2{
	pixel_y = 22;
	pixel_x = 4
	},
/obj/machinery/light_switch/directional/east,
/turf/open/floor/iron,
/area/misc/condo)
"H" = (
/obj/structure/table/wood,
/turf/open/floor/wood,
/area/misc/condo)
"I" = (
/turf/closed/indestructible/hoteldoor/fakedoor,
/area/misc/condo)
"J" = (
/obj/effect/turf_decal/siding/wood,
/turf/open/floor/iron,
/area/misc/condo)
"K" = (
/obj/structure/table/wood,
/obj/item/flashlight/lamp/green,
/turf/open/floor/wood,
/area/misc/condo)
"P" = (
/obj/structure/bed/double{
	dir = 4
	},
/obj/effect/spawner/random/bedsheet/double{
	dir = 1
	},
/turf/open/floor/wood,
/area/misc/condo)
"R" = (
/obj/effect/turf_decal/siding/wood,
/obj/effect/spawner/random/structure/closet_private,
/turf/open/floor/iron,
/area/misc/condo)

(1,1,1) = {"
C
a
a
a
a
f
"}
(2,1,1) = {"
a
a
R
P
K
a
"}
(3,1,1) = {"
I
e
J
r
H
a
"}
(4,1,1) = {"
a
a
F
w
n
a
"}
(5,1,1) = {"
C
a
a
a
a
a
"}
