//MAP CONVERTED BY dmm2tgm.py THIS HEADER COMMENT PREVENTS RECONVERSION, DO NOT REMOVE
"a" = (
/turf/open/water/jungle,
/area/misc/condo)
"b" = (
/turf/open/misc/dirt/dark/station,
/area/misc/condo)
"f" = (
/obj/structure/flora/bush/fullgrass,
/turf/open/misc/grass/jungle/station,
/area/misc/condo)
"g" = (
/turf/open/misc/dirt/station,
/area/misc/condo)
"i" = (
/obj/structure/flora/bush/jungle/c,
/turf/open/misc/grass/jungle/station,
/area/misc/condo)
"k" = (
/obj/effect/light_emitter/fake_outdoors,
/turf/open/water/jungle,
/area/misc/condo)
"m" = (
/obj/structure/flora/tree/jungle/small/style_5,
/turf/open/misc/grass/jungle/station,
/area/misc/condo)
"n" = (
/turf/open/misc/grass/jungle/station,
/area/misc/condo)
"o" = (
/obj/structure/flora/bush/reed,
/turf/open/misc/dirt/station,
/area/misc/condo)
"p" = (
/obj/structure/flora/bush/large,
/turf/open/misc/dirt/station,
/area/misc/condo)
"r" = (
/obj/structure/flora/bush/grassy,
/turf/open/misc/grass/jungle/station,
/area/misc/condo)
"s" = (
/obj/structure/flora/tree/jungle/style_3,
/obj/effect/light_emitter/fake_outdoors,
/turf/open/misc/grass/jungle/station,
/area/misc/condo)
"t" = (
/turf/open/misc/beach/sand,
/area/misc/condo)
"u" = (
/obj/structure/flora/bush/flowers_br,
/turf/open/misc/grass/jungle/station,
/area/misc/condo)
"v" = (
/obj/structure/flora/tree/jungle/small/style_2,
/turf/open/misc/grass/jungle/station,
/area/misc/condo)
"z" = (
/obj/structure/flora/bush/generic,
/turf/open/misc/dirt/station,
/area/misc/condo)
"B" = (
/obj/structure/flora/tree/jungle/small/style_4,
/turf/open/misc/grass/jungle/station,
/area/misc/condo)
"C" = (
/turf/closed/indestructible/hoteldoor/fakedoor,
/area/misc/condo)
"F" = (
/obj/structure/flora/tree/jungle/small/style_2,
/obj/effect/light_emitter/fake_outdoors,
/turf/open/misc/dirt/station,
/area/misc/condo)
"I" = (
/obj/structure/flora/bush/flowers_yw,
/turf/open/misc/grass/jungle/station,
/area/misc/condo)
"L" = (
/obj/structure/flora/bush/jungle,
/turf/open/misc/grass/jungle/station,
/area/misc/condo)
"M" = (
/obj/structure/flora/bush/flowers_pp,
/turf/open/misc/grass/jungle/station,
/area/misc/condo)
"N" = (
/obj/effect/planetary_turf_atmos_helper,
/turf/closed/indestructible/iron,
/area/misc/condo)
"O" = (
/turf/closed/indestructible/iron,
/area/misc/condo)
"Q" = (
/obj/effect/light_emitter/fake_outdoors,
/turf/open/misc/beach/sand,
/area/misc/condo)
"S" = (
/obj/structure/flora/tree/jungle/style_5,
/turf/open/misc/grass/jungle/station,
/area/misc/condo)
"U" = (
/obj/structure/flora/tree/jungle/style_2,
/turf/open/misc/grass/jungle/station,
/area/misc/condo)
"X" = (
/turf/cordon,
/area/misc/condo)
"Y" = (
/turf/closed/indestructible/rock,
/area/misc/condo)
"Z" = (
/obj/structure/flora/bush/style_2,
/turf/open/misc/grass/jungle/station,
/area/misc/condo)

(1,1,1) = {"
X
X
Y
Y
Y
Y
Y
O
O
O
O
O
O
O
O
"}
(2,1,1) = {"
X
Y
Y
a
a
a
a
a
a
a
o
p
i
Z
O
"}
(3,1,1) = {"
Y
Y
a
a
a
a
a
a
a
g
b
M
n
v
O
"}
(4,1,1) = {"
Y
a
a
a
a
k
a
a
a
g
g
s
n
n
O
"}
(5,1,1) = {"
Y
a
a
a
a
a
a
a
a
t
t
g
m
n
O
"}
(6,1,1) = {"
Y
a
a
a
a
a
a
a
t
t
t
z
u
n
O
"}
(7,1,1) = {"
Y
a
a
a
a
a
a
a
t
t
t
n
n
g
N
"}
(8,1,1) = {"
Y
a
a
a
a
a
a
a
Q
t
g
n
n
g
C
"}
(9,1,1) = {"
Y
Y
a
a
a
a
a
t
t
t
g
S
n
n
O
"}
(10,1,1) = {"
X
Y
a
a
a
a
a
t
t
t
t
n
U
I
O
"}
(11,1,1) = {"
X
Y
a
a
a
a
a
t
t
t
t
g
f
n
O
"}
(12,1,1) = {"
X
Y
Y
a
a
k
a
a
t
t
t
F
n
r
O
"}
(13,1,1) = {"
X
X
Y
a
a
a
a
a
o
t
t
n
B
n
O
"}
(14,1,1) = {"
X
X
Y
Y
a
a
a
a
a
g
b
n
n
L
O
"}
(15,1,1) = {"
X
X
X
Y
Y
Y
Y
O
O
O
O
O
O
O
O
"}
