//MAP CONVERTED BY dmm2tgm.py THIS HEADER COMMENT PREVENTS RECONVERSION, DO NOT REMOVE
"aT" = (
/obj/machinery/light/small/directional/east,
/obj/effect/turf_decal/siding/wood,
/obj/effect/turf_decal/siding/wood{
	dir = 1
	},
/turf/open/floor/wood,
/area/misc/condo)
"bn" = (
/obj/structure/chair/wood{
	dir = 4
	},
/turf/open/floor/wood/tile,
/area/misc/condo)
"bG" = (
/obj/structure/bookcase/random/religion,
/turf/open/floor/wood/large,
/area/misc/condo)
"ek" = (
/obj/structure/bookcase/random/adult,
/obj/structure/curtain/cloth/fancy,
/turf/open/floor/wood/large,
/area/misc/condo)
"fB" = (
/turf/closed/wall/mineral/stone,
/area/misc/condo)
"fN" = (
/obj/structure/flora/rock/pile/jungle/style_2,
/obj/effect/turf_decal/weather/dirt{
	dir = 1
	},
/obj/effect/light_emitter/interlink,
/turf/open/floor/grass,
/area/misc/condo)
"gb" = (
/obj/effect/turf_decal/siding/wood,
/obj/effect/turf_decal/siding/wood{
	dir = 5
	},
/turf/open/floor/wood,
/area/misc/condo)
"hu" = (
/obj/structure/closet/crate/bin,
/obj/effect/turf_decal/siding/wood,
/turf/open/floor/wood,
/area/misc/condo)
"iI" = (
/obj/machinery/light/small/directional/west,
/obj/effect/turf_decal/siding/wood,
/obj/effect/turf_decal/siding/wood{
	dir = 1
	},
/turf/open/floor/wood,
/area/misc/condo)
"iN" = (
/obj/effect/turf_decal/siding/wood{
	dir = 6
	},
/turf/open/floor/wood,
/area/misc/condo)
"jz" = (
/obj/structure/table/wood,
/obj/item/clothing/glasses/regular{
	pixel_x = 0;
	pixel_y = -4
	},
/turf/open/floor/carpet/green,
/area/misc/condo)
"kU" = (
/obj/structure/bookcase/random/reference,
/turf/open/floor/wood/large,
/area/misc/condo)
"lS" = (
/obj/structure/bookcase/random/fiction,
/turf/open/floor/wood/large,
/area/misc/condo)
"nk" = (
/obj/structure/table/wood,
/turf/open/floor/carpet/green,
/area/misc/condo)
"qh" = (
/obj/structure/window/green_glass_pane,
/obj/structure/curtain/cloth/fancy,
/turf/open/floor/wood/tile,
/area/misc/condo)
"ry" = (
/obj/effect/turf_decal/weather/dirt,
/obj/structure/flora/rock/pile/jungle/style_5,
/obj/effect/light_emitter/interlink,
/turf/open/floor/grass,
/area/misc/condo)
"rA" = (
/turf/open/floor/wood/tile,
/area/misc/condo)
"sM" = (
/obj/machinery/computer/libraryconsole/bookmanagement,
/obj/structure/table/wood,
/obj/effect/turf_decal/siding/wood,
/turf/open/floor/wood,
/area/misc/condo)
"tN" = (
/obj/effect/turf_decal/siding/wood{
	dir = 10
	},
/turf/open/floor/wood,
/area/misc/condo)
"uR" = (
/obj/structure/table/wood,
/obj/effect/turf_decal/siding/wood{
	dir = 1
	},
/turf/open/floor/wood,
/area/misc/condo)
"vd" = (
/obj/effect/turf_decal/siding/wood,
/obj/effect/turf_decal/siding/wood{
	dir = 1
	},
/turf/open/floor/wood,
/area/misc/condo)
"vo" = (
/obj/machinery/light_switch/directional/south,
/turf/open/floor/carpet/red,
/area/misc/condo)
"wd" = (
/obj/structure/chair/comfy/black{
	dir = 8
	},
/obj/effect/turf_decal/siding/wood{
	dir = 5
	},
/turf/open/floor/wood,
/area/misc/condo)
"xt" = (
/obj/structure/sign/painting/large/library{
	pixel_x = 0;
	pixel_y = -36
	},
/turf/open/floor/carpet/red,
/area/misc/condo)
"zc" = (
/obj/machinery/light/warm/dim/directional/south,
/turf/open/floor/carpet/red,
/area/misc/condo)
"ze" = (
/obj/structure/displaycase/trophy,
/turf/open/floor/wood/tile,
/area/misc/condo)
"zq" = (
/obj/machinery/door/airlock/wood,
/turf/closed/wall/mineral/stone,
/area/misc/condo)
"Aj" = (
/obj/structure/table/wood,
/obj/item/pen/fountain{
	pixel_x = -5;
	pixel_y = 8
	},
/turf/open/floor/carpet/green,
/area/misc/condo)
"AI" = (
/obj/effect/turf_decal/weather/dirt,
/obj/structure/flora/rock/pile/jungle/style_3,
/obj/effect/light_emitter/interlink,
/turf/open/floor/grass,
/area/misc/condo)
"BX" = (
/obj/structure/sign/painting/library,
/turf/closed/indestructible/wood,
/area/misc/condo)
"Cv" = (
/obj/structure/chair/comfy/beige{
	dir = 4
	},
/obj/effect/turf_decal/siding/wood{
	dir = 9
	},
/turf/open/floor/wood,
/area/misc/condo)
"CC" = (
/obj/structure/chair/wood,
/turf/open/floor/wood/tile,
/area/misc/condo)
"CT" = (
/obj/structure/chair/office/light{
	dir = 1
	},
/turf/open/floor/wood/tile,
/area/misc/condo)
"Dt" = (
/obj/structure/table/wood,
/obj/item/folder{
	pixel_x = 4;
	pixel_y = 4
	},
/turf/open/floor/carpet/green,
/area/misc/condo)
"Ei" = (
/obj/effect/turf_decal/siding/wood{
	dir = 5
	},
/obj/effect/turf_decal/siding/wood,
/turf/open/floor/wood,
/area/misc/condo)
"En" = (
/obj/structure/table/wood,
/obj/effect/turf_decal/siding/wood{
	dir = 1
	},
/obj/item/paper_bin{
	pixel_x = -2;
	pixel_y = 6
	},
/turf/open/floor/wood,
/area/misc/condo)
"EF" = (
/turf/closed/indestructible/wood,
/area/misc/condo)
"FX" = (
/obj/effect/turf_decal/weather/dirt{
	dir = 1
	},
/obj/effect/light_emitter/interlink,
/turf/open/floor/grass,
/area/misc/condo)
"Gd" = (
/turf/closed/indestructible/hoteldoor/fakedoor,
/area/misc/condo)
"Gl" = (
/obj/structure/easel,
/turf/open/floor/wood/tile,
/area/misc/condo)
"Hg" = (
/obj/structure/chair/wood{
	dir = 8
	},
/turf/open/floor/wood/tile,
/area/misc/condo)
"Ic" = (
/obj/structure/table/wood,
/obj/item/flashlight/lamp/green{
	pixel_x = -8;
	pixel_y = 10
	},
/turf/open/floor/carpet/green,
/area/misc/condo)
"Iq" = (
/obj/structure/bookcase/random/nonfiction,
/turf/open/floor/wood/large,
/area/misc/condo)
"JL" = (
/obj/structure/table/wood,
/obj/item/flashlight/lamp/green{
	pixel_x = 12;
	pixel_y = 2
	},
/turf/open/floor/carpet/green,
/area/misc/condo)
"Mw" = (
/obj/structure/window/green_glass_pane,
/obj/structure/curtain/cloth/fancy,
/turf/closed/wall/mineral/stone,
/area/misc/condo)
"QG" = (
/obj/effect/turf_decal/siding/wood{
	dir = 9
	},
/obj/effect/turf_decal/siding/wood,
/turf/open/floor/wood,
/area/misc/condo)
"QM" = (
/obj/structure/table/wood,
/obj/item/paper_bin{
	pixel_x = -6;
	pixel_y = 5
	},
/turf/open/floor/carpet/green,
/area/misc/condo)
"RY" = (
/obj/effect/turf_decal/weather/dirt,
/obj/structure/chair/sofa/bench/right,
/obj/effect/light_emitter/interlink,
/turf/open/floor/grass,
/area/misc/condo)
"TR" = (
/obj/effect/turf_decal/weather/dirt,
/obj/structure/chair/sofa/bench/left,
/obj/effect/light_emitter/interlink,
/turf/open/floor/grass,
/area/misc/condo)
"Ul" = (
/obj/effect/turf_decal/weather/dirt{
	dir = 1
	},
/obj/effect/light_emitter/interlink,
/obj/structure/hedge,
/turf/open/floor/grass,
/area/misc/condo)
"UY" = (
/obj/effect/turf_decal/weather/dirt,
/obj/effect/light_emitter/interlink,
/turf/open/floor/grass,
/area/misc/condo)
"VL" = (
/obj/effect/turf_decal/weather/dirt,
/obj/effect/light_emitter/interlink,
/obj/structure/hedge,
/turf/open/floor/grass,
/area/misc/condo)
"Wu" = (
/turf/open/floor/carpet/red,
/area/misc/condo)
"XB" = (
/obj/machinery/light_switch/directional/north,
/turf/open/floor/carpet/red,
/area/misc/condo)
"Yp" = (
/obj/machinery/light/warm/dim/directional/north,
/turf/open/floor/carpet/red,
/area/misc/condo)
"Zz" = (
/obj/effect/light_emitter/interlink,
/turf/open/misc/dirt/station,
/area/misc/condo)

(1,1,1) = {"
fB
fB
zq
fB
EF
EF
BX
EF
BX
EF
BX
EF
BX
EF
EF
"}
(2,1,1) = {"
fB
AI
Zz
FX
qh
hu
Gl
ek
iI
Iq
iI
lS
rA
En
EF
"}
(3,1,1) = {"
fB
UY
Zz
FX
qh
iN
rA
kU
vd
Iq
vd
lS
rA
wd
BX
"}
(4,1,1) = {"
fB
VL
Zz
Ul
EF
Yp
rA
kU
Ei
Iq
gb
lS
rA
zc
EF
"}
(5,1,1) = {"
Mw
VL
Zz
FX
qh
Wu
rA
ze
rA
ze
rA
ze
rA
xt
EF
"}
(6,1,1) = {"
Mw
UY
Zz
FX
qh
Wu
Wu
Wu
Wu
Wu
Wu
Wu
Wu
Wu
EF
"}
(7,1,1) = {"
fB
RY
Zz
Ul
EF
XB
rA
bn
bn
bn
bn
bn
rA
Wu
EF
"}
(8,1,1) = {"
fB
TR
Zz
FX
qh
Wu
CC
jz
nk
Aj
JL
nk
rA
Wu
Gd
"}
(9,1,1) = {"
fB
UY
Zz
FX
qh
Wu
CC
nk
Ic
QM
nk
Dt
rA
vo
EF
"}
(10,1,1) = {"
fB
VL
Zz
Ul
EF
Wu
rA
Hg
Hg
Hg
Hg
Hg
rA
Wu
EF
"}
(11,1,1) = {"
Mw
VL
Zz
fN
qh
Wu
Wu
Wu
Wu
Wu
Wu
Wu
Wu
xt
EF
"}
(12,1,1) = {"
Mw
UY
Zz
FX
qh
Wu
rA
ze
rA
ze
rA
ze
rA
Wu
EF
"}
(13,1,1) = {"
fB
UY
Zz
Ul
EF
Yp
rA
kU
QG
bG
QG
Iq
rA
zc
EF
"}
(14,1,1) = {"
fB
UY
Zz
FX
qh
tN
rA
kU
vd
bG
vd
Iq
rA
Cv
BX
"}
(15,1,1) = {"
fB
ry
Zz
FX
qh
sM
CT
kU
aT
bG
aT
Iq
rA
uR
EF
"}
(16,1,1) = {"
fB
fB
zq
fB
EF
EF
BX
EF
BX
EF
BX
EF
BX
EF
EF
"}
