//MAP CONVERTED BY dmm2tgm.py THIS HEADER COMMENT PREVENTS RECONVERSION, DO NOT REMOVE
"aY" = (
/obj/effect/turf_decal/siding/thinplating_new/light{
	dir = 6
	},
/obj/structure/window/spawner/directional/south,
/obj/structure/window/spawner/directional/east,
/obj/structure/table,
/obj/item/reagent_containers/cup/glass/coffee{
	pixel_x = 5;
	pixel_y = 14
	},
/obj/item/reagent_containers/cup/glass/coffee{
	pixel_x = -7;
	pixel_y = 2
	},
/turf/open/indestructible/hotelwood,
/area/misc/condo)
"bv" = (
/obj/effect/turf_decal/trimline/blue/filled/line,
/obj/structure/table,
/obj/effect/spawner/random/entertainment/plushie,
/turf/open/indestructible/white,
/area/misc/condo)
"dh" = (
/obj/effect/turf_decal/trimline/blue/filled/line,
/obj/item/kirbyplants/random/fullysynthetic,
/turf/open/indestructible/white,
/area/misc/condo)
"ds" = (
/obj/effect/turf_decal/trimline/blue/filled/corner{
	dir = 4
	},
/turf/open/indestructible/white,
/area/misc/condo)
"dA" = (
/obj/machinery/computer{
	icon_screen = "crew"
	},
/obj/effect/turf_decal/tile/blue/opposingcorners,
/turf/open/indestructible/white/textured,
/area/misc/condo)
"eu" = (
/obj/structure/bed/pod{
	dir = 4
	},
/obj/item/bedsheet/medical{
	dir = 4
	},
/obj/effect/turf_decal/tile/blue/opposingcorners,
/turf/open/indestructible/white,
/area/misc/condo)
"eR" = (
/obj/structure/bookcase/random,
/obj/structure/sign/clock/directional/west,
/turf/open/indestructible/hotelwood,
/area/misc/condo)
"gE" = (
/obj/structure/table,
/obj/machinery/computer/security/telescreen/entertainment/directional/north,
/obj/item/toy/cards/deck{
	pixel_x = -7;
	pixel_y = 11
	},
/obj/machinery/light/cold/directional/north,
/turf/open/indestructible/hotelwood,
/area/misc/condo)
"gY" = (
/obj/effect/turf_decal/trimline/blue/filled/warning{
	dir = 1
	},
/turf/open/indestructible/white/smooth_large,
/area/misc/condo)
"hJ" = (
/obj/machinery/computer{
	icon_screen = "medcomp"
	},
/obj/effect/turf_decal/tile/blue/opposingcorners,
/turf/open/indestructible/white/textured,
/area/misc/condo)
"jt" = (
/turf/open/indestructible/white/smooth_large,
/area/misc/condo)
"kJ" = (
/obj/effect/turf_decal/tile/blue/opposingcorners,
/obj/machinery/light/cold/directional/south,
/turf/open/indestructible/white,
/area/misc/condo)
"kN" = (
/obj/structure/table,
/obj/effect/turf_decal/tile/blue/opposingcorners,
/obj/item/reagent_containers/cup/glass/waterbottle/large{
	pixel_x = -7;
	pixel_y = 7
	},
/obj/machinery/computer/security/telescreen/entertainment/directional/south,
/turf/open/indestructible/white,
/area/misc/condo)
"ld" = (
/obj/effect/turf_decal/trimline/blue/filled/line,
/obj/structure/chair{
	dir = 1
	},
/turf/open/indestructible/white,
/area/misc/condo)
"lS" = (
/obj/structure/table,
/obj/machinery/microwave{
	pixel_y = 6
	},
/turf/open/indestructible/hotelwood,
/area/misc/condo)
"mn" = (
/obj/structure/table,
/obj/effect/turf_decal/tile/blue/opposingcorners,
/obj/item/clipboard{
	pixel_y = 4;
	pixel_x = -5
	},
/obj/item/paper{
	pixel_x = -5;
	pixel_y = 3
	},
/obj/item/pen/blue{
	pixel_x = -5;
	pixel_y = 3
	},
/obj/item/clothing/glasses/hud/health{
	pixel_x = 10;
	pixel_y = 10
	},
/turf/open/indestructible/white/textured,
/area/misc/condo)
"mL" = (
/obj/effect/turf_decal/siding/thinplating_new/light{
	dir = 4
	},
/obj/item/banner/medical/mundane,
/obj/structure/window/spawner/directional/east,
/obj/structure/sign/poster/official/random/directional/north,
/turf/open/indestructible/hotelwood,
/area/misc/condo)
"mV" = (
/obj/effect/turf_decal/trimline/blue/filled/line{
	dir = 1
	},
/obj/item/kirbyplants/random/fullysynthetic,
/turf/open/indestructible/white,
/area/misc/condo)
"nZ" = (
/obj/effect/turf_decal/trimline/blue/filled/warning{
	dir = 8
	},
/obj/machinery/light/cold/directional/west,
/turf/open/indestructible/white,
/area/misc/condo)
"ph" = (
/obj/effect/turf_decal/trimline/blue/filled/line,
/obj/item/kirbyplants/random/fullysynthetic,
/obj/structure/sign/poster/official/random/directional/south,
/turf/open/indestructible/white,
/area/misc/condo)
"pZ" = (
/turf/closed/indestructible/fakeglass,
/area/misc/condo)
"qR" = (
/obj/machinery/vending/imported,
/turf/open/indestructible/hotelwood,
/area/misc/condo)
"rY" = (
/obj/effect/turf_decal/tile/blue/opposingcorners,
/turf/open/indestructible/white,
/area/misc/condo)
"sn" = (
/turf/open/space/basic,
/area/misc/condo)
"so" = (
/obj/effect/turf_decal/trimline/blue/filled/warning{
	dir = 8
	},
/turf/open/indestructible/white,
/area/misc/condo)
"ue" = (
/obj/effect/turf_decal/trimline/blue/filled/corner{
	dir = 8
	},
/turf/open/indestructible/white,
/area/misc/condo)
"uM" = (
/obj/effect/turf_decal/trimline/blue/filled/line,
/obj/machinery/light/cold/directional/south,
/obj/structure/reagent_dispensers/water_cooler,
/turf/open/indestructible/white,
/area/misc/condo)
"uW" = (
/obj/structure/flora/bush/flowers_br/style_random,
/obj/structure/flora/bush/flowers_yw/style_random,
/obj/structure/flora/bush/flowers_pp/style_random,
/obj/structure/window/reinforced/fulltile{
	icon_state = "reinforced_window-3"
	},
/turf/open/floor/grass,
/area/misc/condo)
"uZ" = (
/obj/structure/noticeboard/directional/north,
/turf/open/indestructible/hotelwood,
/area/misc/condo)
"vt" = (
/obj/machinery/vending/medical,
/obj/effect/turf_decal/tile/blue/opposingcorners,
/obj/structure/sign/poster/official/random/directional/south,
/turf/open/indestructible/white/textured,
/area/misc/condo)
"vJ" = (
/obj/effect/turf_decal/trimline/blue/filled/line{
	dir = 1
	},
/obj/structure/chair,
/turf/open/indestructible/white,
/area/misc/condo)
"wh" = (
/obj/effect/turf_decal/tile/blue/opposingcorners,
/obj/structure/chair{
	dir = 1
	},
/turf/open/indestructible/white,
/area/misc/condo)
"xz" = (
/obj/effect/turf_decal/trimline/blue/filled/line{
	dir = 6
	},
/obj/item/kirbyplants/random/fullysynthetic,
/turf/open/indestructible/white,
/area/misc/condo)
"zf" = (
/obj/effect/turf_decal/trimline/blue/filled/warning{
	dir = 9
	},
/obj/item/kirbyplants/random/fullysynthetic,
/turf/open/indestructible/white,
/area/misc/condo)
"zE" = (
/obj/effect/turf_decal/trimline/blue/filled/line{
	dir = 4
	},
/turf/open/indestructible/white,
/area/misc/condo)
"AV" = (
/obj/machinery/door/airlock/medical{
	name = "Nurse Room"
	},
/obj/effect/turf_decal/tile/blue/opposingcorners,
/turf/open/indestructible/white/textured,
/area/misc/condo)
"BJ" = (
/obj/item/kirbyplants/random/fullysynthetic,
/obj/effect/turf_decal/tile/blue/opposingcorners,
/turf/open/indestructible/white/textured,
/area/misc/condo)
"CF" = (
/obj/machinery/light/cold/directional/west,
/obj/machinery/vending/coffee,
/obj/structure/sign/poster/official/random/directional/west,
/turf/open/indestructible/hotelwood,
/area/misc/condo)
"DY" = (
/obj/effect/turf_decal/siding/thinplating_new/light{
	dir = 4
	},
/turf/open/indestructible/hotelwood,
/area/misc/condo)
"Es" = (
/obj/structure/table,
/obj/effect/turf_decal/tile/blue/opposingcorners,
/obj/item/reagent_containers/spray/cleaner{
	pixel_x = 9;
	pixel_y = 4
	},
/obj/item/folder/white{
	pixel_x = -4;
	pixel_y = 2
	},
/obj/item/clothing/gloves/latex/nitrile{
	pixel_x = -13
	},
/obj/machinery/digital_clock/directional/south,
/turf/open/indestructible/white/textured,
/area/misc/condo)
"ES" = (
/obj/item/kirbyplants/random/fullysynthetic,
/obj/effect/turf_decal/trimline/blue/filled/line{
	dir = 10
	},
/turf/open/indestructible/white,
/area/misc/condo)
"Fh" = (
/obj/item/clothing/suit/toggle/labcoat/hospitalgown,
/obj/structure/closet,
/obj/item/clothing/glasses/regular/hipster,
/obj/item/clothing/shoes/sneakers/white,
/obj/effect/turf_decal/tile/blue/opposingcorners,
/turf/open/indestructible/white,
/area/misc/condo)
"Ge" = (
/obj/effect/turf_decal/tile/blue/opposingcorners,
/obj/structure/chair{
	dir = 4
	},
/turf/open/indestructible/white,
/area/misc/condo)
"GK" = (
/turf/closed/indestructible/steel,
/area/misc/condo)
"Ht" = (
/obj/machinery/door/window/left/directional/west{
	name = "Nurse Control Windoor"
	},
/obj/effect/turf_decal/tile/blue/opposingcorners,
/obj/structure/table/reinforced,
/turf/open/indestructible/white/textured,
/area/misc/condo)
"HD" = (
/obj/effect/turf_decal/trimline/blue/filled/warning{
	dir = 9
	},
/obj/item/banner/medical/mundane,
/turf/open/indestructible/white,
/area/misc/condo)
"KO" = (
/obj/structure/flora/bush/flowers_br/style_random,
/obj/structure/flora/bush/flowers_yw/style_random,
/obj/structure/flora/bush/flowers_pp/style_random,
/obj/structure/window/reinforced/fulltile{
	icon_state = "reinforced_window-12"
	},
/turf/open/floor/grass,
/area/misc/condo)
"KT" = (
/obj/effect/turf_decal/trimline/blue/filled/line{
	dir = 6
	},
/obj/item/banner/medical/mundane,
/turf/open/indestructible/white,
/area/misc/condo)
"Lq" = (
/obj/structure/sign/departments/medbay/alt,
/turf/closed/indestructible/steel,
/area/misc/condo)
"LY" = (
/obj/effect/turf_decal/siding/thinplating_new/light{
	dir = 4
	},
/obj/structure/chair,
/obj/structure/window/spawner/directional/east,
/turf/open/indestructible/hotelwood,
/area/misc/condo)
"Mo" = (
/obj/structure/chair/office/light{
	dir = 1
	},
/obj/effect/turf_decal/tile/blue/opposingcorners,
/turf/open/indestructible/white/textured,
/area/misc/condo)
"MH" = (
/obj/effect/turf_decal/trimline/blue/filled/line{
	dir = 8
	},
/obj/machinery/light/cold/directional/west,
/turf/open/indestructible/white,
/area/misc/condo)
"OM" = (
/obj/effect/turf_decal/tile/blue/opposingcorners,
/obj/machinery/door/airlock/medical{
	name = "Recovery Room"
	},
/turf/open/indestructible/white,
/area/misc/condo)
"PG" = (
/turf/open/indestructible/carpet,
/area/misc/condo)
"PM" = (
/obj/effect/turf_decal/trimline/blue/filled/corner,
/turf/open/indestructible/white,
/area/misc/condo)
"PQ" = (
/obj/effect/turf_decal/trimline/blue/filled/warning,
/turf/open/indestructible/white/smooth_large,
/area/misc/condo)
"PU" = (
/obj/effect/turf_decal/trimline/blue/filled/line{
	dir = 4
	},
/obj/item/banner/medical/mundane,
/obj/machinery/light/cold/directional/east,
/turf/open/indestructible/white,
/area/misc/condo)
"Qk" = (
/obj/structure/closet,
/obj/item/clothing/suit/toggle/labcoat/hospitalgown,
/obj/item/clothing/glasses/regular/hipster,
/obj/item/clothing/shoes/sneakers/white,
/obj/effect/turf_decal/tile/blue/opposingcorners,
/turf/open/indestructible/white,
/area/misc/condo)
"Qv" = (
/turf/closed/indestructible/hoteldoor/fakedoor{
	dir = 4
	},
/area/misc/condo)
"QX" = (
/obj/item/kirbyplants/random/fullysynthetic,
/obj/effect/turf_decal/tile/blue/opposingcorners,
/turf/open/indestructible/white,
/area/misc/condo)
"Ri" = (
/obj/effect/turf_decal/trimline/blue/filled/warning{
	dir = 8
	},
/turf/open/indestructible/white/smooth_large,
/area/misc/condo)
"Rp" = (
/obj/effect/turf_decal/tile/blue/opposingcorners,
/obj/machinery/iv_drip,
/obj/machinery/digital_clock/directional/south,
/turf/open/indestructible/white,
/area/misc/condo)
"Rv" = (
/obj/effect/turf_decal/trimline/blue/filled/line{
	dir = 5
	},
/obj/item/kirbyplants/random/fullysynthetic,
/turf/open/indestructible/white,
/area/misc/condo)
"Rx" = (
/obj/effect/turf_decal/trimline/blue/filled/line{
	dir = 4
	},
/obj/vehicle/ridden/wheelchair{
	dir = 8
	},
/turf/open/indestructible/white,
/area/misc/condo)
"RE" = (
/obj/effect/turf_decal/tile/blue/opposingcorners,
/obj/vehicle/ridden/wheelchair{
	dir = 8
	},
/obj/machinery/digital_clock/directional/north,
/turf/open/indestructible/white,
/area/misc/condo)
"RM" = (
/obj/item/kirbyplants/random/fullysynthetic,
/obj/effect/turf_decal/tile/blue/opposingcorners,
/obj/machinery/light/cold/directional/north,
/turf/open/indestructible/white/textured,
/area/misc/condo)
"RX" = (
/obj/effect/turf_decal/trimline/blue/filled/warning{
	dir = 1
	},
/obj/item/kirbyplants/random/fullysynthetic,
/turf/open/indestructible/white,
/area/misc/condo)
"Sb" = (
/obj/effect/turf_decal/trimline/blue/filled/line{
	dir = 4
	},
/obj/machinery/iv_drip,
/turf/open/indestructible/white,
/area/misc/condo)
"Sh" = (
/obj/effect/spawner/structure/window/reinforced,
/obj/structure/curtain/bounty,
/turf/open/floor/plating,
/area/misc/condo)
"Sr" = (
/obj/effect/turf_decal/trimline/blue/filled/line{
	dir = 10
	},
/obj/item/banner/medical/mundane,
/turf/open/indestructible/white,
/area/misc/condo)
"Sx" = (
/obj/effect/turf_decal/siding/thinplating_new/light,
/turf/open/indestructible/hotelwood,
/area/misc/condo)
"SD" = (
/obj/effect/turf_decal/tile/blue/opposingcorners,
/turf/open/indestructible/white/textured,
/area/misc/condo)
"SU" = (
/obj/structure/table,
/obj/item/storage/box/cups{
	pixel_x = 5;
	pixel_y = 15
	},
/obj/item/reagent_containers/cup/glass/waterbottle/large{
	pixel_x = -8;
	pixel_y = 20
	},
/obj/item/reagent_containers/cup/glass/waterbottle/large{
	pixel_x = -8;
	pixel_y = 11
	},
/obj/item/reagent_containers/cup/glass/mug/nanotrasen{
	pixel_x = 4;
	pixel_y = 2
	},
/obj/effect/turf_decal/siding/thinplating_new/light,
/obj/structure/window/spawner/directional/south,
/obj/structure/sign/calendar/directional/west,
/turf/open/indestructible/hotelwood,
/area/misc/condo)
"TB" = (
/obj/effect/turf_decal/trimline/blue/filled/corner{
	dir = 1
	},
/turf/open/indestructible/white,
/area/misc/condo)
"TV" = (
/obj/effect/turf_decal/trimline/blue/filled/line,
/obj/machinery/light/cold/directional/south,
/obj/structure/chair{
	dir = 1
	},
/turf/open/indestructible/white,
/area/misc/condo)
"Ut" = (
/obj/effect/turf_decal/trimline/blue/filled/line{
	dir = 8
	},
/turf/open/indestructible/white,
/area/misc/condo)
"Ux" = (
/obj/machinery/vending/wardrobe/medi_wardrobe/ghost_cafe,
/obj/effect/turf_decal/tile/blue/opposingcorners,
/turf/open/indestructible/white/textured,
/area/misc/condo)
"UC" = (
/obj/structure/table,
/obj/item/book/manual/random{
	pixel_x = -5;
	pixel_y = 3
	},
/obj/effect/turf_decal/tile/blue/opposingcorners,
/obj/item/reagent_containers/cup/glass/mug/coco{
	pixel_x = 8
	},
/obj/machinery/computer/security/telescreen/entertainment/directional/north,
/turf/open/indestructible/white,
/area/misc/condo)
"Vd" = (
/obj/machinery/door/airlock/medical{
	name = "Recovery Room"
	},
/obj/effect/turf_decal/tile/blue/opposingcorners,
/turf/open/indestructible/white,
/area/misc/condo)
"Wi" = (
/obj/effect/turf_decal/siding/thinplating_new/light,
/obj/structure/chair{
	dir = 4
	},
/obj/structure/window/spawner/directional/south,
/turf/open/indestructible/hotelwood,
/area/misc/condo)
"WN" = (
/obj/structure/chair{
	dir = 4
	},
/turf/open/indestructible/hotelwood,
/area/misc/condo)
"Xk" = (
/obj/effect/spawner/structure/window/reinforced,
/turf/open/floor/plating,
/area/misc/condo)
"Xw" = (
/obj/effect/turf_decal/trimline/blue/filled/warning{
	dir = 1
	},
/turf/open/indestructible/white,
/area/misc/condo)
"Yy" = (
/obj/effect/turf_decal/tile/blue/opposingcorners,
/obj/machinery/light/cold/directional/north,
/turf/open/indestructible/white,
/area/misc/condo)
"YB" = (
/obj/structure/chair{
	dir = 1
	},
/turf/open/indestructible/carpet,
/area/misc/condo)
"ZV" = (
/obj/structure/chair{
	dir = 8
	},
/turf/open/indestructible/hotelwood,
/area/misc/condo)

(1,1,1) = {"
GK
GK
GK
GK
GK
GK
pZ
Qv
pZ
GK
pZ
Qv
pZ
GK
GK
"}
(2,1,1) = {"
GK
eR
qR
CF
lS
SU
HD
Ri
Sr
Xk
Ux
SD
vt
GK
sn
"}
(3,1,1) = {"
GK
uZ
PG
PG
PG
Sx
Xw
jt
PQ
AV
SD
SD
SD
KO
sn
"}
(4,1,1) = {"
GK
WN
PG
PG
PG
Sx
Xw
jt
TV
Xk
RM
SD
BJ
KO
sn
"}
(5,1,1) = {"
GK
gE
YB
PG
PG
Sx
Xw
jt
bv
Xk
hJ
SD
mn
KO
sn
"}
(6,1,1) = {"
GK
ZV
PG
PG
PG
Wi
Xw
jt
ld
Xk
dA
Mo
Es
GK
sn
"}
(7,1,1) = {"
GK
mL
DY
DY
LY
aY
RX
jt
dh
Lq
Xk
Ht
Xk
GK
sn
"}
(8,1,1) = {"
pZ
zf
so
so
so
nZ
TB
jt
ue
MH
Ut
Ri
ES
KO
sn
"}
(9,1,1) = {"
Qv
gY
jt
jt
jt
jt
jt
jt
jt
jt
jt
jt
uM
KO
sn
"}
(10,1,1) = {"
pZ
Rv
Rx
Sb
Rx
zE
ds
jt
PM
zE
zE
zE
KT
KO
sn
"}
(11,1,1) = {"
GK
Sh
Sh
Sh
Sh
GK
mV
jt
ph
GK
Sh
Sh
Sh
GK
GK
"}
(12,1,1) = {"
GK
UC
eu
wh
QX
Sh
vJ
jt
ld
Sh
QX
Ge
eu
kN
GK
"}
(13,1,1) = {"
GK
Yy
rY
rY
rY
OM
gY
jt
PQ
Vd
rY
rY
rY
kJ
GK
"}
(14,1,1) = {"
GK
RE
rY
rY
Fh
Sh
Rv
PU
xz
Sh
Qk
rY
rY
Rp
GK
"}
(15,1,1) = {"
GK
uW
uW
uW
uW
GK
uW
uW
uW
GK
uW
uW
uW
uW
GK
"}
(16,1,1) = {"
sn
sn
sn
sn
sn
sn
sn
sn
sn
sn
sn
sn
sn
sn
sn
"}
