//MAP CONVERTED BY dmm2tgm.py THIS HEADER COMMENT PREVENTS RECONVERSION, DO NOT REMOVE
"a" = (
/obj/structure/dresser,
/obj/machinery/light/warm/directional/west,
/turf/open/floor/wood/large,
/area/misc/condo)
"h" = (
/obj/structure/sink/directional/north,
/turf/open/floor/iron/freezer,
/area/misc/condo)
"i" = (
/obj/structure/chair/sofa/corp/right,
/turf/open/floor/wood/large,
/area/misc/condo)
"k" = (
/obj/structure/toilet{
	pixel_y = 10
	},
/obj/structure/railing{
	dir = 4
	},
/obj/structure/mirror/directional/north,
/turf/open/floor/iron/freezer,
/area/misc/condo)
"l" = (
/obj/effect/spawner/liquids_spawner,
/turf/open/floor/iron/pool,
/area/misc/condo)
"m" = (
/obj/machinery/light/small/directional/north,
/obj/effect/spawner/liquids_spawner,
/turf/open/floor/iron/pool,
/area/misc/condo)
"q" = (
/obj/effect/turf_decal/siding/thinplating/dark{
	dir = 10
	},
/turf/open/floor/iron/dark/small,
/area/misc/condo)
"r" = (
/turf/closed/indestructible/normal_wall,
/area/misc/condo)
"s" = (
/obj/structure/chair/sofa/corp/corner,
/turf/open/floor/wood/large,
/area/misc/condo)
"v" = (
/obj/structure/table/wood,
/obj/item/toy/cards/deck,
/turf/open/floor/wood/large,
/area/misc/condo)
"y" = (
/turf/open/floor/iron/freezer,
/area/misc/condo)
"z" = (
/obj/effect/planetary_turf_atmos_helper,
/turf/closed/indestructible/normal_wall,
/area/misc/condo)
"A" = (
/obj/effect/turf_decal/siding/wood,
/turf/open/floor/wood/large,
/area/misc/condo)
"B" = (
/obj/item/kirbyplants/random,
/obj/effect/turf_decal/siding/thinplating/dark,
/turf/open/floor/iron/dark/small,
/area/misc/condo)
"C" = (
/obj/machinery/shower/directional/south,
/obj/structure/drain,
/obj/structure/curtain,
/obj/structure/window/spawner/directional/east,
/turf/open/floor/iron/freezer,
/area/misc/condo)
"D" = (
/obj/effect/turf_decal/siding/wood,
/obj/structure/closet/secure_closet/personal/cabinet,
/turf/open/floor/wood/large,
/area/misc/condo)
"F" = (
/obj/effect/turf_decal/siding/wood,
/obj/structure/chair/sofa/corp/left{
	dir = 8
	},
/turf/open/floor/wood/large,
/area/misc/condo)
"G" = (
/obj/effect/turf_decal/siding/thinplating/dark,
/obj/machinery/door/airlock/bathroom{
	name = "Restroom"
	},
/turf/open/floor/iron/freezer,
/area/misc/condo)
"I" = (
/turf/closed/indestructible/hoteldoor/fakedoor,
/area/misc/condo)
"K" = (
/obj/structure/fluff/fake_vent,
/turf/open/floor/wood/large,
/area/misc/condo)
"L" = (
/obj/structure/fluff/fake_scrubber,
/turf/open/floor/wood/large,
/area/misc/condo)
"N" = (
/obj/structure/bed/double{
	dir = 4
	},
/obj/effect/spawner/random/bedsheet/any/double{
	dir = 1
	},
/obj/machinery/light_switch/directional/west,
/turf/open/floor/wood/large,
/area/misc/condo)
"Q" = (
/obj/structure/fireplace,
/obj/effect/turf_decal/siding/thinplating/dark,
/turf/open/floor/iron/dark/small,
/area/misc/condo)
"X" = (
/turf/open/floor/wood/large,
/area/misc/condo)
"Y" = (
/obj/effect/turf_decal/siding/wood,
/obj/structure/closet/emcloset/wall{
	pixel_y = -32
	},
/turf/open/floor/wood/large,
/area/misc/condo)
"Z" = (
/obj/structure/chair/sofa/corp{
	dir = 8
	},
/turf/open/floor/wood/large,
/area/misc/condo)

(1,1,1) = {"
r
r
r
r
r
r
r
r
r
"}
(2,1,1) = {"
r
C
y
G
X
a
N
D
r
"}
(3,1,1) = {"
r
k
h
r
q
K
L
Y
r
"}
(4,1,1) = {"
r
m
l
r
Q
i
v
A
I
"}
(5,1,1) = {"
r
l
l
r
B
s
Z
F
r
"}
(6,1,1) = {"
r
r
r
r
r
r
r
r
z
"}
