//MAP CONVERTED BY dmm2tgm.py THIS HEADER COMMENT PREVENTS RECONVERSION, DO NOT REMOVE
"a" = (
/obj/structure/lattice/catwalk,
/turf/open/space/basic,
/area/misc/condo)
"b" = (
/obj/structure/table/reinforced/rglass,
/obj/item/flashlight/lamp{
	pixel_x = -1;
	pixel_y = 6
	},
/turf/open/floor/carpet/blue,
/area/misc/condo)
"c" = (
/obj/structure/table/reinforced/rglass,
/obj/effect/turf_decal/tile/dark_blue,
/obj/item/folder,
/obj/item/folder/yellow{
	pixel_x = 7;
	pixel_y = 4
	},
/turf/open/floor/iron/dark/side{
	dir = 1
	},
/area/misc/condo)
"d" = (
/obj/effect/turf_decal/tile/dark_blue{
	dir = 1
	},
/turf/open/floor/iron/dark/corner,
/area/misc/condo)
"e" = (
/obj/machinery/door/airlock/external/glass,
/obj/structure/fans/tiny/invisible,
/turf/open/floor/iron,
/area/misc/condo)
"f" = (
/obj/structure/table/reinforced/rglass,
/obj/effect/turf_decal/tile/dark_blue{
	dir = 1
	},
/obj/effect/spawner/random/bureaucracy/stamp,
/turf/open/floor/iron/dark/side,
/area/misc/condo)
"g" = (
/turf/closed/indestructible/hoteldoor/fakedoor,
/area/misc/condo)
"h" = (
/obj/effect/turf_decal/tile/dark_blue,
/obj/effect/turf_decal/tile/dark_blue{
	dir = 1
	},
/turf/open/floor/iron/dark/corner{
	dir = 8
	},
/area/misc/condo)
"i" = (
/obj/item/banner/command/mundane,
/turf/open/floor/iron/dark/side{
	dir = 5
	},
/area/misc/condo)
"j" = (
/obj/item/kirbyplants/organic/plant21,
/obj/effect/turf_decal/tile/dark_blue,
/obj/structure/sign/flag/nanotrasen/directional/north,
/turf/open/floor/iron/dark/side{
	dir = 1
	},
/area/misc/condo)
"k" = (
/obj/structure/chair/comfy{
	dir = 1;
	color = "#2c7ada"
	},
/turf/open/floor/carpet/blue,
/area/misc/condo)
"l" = (
/obj/effect/turf_decal/tile/dark_blue,
/turf/open/floor/iron/dark/side{
	dir = 9
	},
/area/misc/condo)
"m" = (
/obj/effect/turf_decal/tile/dark_blue,
/obj/item/banner/command/mundane,
/turf/open/floor/iron/dark/side{
	dir = 8
	},
/area/misc/condo)
"n" = (
/obj/structure/table/reinforced/rglass,
/obj/item/paper_bin{
	pixel_y = 4
	},
/turf/open/floor/carpet/blue,
/area/misc/condo)
"o" = (
/obj/machinery/light/cold/directional/west,
/obj/effect/turf_decal/tile/dark_blue,
/turf/open/floor/iron/dark/side{
	dir = 8
	},
/area/misc/condo)
"p" = (
/obj/machinery/light/small/directional/south,
/obj/effect/turf_decal/tile/dark_blue{
	dir = 1
	},
/turf/open/floor/iron/dark/side,
/area/misc/condo)
"q" = (
/turf/closed/wall/r_wall,
/area/misc/condo)
"r" = (
/obj/structure/table/reinforced/rglass,
/obj/item/folder/blue{
	pixel_x = 4;
	pixel_y = 4
	},
/turf/open/floor/carpet/blue,
/area/misc/condo)
"s" = (
/obj/effect/turf_decal/tile/dark_blue,
/turf/open/floor/iron/dark/side{
	dir = 8
	},
/area/misc/condo)
"t" = (
/obj/item/kirbyplants/organic/plant21,
/obj/effect/turf_decal/tile/dark_blue{
	dir = 1
	},
/obj/structure/sign/flag/terragov/directional/south,
/turf/open/floor/iron/dark/side,
/area/misc/condo)
"u" = (
/obj/machinery/modular_computer/preset/civilian,
/obj/effect/turf_decal/tile/dark_blue,
/turf/open/floor/iron/dark/side{
	dir = 1
	},
/area/misc/condo)
"w" = (
/obj/effect/spawner/structure/window/reinforced/plasma,
/turf/open/floor/plating,
/area/misc/condo)
"x" = (
/obj/structure/table/reinforced/rglass,
/obj/item/stamp,
/obj/effect/spawner/random/bureaucracy/stamp{
	pixel_x = 6;
	pixel_y = 8
	},
/turf/open/floor/iron/dark/side{
	dir = 5
	},
/area/misc/condo)
"y" = (
/obj/machinery/light/cold/directional/east,
/obj/effect/turf_decal/tile/dark_blue{
	dir = 1
	},
/obj/structure/table/reinforced/rglass,
/obj/item/disk/nuclear/fake{
	pixel_x = -1;
	pixel_y = 4
	},
/turf/open/floor/iron/dark/side{
	dir = 4
	},
/area/misc/condo)
"z" = (
/obj/structure/chair/comfy{
	color = "#ce381e"
	},
/turf/open/floor/carpet/blue,
/area/misc/condo)
"A" = (
/obj/effect/turf_decal/tile/dark_blue,
/turf/open/floor/iron/dark/side{
	dir = 1
	},
/area/misc/condo)
"B" = (
/turf/open/floor/iron/dark/side{
	dir = 10
	},
/area/misc/condo)
"C" = (
/obj/structure/chair/comfy{
	color = "#4aac21"
	},
/turf/open/floor/carpet/blue,
/area/misc/condo)
"D" = (
/obj/machinery/shuttle_manipulator{
	desc = "A holographic display of the ship we're on right now.";
	name = "ship holographic display"
	},
/turf/open/floor/circuit,
/area/misc/condo)
"E" = (
/turf/open/space/basic,
/area/misc/condo)
"F" = (
/obj/effect/turf_decal/tile/dark_blue{
	dir = 1
	},
/turf/open/floor/iron/dark/side{
	dir = 4
	},
/area/misc/condo)
"G" = (
/obj/machinery/modular_computer/preset/civilian,
/obj/machinery/light/cold/directional/north,
/obj/effect/turf_decal/tile/dark_blue,
/obj/structure/sign/flag/terragov/directional/north,
/turf/open/floor/iron/dark/side{
	dir = 1
	},
/area/misc/condo)
"H" = (
/obj/effect/turf_decal/tile/dark_blue,
/turf/open/floor/iron/dark/corner{
	dir = 1
	},
/area/misc/condo)
"I" = (
/obj/effect/turf_decal/tile/dark_blue,
/obj/structure/filingcabinet,
/turf/open/floor/iron/dark/side{
	dir = 1
	},
/area/misc/condo)
"J" = (
/obj/machinery/modular_computer/preset/civilian{
	dir = 8
	},
/obj/effect/turf_decal/tile/dark_blue{
	dir = 1
	},
/turf/open/floor/iron/dark/side{
	dir = 4
	},
/area/misc/condo)
"K" = (
/obj/structure/chair/comfy{
	dir = 1;
	color = "#1cbfcb"
	},
/turf/open/floor/carpet/blue,
/area/misc/condo)
"L" = (
/obj/machinery/modular_computer/preset/civilian{
	dir = 1
	},
/obj/machinery/light/cold/directional/south,
/obj/effect/turf_decal/tile/dark_blue{
	dir = 1
	},
/obj/structure/sign/flag/nanotrasen/directional/south,
/turf/open/floor/iron/dark/side,
/area/misc/condo)
"M" = (
/obj/effect/turf_decal/tile/dark_blue{
	dir = 1
	},
/turf/open/floor/iron/dark/side,
/area/misc/condo)
"N" = (
/obj/structure/chair/comfy{
	dir = 1;
	color = "#2cda61"
	},
/turf/open/floor/carpet/blue,
/area/misc/condo)
"O" = (
/obj/machinery/modular_computer/preset/civilian{
	dir = 1
	},
/obj/effect/turf_decal/tile/dark_blue{
	dir = 1
	},
/turf/open/floor/iron/dark/side,
/area/misc/condo)
"P" = (
/obj/effect/turf_decal/tile/dark_blue,
/obj/effect/turf_decal/tile/dark_blue{
	dir = 1
	},
/turf/open/floor/iron/dark/corner{
	dir = 4
	},
/area/misc/condo)
"Q" = (
/obj/structure{
	density = 1;
	icon = 'icons/obj/machines/shuttle_manipulator.dmi';
	icon_state = "hologram_on";
	light_color = "#2cb2e8";
	light_range = 2;
	mouse_opacity = 0;
	name = "holographic projection";
	pixel_x = -32;
	pixel_y = 17
	},
/obj/structure{
	desc = "This is the ship we're on. It's amazing what Nanotrasen can do once they actually put more than ten seconds of effort into their projects.";
	icon = 'icons/obj/machines/shuttle_manipulator.dmi';
	icon_state = "hologram_whiteship";
	light_color = "#2cb2e8";
	light_range = 7;
	name = "Ship Hologram";
	pixel_x = -32;
	pixel_y = 27
	},
/turf/open/floor/circuit,
/area/misc/condo)
"R" = (
/obj/structure/chair/comfy{
	color = "#e6a515"
	},
/turf/open/floor/carpet/blue,
/area/misc/condo)
"S" = (
/obj/effect/turf_decal/tile/dark_blue,
/obj/item/banner/command/mundane,
/obj/machinery/light_switch/directional/west,
/turf/open/floor/iron/dark/side{
	dir = 8
	},
/area/misc/condo)
"T" = (
/obj/effect/turf_decal/tile/dark_blue{
	dir = 1
	},
/obj/item/banner/command/mundane,
/turf/open/floor/iron/dark/side{
	dir = 6
	},
/area/misc/condo)
"U" = (
/obj/machinery/modular_computer/preset/civilian,
/obj/effect/turf_decal/tile/dark_blue,
/turf/open/floor/iron/dark/side{
	dir = 9
	},
/area/misc/condo)
"V" = (
/obj/structure/table/reinforced/rglass,
/obj/effect/turf_decal/tile/dark_blue{
	dir = 1
	},
/obj/item/paper_bin{
	pixel_y = 4
	},
/turf/open/floor/iron/dark/side{
	dir = 6
	},
/area/misc/condo)
"X" = (
/turf/closed/wall/space,
/area/misc/condo)
"Y" = (
/obj/structure/closet/emcloset/anchored,
/obj/item/clothing/head/helmet/space/eva,
/obj/item/clothing/head/helmet/space/eva,
/obj/item/clothing/suit/space,
/obj/item/clothing/suit/space,
/obj/item/tank/jetpack/carbondioxide,
/obj/item/tank/jetpack/carbondioxide,
/obj/item/tank/internals/oxygen,
/obj/item/tank/internals/oxygen,
/obj/item/clothing/mask/breath,
/obj/item/clothing/mask/breath,
/turf/open/floor/iron/dark/side{
	dir = 10
	},
/area/misc/condo)
"Z" = (
/obj/machinery/light/small/directional/north,
/obj/effect/turf_decal/tile/dark_blue,
/turf/open/floor/iron/dark/side{
	dir = 1
	},
/area/misc/condo)

(1,1,1) = {"
X
X
X
X
q
X
X
X
q
X
X
X
X
X
X
"}
(2,1,1) = {"
X
E
q
q
q
q
g
q
q
q
q
E
E
E
X
"}
(3,1,1) = {"
X
E
q
U
o
S
s
m
o
Y
q
a
E
E
X
"}
(4,1,1) = {"
X
E
w
I
d
F
F
F
P
M
e
a
E
E
X
"}
(5,1,1) = {"
X
E
q
j
M
C
n
K
A
t
q
a
E
E
X
"}
(6,1,1) = {"
X
E
q
G
M
R
b
N
A
L
q
a
E
E
X
"}
(7,1,1) = {"
X
E
w
u
M
z
r
k
A
O
w
a
E
E
X
"}
(8,1,1) = {"
X
E
w
c
h
B
D
l
H
f
w
E
E
E
X
"}
(9,1,1) = {"
X
E
w
x
P
M
Q
A
d
V
w
E
E
E
X
"}
(10,1,1) = {"
X
E
q
q
Z
h
s
H
p
q
q
E
E
E
X
"}
(11,1,1) = {"
X
E
a
w
i
J
y
J
T
w
a
E
E
E
X
"}
(12,1,1) = {"
X
E
a
w
w
w
q
w
w
w
a
E
E
E
X
"}
(13,1,1) = {"
X
E
a
a
a
a
a
a
a
a
a
E
E
E
X
"}
(14,1,1) = {"
X
E
E
E
E
E
E
E
E
E
E
E
E
E
X
"}
(15,1,1) = {"
X
E
E
E
E
E
E
E
E
E
E
E
E
E
X
"}
(16,1,1) = {"
X
X
X
X
X
X
X
X
X
X
X
X
X
X
X
"}
