//MAP CONVERTED BY dmm2tgm.py THIS HEADER COMMENT PREVENTS RECONVERSION, DO NOT REMOVE
"a" = (
/obj/structure/closet/secure_closet/personal/cabinet,
/obj/effect/turf_decal/siding/dark{
	dir = 10
	},
/obj/machinery/light_switch/directional/west,
/obj/item/storage/box/matches,
/turf/open/floor/stone,
/area/misc/condo)
"c" = (
/obj/structure/bed/double{
	dir = 4
	},
/obj/item/bedsheet/orange/double{
	dir = 1
	},
/turf/open/floor/carpet/royalblue,
/area/misc/condo)
"d" = (
/turf/closed/indestructible/normal_wall,
/area/misc/condo)
"f" = (
/obj/machinery/light/small/directional/west,
/obj/machinery/status_display/evac/directional/west,
/turf/open/floor/iron/freezer,
/area/misc/condo)
"g" = (
/obj/structure/flora/bush/flowers_br/style_random,
/obj/structure/flora/bush/ferny/style_3,
/obj/structure/flora/bush/flowers_yw/style_2,
/obj/structure/flora/bush/leafy,
/obj/structure/window/reinforced/fulltile/indestructible,
/obj/structure/curtain/bounty,
/turf/open/floor/grass,
/area/misc/condo)
"h" = (
/obj/structure/fluff/fake_vent,
/turf/open/floor/carpet/royalblue,
/area/misc/condo)
"l" = (
/obj/effect/planetary_turf_atmos_helper,
/turf/closed/indestructible/normal_wall,
/area/misc/condo)
"p" = (
/turf/cordon,
/area/misc/condo)
"q" = (
/obj/machinery/door/airlock/bathroom{
	name = "Restroom"
	},
/turf/open/floor/plating,
/area/misc/condo)
"r" = (
/obj/structure/flora/bush/flowers_br/style_random,
/obj/structure/flora/bush/ferny/style_2,
/obj/structure/flora/bush/flowers_yw,
/obj/structure/flora/bush/leafy,
/obj/structure/window/reinforced/fulltile/indestructible,
/obj/structure/curtain/bounty,
/turf/open/floor/grass,
/area/misc/condo)
"t" = (
/obj/machinery/light/built/directional/west,
/obj/effect/turf_decal/trimline/dark/filled/line{
	dir = 4
	},
/obj/effect/turf_decal/trimline/dark/filled/mid_joiner{
	dir = 4
	},
/turf/open/floor/wood/tile,
/area/misc/condo)
"u" = (
/obj/structure/flora/bush/flowers_pp/style_3,
/obj/structure/flora/bush/ferny/style_3,
/obj/structure/flora/bush/flowers_yw/style_3,
/obj/structure/flora/bush/leafy,
/obj/structure/window/reinforced/fulltile/indestructible,
/obj/structure/curtain/bounty,
/turf/open/floor/grass,
/area/misc/condo)
"x" = (
/obj/structure/fluff/fake_scrubber,
/turf/open/floor/carpet/royalblue,
/area/misc/condo)
"z" = (
/obj/effect/turf_decal/siding/wood{
	dir = 10
	},
/turf/open/floor/wood/tile,
/area/misc/condo)
"A" = (
/turf/open/floor/iron/freezer,
/area/misc/condo)
"B" = (
/obj/structure/fluff/fake_firedoor,
/obj/effect/turf_decal/trimline/dark/filled/line{
	dir = 6
	},
/obj/effect/turf_decal/trimline/dark/filled/mid_joiner,
/obj/effect/turf_decal/trimline/dark/filled/mid_joiner{
	dir = 4
	},
/turf/open/floor/wood/tile,
/area/misc/condo)
"E" = (
/obj/structure/fireplace,
/obj/effect/turf_decal/siding/dark{
	dir = 6
	},
/turf/open/floor/stone,
/area/misc/condo)
"F" = (
/obj/structure/window/reinforced/tinted/spawner/directional/east,
/obj/machinery/shower/directional/south,
/obj/structure/drain,
/turf/open/floor/iron/freezer,
/area/misc/condo)
"H" = (
/obj/effect/turf_decal/trimline/dark/filled/line{
	dir = 5
	},
/obj/effect/turf_decal/trimline/dark/filled/mid_joiner{
	dir = 4
	},
/obj/effect/turf_decal/trimline/dark/filled/mid_joiner{
	dir = 1
	},
/turf/open/floor/wood/tile,
/area/misc/condo)
"I" = (
/turf/open/floor/carpet/royalblue,
/area/misc/condo)
"J" = (
/obj/structure/sink/directional/west,
/obj/structure/mirror/directional/east,
/turf/open/floor/iron/freezer,
/area/misc/condo)
"K" = (
/obj/effect/turf_decal/trimline/dark/filled/line{
	dir = 1
	},
/obj/effect/turf_decal/trimline/dark/filled/mid_joiner{
	dir = 1
	},
/turf/open/floor/wood/tile,
/area/misc/condo)
"L" = (
/obj/structure/table/wood,
/obj/effect/turf_decal/siding/wood/corner{
	dir = 8
	},
/obj/machinery/light/directional/east,
/turf/open/floor/wood/tile,
/area/misc/condo)
"M" = (
/obj/machinery/light/small/built/directional/south,
/obj/effect/turf_decal/trimline/dark/filled/line{
	dir = 1
	},
/obj/effect/turf_decal/trimline/dark/filled/mid_joiner{
	dir = 1
	},
/turf/open/floor/wood/tile,
/area/misc/condo)
"O" = (
/obj/structure/noticeboard/directional/south,
/obj/effect/turf_decal/trimline/dark/filled/line{
	dir = 9
	},
/obj/effect/turf_decal/trimline/dark/filled/mid_joiner{
	dir = 1
	},
/obj/effect/turf_decal/trimline/dark/filled/mid_joiner{
	dir = 8
	},
/turf/open/floor/wood/tile,
/area/misc/condo)
"P" = (
/obj/structure/table,
/obj/structure/towel_bin{
	pixel_x = 1;
	pixel_y = 5
	},
/turf/open/floor/iron/freezer,
/area/misc/condo)
"Q" = (
/obj/structure/chair/sofa/left/maroon{
	dir = 8
	},
/obj/effect/turf_decal/siding/wood{
	dir = 10
	},
/turf/open/floor/wood/tile,
/area/misc/condo)
"R" = (
/obj/effect/turf_decal/trimline/dark/filled/line{
	dir = 4
	},
/obj/effect/turf_decal/trimline/dark/filled/mid_joiner{
	dir = 4
	},
/turf/open/floor/wood/tile,
/area/misc/condo)
"S" = (
/obj/structure/flora/bush/flowers_pp/style_2,
/obj/structure/flora/bush/ferny/style_2,
/obj/structure/flora/bush/flowers_yw/style_2,
/obj/structure/flora/bush/leafy,
/obj/structure/window/reinforced/fulltile/indestructible,
/obj/structure/curtain/bounty/start_closed,
/turf/open/floor/grass,
/area/misc/condo)
"T" = (
/obj/structure/toilet{
	dir = 4
	},
/turf/open/floor/iron/freezer,
/area/misc/condo)
"U" = (
/obj/structure/sign/poster/random/directional/south,
/obj/effect/turf_decal/trimline/dark/filled/line{
	dir = 1
	},
/obj/effect/turf_decal/trimline/dark/filled/mid_joiner{
	dir = 1
	},
/turf/open/floor/wood/tile,
/area/misc/condo)
"V" = (
/obj/structure/dresser,
/turf/open/floor/carpet/royalblue,
/area/misc/condo)
"W" = (
/turf/closed/indestructible/hoteldoor/fakedoor,
/area/misc/condo)
"X" = (
/obj/structure/chair/sofa/right/maroon{
	dir = 8
	},
/obj/effect/turf_decal/siding/wood{
	dir = 8
	},
/turf/open/floor/wood/tile,
/area/misc/condo)

(1,1,1) = {"
p
d
d
d
d
d
"}
(2,1,1) = {"
p
d
F
f
T
l
"}
(3,1,1) = {"
p
d
P
A
J
d
"}
(4,1,1) = {"
O
d
d
q
d
d
"}
(5,1,1) = {"
K
u
a
I
c
d
"}
(6,1,1) = {"
M
d
E
h
V
d
"}
(7,1,1) = {"
K
W
z
x
I
d
"}
(8,1,1) = {"
K
S
L
X
Q
d
"}
(9,1,1) = {"
U
d
d
r
g
d
"}
(10,1,1) = {"
H
R
t
R
R
B
"}
