//MAP CONVERTED BY dmm2tgm.py THIS HEADER COMMENT PREVENTS RECONVERSION, DO NOT REMOVE
"aJ" = (
/obj/effect/planetary_turf_atmos_helper,
/turf/closed/indestructible/normal_wall,
/area/misc/condo)
"bK" = (
/obj/effect/decal/cleanable/dirt/dust,
/obj/structure/sign/poster/contraband/energy_swords/directional/north,
/turf/open/floor/plating,
/area/misc/condo)
"dA" = (
/obj/effect/turf_decal/tile/red/diagonal_centre,
/obj/structure/fluff/fake_scrubber,
/turf/open/floor/iron/dark/diagonal,
/area/misc/condo)
"ef" = (
/obj/structure/steam_vent,
/obj/effect/decal/cleanable/dirt/dust,
/turf/open/floor/plating,
/area/misc/condo)
"eS" = (
/obj/effect/turf_decal/tile/red/diagonal_centre,
/obj/structure/fluff/fake_vent,
/turf/open/floor/iron/dark/diagonal,
/area/misc/condo)
"fc" = (
/obj/effect/turf_decal/tile/neutral{
	dir = 4
	},
/obj/structure/disposalpipe/broken{
	dir = 4
	},
/turf/open/floor/iron,
/area/misc/condo)
"fM" = (
/obj/effect/decal/cleanable/dirt/dust,
/obj/effect/mapping_helpers/burnt_floor,
/obj/structure/table/wood,
/obj/structure/sign/poster/contraband/fun_police/directional/north,
/turf/open/floor/wood,
/area/misc/condo)
"gL" = (
/obj/effect/turf_decal/tile/neutral/fourcorners,
/obj/structure/fluff/fake_scrubber,
/turf/open/floor/iron,
/area/misc/condo)
"gM" = (
/obj/effect/turf_decal/siding/wideplating_new{
	dir = 8
	},
/obj/effect/turf_decal/siding/wideplating_new{
	dir = 4
	},
/obj/machinery/door/airlock/security{
	dir = 4;
	name = "Checkpoint"
	},
/obj/effect/mapping_helpers/airlock/cyclelink_helper{
	dir = 4
	},
/turf/open/floor/iron/smooth_large,
/area/misc/condo)
"jr" = (
/turf/cordon,
/area/misc/condo)
"kQ" = (
/obj/structure/sign/poster/contraband/syndicate_pistol/directional/north,
/turf/open/floor/plating,
/area/misc/condo)
"mb" = (
/turf/closed/indestructible/fakedoor/maintenance,
/area/misc/condo)
"nI" = (
/obj/effect/turf_decal/siding/wideplating_new/dark{
	dir = 1
	},
/obj/structure/window/reinforced/spawner/directional/north,
/obj/structure/closet/secure_closet/personal,
/turf/open/floor/iron/dark/textured_large,
/area/misc/condo)
"oo" = (
/turf/closed/indestructible/hoteldoor/fakedoor/public,
/area/misc/condo)
"oq" = (
/obj/structure/closet/crate/preopen,
/turf/open/floor/plating,
/area/misc/condo)
"ox" = (
/obj/effect/turf_decal/siding/wideplating_new{
	dir = 8
	},
/obj/effect/turf_decal/siding/wideplating_new{
	dir = 4
	},
/obj/structure/fluff/fake_firedoor{
	dir = 8
	},
/obj/structure/table/reinforced,
/obj/machinery/door/window/brigdoor/right/directional/east,
/obj/machinery/door/window/brigdoor/left/directional/west,
/turf/open/floor/iron/smooth_large,
/area/misc/condo)
"oE" = (
/obj/effect/decal/cleanable/dirt/dust,
/turf/open/floor/plating,
/area/misc/condo)
"oM" = (
/obj/effect/turf_decal/trimline/dark/filled/mid_joiner{
	dir = 1
	},
/obj/effect/turf_decal/trimline/dark/filled/mid_joiner{
	dir = 1;
	pixel_x = 16
	},
/obj/effect/turf_decal/tile/neutral{
	dir = 1
	},
/obj/effect/turf_decal/trimline/dark/filled/line{
	dir = 1
	},
/turf/open/floor/iron,
/area/misc/condo)
"oP" = (
/obj/effect/decal/cleanable/dirt/dust,
/obj/structure/closet,
/turf/open/floor/plating,
/area/misc/condo)
"pw" = (
/obj/effect/turf_decal/trimline/dark/filled/mid_joiner{
	dir = 1
	},
/obj/effect/turf_decal/tile/neutral{
	dir = 4
	},
/obj/effect/turf_decal/trimline/dark/filled/line{
	dir = 1
	},
/obj/effect/turf_decal/trimline/dark/filled/mid_joiner{
	dir = 1;
	pixel_x = 16
	},
/turf/open/floor/iron,
/area/misc/condo)
"pP" = (
/obj/effect/mapping_helpers/broken_floor,
/turf/open/floor/wood,
/area/misc/condo)
"re" = (
/obj/effect/turf_decal/siding/wideplating_new{
	dir = 8
	},
/obj/effect/spawner/random/vending/colavend,
/obj/machinery/light/directional/east,
/turf/open/floor/iron/dark,
/area/misc/condo)
"rn" = (
/obj/effect/turf_decal/tile/neutral/fourcorners,
/turf/open/floor/iron,
/area/misc/condo)
"rJ" = (
/obj/effect/turf_decal/siding/wideplating_new{
	dir = 8
	},
/obj/item/kirbyplants/random,
/turf/open/floor/iron/dark,
/area/misc/condo)
"rM" = (
/obj/structure/grille/broken,
/obj/effect/decal/cleanable/dirt/dust,
/turf/open/floor/plating,
/area/misc/condo)
"se" = (
/turf/closed/indestructible/fakeglass,
/area/misc/condo)
"sz" = (
/turf/open/floor/plating,
/area/misc/condo)
"tK" = (
/turf/open/floor/iron,
/area/misc/condo)
"va" = (
/turf/open/floor/iron/dark/textured_large,
/area/misc/condo)
"vo" = (
/obj/effect/turf_decal/siding/wideplating_new/dark,
/obj/structure/table/reinforced,
/obj/machinery/recharger{
	pixel_y = 8
	},
/obj/structure/sign/poster/official/do_not_question/directional/north,
/turf/open/floor/iron/dark/textured_large,
/area/misc/condo)
"vr" = (
/obj/effect/turf_decal/tile/red/diagonal_centre,
/obj/structure/chair/office{
	dir = 1
	},
/turf/open/floor/iron/dark/diagonal,
/area/misc/condo)
"xg" = (
/obj/structure/fluff/broken_canister_frame,
/obj/effect/decal/cleanable/dirt/dust,
/turf/open/floor/plating,
/area/misc/condo)
"xt" = (
/obj/effect/decal/cleanable/dirt/dust,
/obj/effect/mapping_helpers/burnt_floor,
/obj/structure/table/wood,
/obj/machinery/light/broken/directional/east,
/turf/open/floor/wood,
/area/misc/condo)
"yB" = (
/obj/effect/turf_decal/siding/wideplating_new{
	dir = 8
	},
/turf/open/floor/iron/dark,
/area/misc/condo)
"zd" = (
/obj/effect/spawner/structure/window/hollow/end{
	dir = 4
	},
/turf/open/floor/plating,
/area/misc/condo)
"Aj" = (
/obj/effect/turf_decal/tile/neutral{
	dir = 1
	},
/turf/open/floor/iron,
/area/misc/condo)
"AB" = (
/obj/effect/turf_decal/siding/wideplating_new/dark{
	dir = 1
	},
/obj/machinery/door/window/brigdoor/right/directional/north,
/turf/open/floor/iron/dark/textured_large,
/area/misc/condo)
"Cg" = (
/obj/item/kirbyplants/random,
/obj/machinery/light/directional/east,
/turf/open/floor/iron/dark/diagonal,
/area/misc/condo)
"Ck" = (
/obj/machinery/computer/old,
/turf/open/floor/iron/dark/diagonal,
/area/misc/condo)
"Cx" = (
/obj/effect/turf_decal/siding/wideplating_new{
	dir = 8
	},
/obj/effect/spawner/random/vending/snackvend,
/obj/effect/spawner/random/vending/snackvend,
/obj/effect/spawner/random/vending/snackvend,
/obj/effect/spawner/random/vending/snackvend,
/turf/open/floor/iron/dark,
/area/misc/condo)
"Cy" = (
/obj/effect/turf_decal/trimline/dark/filled/line,
/obj/effect/turf_decal/trimline/dark/filled/mid_joiner,
/obj/effect/turf_decal/trimline/dark/filled/mid_joiner{
	pixel_x = 16
	},
/obj/effect/turf_decal/tile/neutral{
	dir = 1
	},
/turf/open/floor/iron,
/area/misc/condo)
"CK" = (
/obj/structure/tank_holder,
/turf/open/floor/plating,
/area/misc/condo)
"CU" = (
/obj/effect/turf_decal/siding/wideplating_new{
	dir = 8
	},
/obj/effect/turf_decal/siding/wideplating_new{
	dir = 4
	},
/obj/machinery/door/airlock/maintenance_hatch{
	dir = 4
	},
/obj/effect/mapping_helpers/airlock/cyclelink_helper{
	dir = 8
	},
/turf/open/floor/iron/smooth_large,
/area/misc/condo)
"Dp" = (
/obj/effect/turf_decal/trimline/dark/filled/line,
/obj/effect/turf_decal/trimline/dark/filled/mid_joiner,
/obj/effect/turf_decal/trimline/dark/filled/mid_joiner{
	pixel_x = 16
	},
/obj/effect/turf_decal/tile/neutral{
	dir = 4
	},
/turf/open/floor/iron,
/area/misc/condo)
"DC" = (
/turf/closed/indestructible/normal_wall,
/area/misc/condo)
"EC" = (
/obj/structure/bed/double,
/obj/item/bedsheet/grey/double,
/turf/open/floor/iron/dark/textured_large,
/area/misc/condo)
"ED" = (
/obj/effect/turf_decal/siding/wideplating_new{
	dir = 8
	},
/obj/structure/disposalpipe/trunk{
	dir = 8
	},
/obj/machinery/disposal/bin,
/turf/open/floor/iron/dark,
/area/misc/condo)
"FG" = (
/obj/effect/turf_decal/siding/wideplating_new/dark,
/obj/structure/table/reinforced,
/obj/item/folder/red{
	pixel_y = 8
	},
/obj/item/pen/red{
	pixel_y = 8
	},
/turf/open/floor/iron/dark/textured_large,
/area/misc/condo)
"Gv" = (
/obj/effect/decal/cleanable/dirt/dust,
/obj/machinery/light/small/directional/north,
/turf/open/floor/plating,
/area/misc/condo)
"Hw" = (
/obj/effect/mapping_helpers/broken_floor,
/obj/structure/table/wood,
/turf/open/floor/wood,
/area/misc/condo)
"HR" = (
/obj/effect/decal/cleanable/dirt/dust,
/obj/effect/mapping_helpers/burnt_floor,
/turf/open/floor/wood,
/area/misc/condo)
"IM" = (
/obj/effect/turf_decal/siding/wideplating_new{
	dir = 8
	},
/obj/effect/turf_decal/siding/wideplating_new{
	dir = 4
	},
/obj/machinery/door/airlock/maintenance_hatch{
	dir = 4
	},
/turf/open/floor/iron/smooth_large,
/area/misc/condo)
"JA" = (
/obj/effect/turf_decal/trimline/dark/filled/line,
/obj/effect/turf_decal/trimline/dark/filled/mid_joiner,
/obj/effect/turf_decal/trimline/dark/filled/mid_joiner{
	pixel_x = 16
	},
/turf/open/floor/iron,
/area/misc/condo)
"KO" = (
/obj/effect/turf_decal/tile/red/diagonal_centre,
/obj/structure/reagent_dispensers/water_cooler,
/turf/open/floor/iron/dark/diagonal,
/area/misc/condo)
"Lj" = (
/obj/effect/turf_decal/siding/wideplating_new{
	dir = 8
	},
/obj/effect/turf_decal/siding/wideplating_new{
	dir = 4
	},
/obj/structure/fluff/fake_firedoor{
	dir = 8
	},
/turf/open/floor/iron/smooth_large,
/area/misc/condo)
"LD" = (
/obj/effect/turf_decal/tile/neutral/fourcorners,
/obj/structure/fluff/fake_vent,
/turf/open/floor/iron,
/area/misc/condo)
"Mu" = (
/obj/effect/turf_decal/trimline/dark/filled/line{
	dir = 1
	},
/obj/effect/turf_decal/trimline/dark/filled/mid_joiner{
	dir = 1
	},
/obj/effect/turf_decal/trimline/dark/filled/mid_joiner{
	dir = 1;
	pixel_x = 16
	},
/turf/open/floor/iron,
/area/misc/condo)
"Mv" = (
/obj/effect/decal/cleanable/dirt/dust,
/obj/effect/mapping_helpers/broken_floor,
/obj/structure/closet/secure_closet/personal/cabinet,
/turf/open/floor/wood,
/area/misc/condo)
"Nd" = (
/turf/open/space/bluespace,
/area/misc/condo)
"OU" = (
/obj/effect/decal/cleanable/dirt/dust,
/obj/structure/sign/poster/contraband/grey_tide/directional/north,
/obj/structure/closet/crate/preopen,
/turf/open/floor/plating,
/area/misc/condo)
"PU" = (
/obj/effect/turf_decal/siding/wideplating_new/dark{
	dir = 1
	},
/obj/structure/window/reinforced/spawner/directional/north,
/obj/structure/table,
/turf/open/floor/iron/dark/textured_large,
/area/misc/condo)
"QI" = (
/obj/machinery/door/airlock/maintenance{
	dir = 4
	},
/obj/effect/turf_decal/siding/wideplating_new{
	dir = 4
	},
/obj/effect/turf_decal/siding/wideplating_new{
	dir = 8
	},
/turf/open/floor/iron/smooth_large,
/area/misc/condo)
"Sd" = (
/obj/machinery/space_heater,
/obj/effect/decal/cleanable/dirt/dust,
/turf/open/floor/plating,
/area/misc/condo)
"SH" = (
/obj/structure/girder,
/turf/open/floor/plating,
/area/misc/condo)
"Tl" = (
/obj/effect/turf_decal/tile/red/diagonal_centre,
/turf/open/floor/iron/dark/diagonal,
/area/misc/condo)
"TH" = (
/obj/effect/turf_decal/tile/neutral{
	dir = 4
	},
/turf/open/floor/iron,
/area/misc/condo)
"Ub" = (
/obj/effect/turf_decal/tile/neutral{
	dir = 1
	},
/obj/machinery/light/directional/west,
/turf/open/floor/iron,
/area/misc/condo)
"Ud" = (
/obj/structure/bed/maint,
/obj/effect/decal/cleanable/dirt/dust,
/turf/open/floor/plating,
/area/misc/condo)
"Uw" = (
/turf/open/floor/iron/dark/diagonal,
/area/misc/condo)
"Vc" = (
/obj/structure/table,
/obj/effect/decal/cleanable/dirt/dust,
/turf/open/floor/plating,
/area/misc/condo)
"Vk" = (
/obj/effect/turf_decal/tile/neutral{
	dir = 4
	},
/obj/structure/sign/directions/arrival/directional/east{
	dir = 2
	},
/turf/open/floor/iron,
/area/misc/condo)
"Xt" = (
/obj/effect/turf_decal/siding/wideplating_new/dark,
/obj/structure/closet/secure_closet/personal,
/turf/open/floor/iron/dark/textured_large,
/area/misc/condo)

(1,1,1) = {"
DC
DC
DC
DC
DC
DC
DC
DC
DC
DC
DC
DC
DC
DC
aJ
"}
(2,1,1) = {"
oM
oo
Aj
Aj
Aj
Ub
Aj
Aj
Aj
Aj
Aj
Aj
Aj
oo
Cy
"}
(3,1,1) = {"
Mu
oo
tK
LD
rn
rn
tK
rn
tK
rn
rn
gL
tK
oo
JA
"}
(4,1,1) = {"
pw
oo
TH
TH
TH
TH
TH
Vk
TH
TH
fc
TH
TH
oo
Dp
"}
(5,1,1) = {"
DC
DC
gM
DC
se
ox
se
DC
Cx
re
ED
yB
rJ
DC
DC
"}
(6,1,1) = {"
DC
vo
Uw
Tl
Ck
vr
nI
DC
DC
DC
DC
IM
DC
DC
jr
"}
(7,1,1) = {"
DC
FG
eS
Uw
dA
Uw
AB
va
DC
Nd
DC
ef
CK
DC
DC
"}
(8,1,1) = {"
DC
Xt
Uw
Tl
Cg
KO
PU
EC
DC
Nd
se
oE
oE
sz
DC
"}
(9,1,1) = {"
DC
DC
CU
DC
DC
DC
DC
DC
DC
Nd
DC
bK
oq
Sd
DC
"}
(10,1,1) = {"
jr
mb
oE
sz
zd
xg
oE
oq
DC
DC
DC
Lj
DC
DC
DC
"}
(11,1,1) = {"
jr
DC
DC
kQ
oE
oE
sz
oE
sz
SH
oP
oE
DC
jr
jr
"}
(12,1,1) = {"
jr
jr
DC
DC
DC
QI
DC
DC
sz
rM
sz
oE
DC
jr
jr
"}
(13,1,1) = {"
jr
jr
jr
jr
DC
sz
Vc
DC
DC
DC
QI
DC
DC
jr
jr
"}
(14,1,1) = {"
jr
jr
jr
jr
DC
Gv
sz
oE
DC
fM
pP
HR
DC
jr
jr
"}
(15,1,1) = {"
jr
jr
jr
jr
DC
OU
oE
Ud
DC
Hw
xt
Mv
DC
jr
jr
"}
(16,1,1) = {"
jr
jr
jr
jr
DC
DC
DC
DC
DC
DC
DC
DC
DC
jr
jr
"}
