//MAP CONVERTED BY dmm2tgm.py THIS HEADER COMMENT PREVENTS RECONVERSION, DO NOT REMOVE
"ar" = (
/obj/effect/turf_decal/tile/neutral{
	dir = 8
	},
/turf/open/floor/iron,
/area/misc/condo)
"aC" = (
/obj/structure/table,
/obj/item/mop/advanced,
/obj/effect/decal/cleanable/dirt,
/turf/open/floor/iron,
/area/misc/condo)
"aS" = (
/obj/structure/chair/stool/bar/directional/north,
/obj/effect/turf_decal/siding/wood{
	dir = 1
	},
/obj/effect/decal/cleanable/dirt,
/turf/open/floor/wood,
/area/misc/condo)
"bw" = (
/obj/structure/chair/wood{
	dir = 4
	},
/obj/effect/mapping_helpers/broken_floor,
/obj/effect/decal/cleanable/dirt,
/turf/open/floor/wood/parquet,
/area/misc/condo)
"bz" = (
/obj/structure/cable,
/obj/machinery/atmospherics/pipe/smart/manifold4w/supply/hidden/layer4,
/obj/machinery/atmospherics/pipe/smart/manifold4w/scrubbers/hidden/layer2,
/turf/open/floor/plating,
/area/misc/condo)
"cy" = (
/obj/effect/mapping_helpers/broken_floor,
/turf/open/floor/wood,
/area/misc/condo)
"cz" = (
/obj/structure/chair/wood{
	dir = 8
	},
/turf/open/floor/wood,
/area/misc/condo)
"cD" = (
/obj/structure/sink/kitchen{
	desc = "A sink used for washing one's hands and face. It looks rusty and home-made";
	name = "old sink";
	pixel_y = 23
	},
/obj/structure/mop_bucket,
/obj/effect/decal/cleanable/dirt,
/turf/open/floor/iron,
/area/misc/condo)
"dw" = (
/obj/structure/disposalpipe/segment{
	dir = 9
	},
/obj/effect/turf_decal/tile/neutral,
/turf/open/floor/iron,
/area/misc/condo)
"dS" = (
/obj/structure/closet/firecloset,
/turf/open/floor/plating,
/area/misc/condo)
"dT" = (
/obj/effect/turf_decal/tile/neutral/fourcorners,
/turf/open/floor/iron,
/area/misc/condo)
"eO" = (
/obj/structure/steam_vent,
/obj/structure/cable,
/obj/machinery/atmospherics/pipe/smart/manifold4w/supply/hidden/layer4,
/obj/machinery/atmospherics/pipe/smart/manifold4w/scrubbers/hidden/layer2,
/obj/effect/decal/cleanable/dirt,
/turf/open/floor/plating,
/area/misc/condo)
"fa" = (
/obj/structure/chair/wood{
	dir = 4
	},
/obj/effect/decal/cleanable/dirt,
/turf/open/floor/wood,
/area/misc/condo)
"fi" = (
/obj/structure/cable,
/obj/machinery/atmospherics/pipe/smart/manifold4w/supply/hidden/layer4,
/obj/machinery/atmospherics/pipe/smart/manifold4w/scrubbers/hidden/layer2,
/obj/effect/turf_decal/tile/neutral,
/turf/open/floor/iron,
/area/misc/condo)
"gQ" = (
/obj/effect/decal/cleanable/dirt,
/turf/open/floor/iron,
/area/misc/condo)
"ho" = (
/obj/structure/table/wood/fancy,
/obj/item/pizzabox/infinite,
/turf/open/floor/wood,
/area/misc/condo)
"ik" = (
/obj/structure/closet/wardrobe/botanist,
/obj/effect/decal/cleanable/dirt,
/turf/open/floor/plating,
/area/misc/condo)
"iL" = (
/obj/effect/turf_decal/siding/wood,
/obj/effect/decal/cleanable/dirt/dust,
/turf/open/floor/wood,
/area/misc/condo)
"jr" = (
/obj/effect/turf_decal/tile/neutral,
/turf/open/floor/iron,
/area/misc/condo)
"jx" = (
/obj/structure/disposalpipe/segment{
	dir = 5
	},
/obj/effect/turf_decal/tile/neutral/fourcorners,
/turf/open/floor/iron,
/area/misc/condo)
"jT" = (
/obj/machinery/door/firedoor,
/obj/effect/turf_decal/stripes/line,
/obj/effect/turf_decal/stripes/line{
	dir = 1
	},
/obj/effect/turf_decal/caution/stand_clear,
/turf/open/floor/iron,
/area/misc/condo)
"kh" = (
/obj/structure/table/wood/poker,
/obj/effect/decal/cleanable/dirt/dust,
/turf/open/floor/wood/parquet,
/area/misc/condo)
"kD" = (
/obj/structure/table/wood,
/obj/effect/decal/cleanable/dirt,
/turf/open/floor/wood,
/area/misc/condo)
"kS" = (
/obj/effect/decal/cleanable/dirt/dust,
/turf/open/floor/wood,
/area/misc/condo)
"kW" = (
/obj/machinery/chem_dispenser/drinks/beer/fullupgrade,
/obj/structure/table/wood/poker,
/obj/effect/mapping_helpers/broken_floor,
/obj/machinery/light/small/directional/north,
/turf/open/floor/wood/parquet,
/area/misc/condo)
"lU" = (
/obj/machinery/door/airlock/maintenance_hatch{
	name = "Maintenance Hatch"
	},
/obj/structure/cable,
/obj/machinery/atmospherics/pipe/smart/manifold4w/supply/hidden/layer4,
/obj/machinery/atmospherics/pipe/smart/manifold4w/scrubbers/hidden/layer2,
/turf/open/floor/plating,
/area/misc/condo)
"lY" = (
/obj/machinery/disposal/bin,
/obj/structure/disposalpipe/trunk{
	dir = 8
	},
/obj/effect/turf_decal/tile/dark/full,
/turf/open/floor/iron/large,
/area/misc/condo)
"md" = (
/obj/structure/table/wood/poker,
/obj/item/storage/box/drinkingglasses,
/obj/effect/decal/cleanable/dirt,
/turf/open/floor/wood/parquet,
/area/misc/condo)
"mK" = (
/obj/structure/reagent_dispensers/watertank,
/obj/effect/decal/cleanable/dirt,
/turf/open/floor/iron,
/area/misc/condo)
"nA" = (
/obj/structure/cable,
/obj/machinery/atmospherics/pipe/smart/manifold4w/supply/hidden/layer4,
/obj/machinery/atmospherics/pipe/smart/manifold4w/scrubbers/hidden/layer2,
/turf/closed/indestructible/steel,
/area/misc/condo)
"oZ" = (
/turf/closed/indestructible/steel,
/area/misc/condo)
"pm" = (
/obj/structure/cable,
/obj/machinery/atmospherics/pipe/smart/manifold4w/supply/hidden/layer4,
/obj/machinery/atmospherics/pipe/smart/manifold4w/scrubbers/hidden/layer2,
/obj/machinery/light/small/broken/directional/north,
/turf/open/floor/plating,
/area/misc/condo)
"pv" = (
/obj/effect/turf_decal/siding/wood,
/obj/effect/decal/cleanable/dirt,
/turf/open/floor/wood,
/area/misc/condo)
"pD" = (
/obj/effect/decal/cleanable/dirt,
/obj/effect/decal/cleanable/blood/old,
/turf/open/floor/wood/parquet,
/area/misc/condo)
"qn" = (
/obj/structure/table/wood,
/turf/open/floor/wood,
/area/misc/condo)
"st" = (
/obj/structure/grille/broken,
/obj/structure/cable,
/obj/machinery/atmospherics/pipe/smart/manifold4w/supply/hidden/layer4,
/obj/machinery/atmospherics/pipe/smart/manifold4w/scrubbers/hidden/layer2,
/obj/effect/decal/cleanable/dirt,
/turf/open/floor/plating,
/area/misc/condo)
"tZ" = (
/obj/effect/decal/cleanable/dirt,
/obj/effect/decal/cleanable/blood/old,
/obj/effect/decal/cleanable/vomit/old,
/obj/structure/toilet{
	dir = 8
	},
/turf/open/floor/iron,
/area/misc/condo)
"uX" = (
/obj/structure/table/wood/poker,
/obj/item/stack/spacecash/c1000,
/turf/open/floor/wood,
/area/misc/condo)
"wb" = (
/obj/structure/chair/wood{
	dir = 8
	},
/turf/open/floor/wood/parquet,
/area/misc/condo)
"wl" = (
/obj/machinery/vending/cigarette/beach,
/obj/effect/turf_decal/tile/dark/full,
/obj/machinery/light/warm/directional/east,
/turf/open/floor/iron/large,
/area/misc/condo)
"wu" = (
/obj/structure/rack,
/obj/item/crowbar,
/obj/effect/decal/cleanable/dirt,
/turf/open/floor/plating,
/area/misc/condo)
"wS" = (
/obj/structure/chair/sofa/left/brown,
/obj/effect/decal/cleanable/dirt,
/turf/open/floor/wood,
/area/misc/condo)
"xT" = (
/obj/structure/table/wood/poker,
/obj/item/stack/spacecash/c1000,
/turf/open/floor/wood/parquet,
/area/misc/condo)
"zA" = (
/obj/structure/table,
/obj/item/soap/deluxe,
/obj/effect/decal/cleanable/dirt,
/obj/item/storage/box/lights/mixed,
/turf/open/floor/iron,
/area/misc/condo)
"zY" = (
/obj/machinery/door/firedoor,
/obj/effect/turf_decal/stripes/line,
/obj/effect/turf_decal/stripes/line{
	dir = 1
	},
/obj/effect/turf_decal/caution/stand_clear{
	dir = 1
	},
/turf/open/floor/iron,
/area/misc/condo)
"Ae" = (
/obj/structure/table/wood,
/turf/open/floor/wood/parquet,
/area/misc/condo)
"AE" = (
/obj/structure/closet/wardrobe/botanist,
/obj/item/weldingtool/advanced,
/obj/item/wrench,
/obj/item/screwdriver,
/turf/open/floor/plating,
/area/misc/condo)
"AO" = (
/obj/effect/mapping_helpers/broken_floor,
/obj/effect/decal/cleanable/dirt,
/obj/machinery/light/small/broken/directional/east,
/turf/open/floor/wood,
/area/misc/condo)
"BF" = (
/obj/effect/decal/cleanable/dirt,
/obj/machinery/light/small/directional/north,
/turf/open/floor/plating,
/area/misc/condo)
"BR" = (
/obj/effect/decal/cleanable/dirt/dust,
/turf/open/floor/wood/parquet,
/area/misc/condo)
"Dc" = (
/turf/open/floor/wood,
/area/misc/condo)
"DR" = (
/obj/structure/chair/stool/bar/directional/north,
/obj/effect/turf_decal/siding/wood{
	dir = 1
	},
/turf/open/floor/wood,
/area/misc/condo)
"DX" = (
/obj/structure/disposalpipe/segment{
	dir = 6
	},
/obj/effect/turf_decal/tile/neutral,
/turf/open/floor/iron,
/area/misc/condo)
"Ea" = (
/obj/item/stack/cable_coil/cut,
/mob/living/basic/mouse,
/obj/machinery/atmospherics/pipe/smart/manifold4w/supply/hidden/layer4,
/obj/machinery/atmospherics/pipe/smart/manifold4w/scrubbers/hidden/layer2,
/obj/effect/decal/cleanable/dirt,
/turf/open/floor/plating,
/area/misc/condo)
"EX" = (
/obj/effect/decal/cleanable/dirt,
/turf/open/floor/wood,
/area/misc/condo)
"Fl" = (
/obj/effect/decal/cleanable/dirt,
/obj/structure/sink/directional/south,
/obj/structure/mirror/broken/directional/north,
/obj/machinery/light/small/dim/directional/west,
/turf/open/floor/iron,
/area/misc/condo)
"FN" = (
/obj/effect/turf_decal/siding/wood,
/obj/effect/decal/cleanable/dirt,
/obj/machinery/light/small/broken/directional/west,
/turf/open/floor/wood,
/area/misc/condo)
"Gv" = (
/obj/machinery/atmospherics/pipe/smart/manifold4w/scrubbers/hidden/layer2,
/obj/machinery/atmospherics/pipe/smart/manifold4w/supply/hidden/layer4,
/turf/closed/indestructible/steel,
/area/misc/condo)
"HL" = (
/obj/structure/table/wood/poker,
/obj/item/stack/spacecash/c10,
/obj/effect/decal/cleanable/dirt,
/turf/open/floor/wood/parquet,
/area/misc/condo)
"HO" = (
/obj/structure/table/wood/poker,
/obj/effect/spawner/random/trash/soap,
/turf/open/floor/wood,
/area/misc/condo)
"Ib" = (
/turf/open/floor/wood/parquet,
/area/misc/condo)
"Ix" = (
/obj/structure/closet/crate,
/obj/item/stack/sheet/iron/fifty,
/obj/item/stack/sheet/mineral/wood/fifty,
/obj/effect/decal/cleanable/dirt,
/turf/open/floor/plating,
/area/misc/condo)
"Je" = (
/obj/effect/turf_decal/tile/neutral,
/obj/machinery/light/warm/directional/east,
/turf/open/floor/iron,
/area/misc/condo)
"JW" = (
/obj/effect/decal/cleanable/dirt,
/obj/machinery/vending/boozeomat,
/turf/open/floor/wood/parquet,
/area/misc/condo)
"LC" = (
/obj/machinery/portable_atmospherics/canister/air,
/turf/open/floor/plating,
/area/misc/condo)
"Mf" = (
/obj/structure/table,
/obj/item/stack/spacecash/c10,
/turf/open/floor/plating,
/area/misc/condo)
"Mj" = (
/obj/structure/closet/crate,
/obj/effect/decal/cleanable/dirt,
/obj/machinery/light/small/directional/west,
/turf/open/floor/plating,
/area/misc/condo)
"Mk" = (
/obj/structure/cable,
/obj/machinery/atmospherics/pipe/smart/manifold4w/supply/hidden/layer4,
/obj/machinery/atmospherics/pipe/smart/manifold4w/scrubbers/hidden/layer2,
/obj/effect/decal/cleanable/dirt,
/turf/open/floor/plating,
/area/misc/condo)
"Mp" = (
/turf/closed/wall/space{
	space_lit = 1
	},
/area/misc/condo)
"MO" = (
/obj/effect/turf_decal/tile/neutral{
	dir = 8
	},
/obj/machinery/light/warm/directional/west,
/turf/open/floor/iron,
/area/misc/condo)
"Np" = (
/obj/structure/chair/sofa/middle/brown,
/obj/effect/decal/cleanable/dirt,
/turf/open/floor/wood,
/area/misc/condo)
"NX" = (
/obj/machinery/door/firedoor,
/obj/effect/turf_decal/stripes/line,
/obj/effect/turf_decal/stripes/line{
	dir = 1
	},
/turf/open/floor/iron,
/area/misc/condo)
"Oh" = (
/turf/closed/indestructible/hoteldoor{
	icon_state = "closed";
	icon = 'modular_skyrat/modules/aesthetics/airlock/icons/airlocks/station2/glass.dmi'
	},
/area/misc/condo)
"Py" = (
/turf/open/floor/plating,
/area/misc/condo)
"PK" = (
/obj/effect/spawner/structure/window/reinforced,
/turf/open/floor/plating,
/area/misc/condo)
"QJ" = (
/obj/machinery/light/small/dim/directional/east,
/turf/open/floor/plating,
/area/misc/condo)
"Rr" = (
/obj/structure/disposalpipe/segment,
/obj/effect/turf_decal/tile/neutral,
/turf/open/floor/iron,
/area/misc/condo)
"RM" = (
/obj/machinery/vending/coffee,
/obj/effect/turf_decal/tile/dark/full,
/turf/open/floor/iron/large,
/area/misc/condo)
"RP" = (
/obj/machinery/chem_dispenser/drinks/fullupgrade,
/obj/structure/table/wood/poker,
/turf/open/floor/wood/parquet,
/area/misc/condo)
"SS" = (
/obj/structure/chair/stool/bar/directional/west,
/obj/effect/decal/cleanable/dirt,
/turf/open/floor/plating,
/area/misc/condo)
"SV" = (
/obj/structure/disposalpipe/trunk,
/obj/effect/turf_decal/tile/neutral/fourcorners,
/turf/open/floor/iron,
/area/misc/condo)
"Tj" = (
/obj/effect/decal/cleanable/dirt,
/turf/open/floor/plating,
/area/misc/condo)
"Tn" = (
/obj/machinery/barsign/all_access{
	dir = 1
	},
/turf/closed/indestructible/steel,
/area/misc/condo)
"Tu" = (
/obj/effect/mapping_helpers/broken_floor,
/obj/effect/turf_decal/siding/wood{
	dir = 8
	},
/obj/machinery/light/small/directional/south,
/turf/open/floor/wood,
/area/misc/condo)
"Ul" = (
/obj/structure/table/wood/poker,
/obj/item/reagent_containers/cup/glass/shaker,
/turf/open/floor/wood/parquet,
/area/misc/condo)
"UU" = (
/obj/structure/closet/emcloset,
/turf/open/floor/plating,
/area/misc/condo)
"Wh" = (
/obj/effect/mapping_helpers/broken_floor,
/obj/effect/decal/cleanable/dirt,
/turf/open/floor/wood/parquet,
/area/misc/condo)
"Wl" = (
/obj/structure/chair/wood{
	dir = 8
	},
/obj/effect/decal/cleanable/dirt,
/turf/open/floor/wood/parquet,
/area/misc/condo)
"Wt" = (
/obj/effect/decal/cleanable/dirt,
/obj/effect/decal/cleanable/dirt/dust,
/turf/open/floor/wood,
/area/misc/condo)
"WI" = (
/obj/machinery/door/airlock/maintenance_hatch{
	name = "Maintenance Hatch"
	},
/turf/open/floor/plating,
/area/misc/condo)
"WN" = (
/obj/structure/rack,
/obj/item/storage/pill_bottle/maintenance_pill/full,
/turf/open/floor/plating,
/area/misc/condo)
"WX" = (
/obj/structure/chair/sofa/right/brown,
/turf/open/floor/wood,
/area/misc/condo)
"YW" = (
/obj/effect/mapping_helpers/broken_floor,
/obj/effect/decal/cleanable/dirt,
/turf/open/floor/plating,
/area/misc/condo)
"Zq" = (
/obj/structure/chair/wood{
	dir = 4
	},
/turf/open/floor/wood/parquet,
/area/misc/condo)

(1,1,1) = {"
oZ
oZ
oZ
oZ
oZ
oZ
oZ
oZ
oZ
oZ
oZ
oZ
oZ
oZ
oZ
"}
(2,1,1) = {"
oZ
Oh
ar
ar
ar
MO
ar
jT
ar
ar
ar
MO
ar
Oh
oZ
"}
(3,1,1) = {"
oZ
Oh
dT
dT
dT
dT
dT
NX
dT
dT
dT
SV
jx
Oh
oZ
"}
(4,1,1) = {"
oZ
Oh
Je
jr
jr
jr
fi
zY
jr
jr
DX
Rr
dw
Oh
oZ
"}
(5,1,1) = {"
oZ
oZ
oZ
oZ
oZ
oZ
lU
oZ
wl
RM
lY
oZ
oZ
oZ
oZ
"}
(6,1,1) = {"
oZ
Mf
Ix
wu
oZ
Mj
eO
oZ
oZ
oZ
oZ
oZ
Dc
HL
oZ
"}
(7,1,1) = {"
oZ
SS
Tj
Py
WI
Tj
bz
LC
oZ
uX
HO
FN
Zq
bw
Tn
"}
(8,1,1) = {"
oZ
BF
Tj
Tj
oZ
Tj
bz
Py
WI
EX
cy
iL
Ae
Ae
oZ
"}
(9,1,1) = {"
oZ
ik
AE
oZ
oZ
Tj
Mk
dS
oZ
cy
fa
pv
Wl
wb
oZ
"}
(10,1,1) = {"
oZ
oZ
oZ
oZ
st
Ea
bz
UU
oZ
YW
qn
Dc
Tu
oZ
oZ
"}
(11,1,1) = {"
oZ
Fl
WI
Mk
Mk
oZ
oZ
oZ
oZ
Wt
cz
WX
kS
PK
Mp
"}
(12,1,1) = {"
oZ
tZ
nA
pm
WN
oZ
Ul
Ib
md
aS
cy
Np
EX
PK
Mp
"}
(13,1,1) = {"
Gv
Gv
Gv
WI
oZ
oZ
RP
Wh
kh
aS
fa
wS
cy
PK
Mp
"}
(14,1,1) = {"
oZ
cD
gQ
Tj
zA
oZ
kW
pD
xT
DR
kD
kS
ho
PK
Mp
"}
(15,1,1) = {"
oZ
mK
QJ
gQ
aC
oZ
JW
BR
Tj
AO
cz
oZ
PK
PK
Mp
"}
(16,1,1) = {"
oZ
oZ
oZ
oZ
oZ
oZ
oZ
oZ
oZ
oZ
oZ
oZ
Mp
Mp
Mp
"}
