//MAP CONVERTED BY dmm2tgm.py THIS HEADER COMMENT PREVENTS RECONVERSION, DO NOT REMOVE
"dk" = (
/obj/structure/secure_safe/directional/north,
/obj/effect/turf_decal/siding/thinplating_new/dark{
	dir = 5
	},
/turf/open/floor/wood/large,
/area/misc/condo)
"et" = (
/obj/structure/table/reinforced/plastitaniumglass,
/obj/item/phone{
	pixel_x = 7;
	pixel_y = -2;
	desc = "Standard red phone, but somehow evil-er";
	name = "BLOOD-red phone"
	},
/obj/item/flashlight/lamp{
	pixel_x = -5;
	pixel_y = 10
	},
/turf/open/floor/carpet/royalblack,
/area/misc/condo)
"eF" = (
/obj/effect/turf_decal/trimline/dark_red/filled/line{
	dir = 8
	},
/turf/open/indestructible/dark/textured,
/area/misc/condo)
"gj" = (
/obj/effect/turf_decal/skyrat_decals/syndicate/bottom/right,
/obj/structure/table/reinforced/plastitaniumglass,
/obj/item/paper_bin{
	pixel_y = 4
	},
/obj/item/pen/fountain{
	pixel_y = 5
	},
/turf/open/floor/mineral/plastitanium/red,
/area/misc/condo)
"gE" = (
/obj/structure/railing/unbreakable,
/turf/open/floor/iron/stairs/right{
	dir = 8
	},
/area/misc/condo)
"gH" = (
/obj/structure/table/reinforced/plastitaniumglass,
/obj/item/folder/syndicate/blue,
/obj/item/pen/edagger,
/obj/item/toy/gun,
/turf/open/floor/carpet/royalblack,
/area/misc/condo)
"gR" = (
/obj/item/kirbyplants/organic/plant22,
/obj/structure/sign/warning/yes_smoking/circle/directional/north,
/obj/effect/turf_decal/trimline/dark_red/filled,
/turf/open/indestructible/dark/textured,
/area/misc/condo)
"hO" = (
/obj/effect/turf_decal/siding/thinplating_new/dark/corner{
	dir = 1
	},
/obj/effect/turf_decal/trimline/dark_red/filled/warning{
	dir = 4
	},
/obj/effect/turf_decal/trimline/neutral/filled/line{
	dir = 4
	},
/turf/open/indestructible/dark/textured,
/area/misc/condo)
"iG" = (
/obj/effect/turf_decal/trimline/dark_red/filled/line{
	dir = 5
	},
/obj/item/kirbyplants/organic/plant22,
/turf/open/indestructible/dark/textured,
/area/misc/condo)
"iN" = (
/obj/effect/turf_decal/siding/thinplating_new/dark{
	dir = 4
	},
/obj/machinery/light/floor,
/turf/open/indestructible/dark/textured,
/area/misc/condo)
"jc" = (
/obj/machinery/light/directional/south,
/turf/open/floor/iron/stairs/right{
	dir = 8
	},
/area/misc/condo)
"jM" = (
/obj/effect/turf_decal/siding/thinplating_new/dark{
	dir = 6
	},
/obj/structure/railing/unbreakable{
	dir = 6
	},
/obj/structure/showcase/cyborg{
	desc = "A stand with the empty body of a Cybersun cyborg bolted to it.";
	dir = 4;
	icon = 'icons/mob/silicon/robots.dmi';
	icon_state = "synd_sec";
	name = "syndicate cyborg showcase";
	pixel_x = -6
	},
/turf/open/floor/mineral/plastitanium/red,
/area/misc/condo)
"jV" = (
/obj/effect/turf_decal/delivery,
/obj/machinery/vending/boozeomat/syndicate,
/turf/open/indestructible/dark/textured{
	icon_state = "engine"
	},
/area/misc/condo)
"kS" = (
/obj/machinery/light/floor,
/turf/open/indestructible/dark/textured,
/area/misc/condo)
"mq" = (
/turf/open/floor/fakespace,
/area/misc/condo)
"my" = (
/obj/effect/turf_decal/trimline/dark_red/filled/line,
/turf/open/indestructible/dark/textured,
/area/misc/condo)
"nj" = (
/obj/structure/railing/unbreakable{
	dir = 1
	},
/turf/open/floor/iron/stairs/left{
	dir = 8
	},
/area/misc/condo)
"nr" = (
/obj/structure/sign/flag/syndicate/directional/east,
/obj/effect/turf_decal/siding/thinplating_new/dark{
	dir = 6
	},
/turf/open/floor/wood/large,
/area/misc/condo)
"nS" = (
/obj/effect/turf_decal/siding/thinplating_new/dark{
	dir = 10
	},
/obj/structure/railing/unbreakable{
	dir = 10
	},
/obj/structure/showcase/cyborg{
	desc = "A stand with the empty body of a Cybersun cyborg bolted to it.";
	dir = 8;
	icon = 'icons/mob/silicon/robots.dmi';
	icon_state = "synd_sec";
	name = "syndicate cyborg showcase";
	pixel_x = 6
	},
/turf/open/floor/mineral/plastitanium/red,
/area/misc/condo)
"nW" = (
/obj/effect/turf_decal/siding/thinplating_new/dark{
	dir = 4
	},
/turf/open/floor/carpet/royalblack,
/area/misc/condo)
"nX" = (
/obj/effect/turf_decal/trimline/dark_red/filled/corner,
/turf/open/indestructible/dark/textured,
/area/misc/condo)
"ou" = (
/obj/effect/turf_decal/trimline/dark_red/filled/line{
	dir = 6
	},
/turf/open/indestructible/dark/textured,
/area/misc/condo)
"qx" = (
/turf/closed/indestructible/fakeglass,
/area/misc/condo)
"qD" = (
/obj/effect/turf_decal/skyrat_decals/syndicate/middle/right,
/obj/structure/table/reinforced/plastitaniumglass,
/obj/machinery{
	icon = 'modular_skyrat/modules/aesthetics/intercom/icons/intercom.dmi';
	icon_state = "intercom";
	name = "Intercom"
	},
/turf/open/floor/mineral/plastitanium/red,
/area/misc/condo)
"qE" = (
/obj/structure/table/reinforced/plastitaniumglass,
/obj/item/storage/fancy/cigarettes/cigars/havana{
	pixel_y = 5;
	pixel_x = 4
	},
/obj/item/lighter/skull{
	pixel_x = -8;
	pixel_y = 1
	},
/turf/open/indestructible/dark/textured,
/area/misc/condo)
"ry" = (
/obj/effect/turf_decal/siding/thinplating_new/dark{
	dir = 9
	},
/obj/structure/railing/unbreakable{
	dir = 9
	},
/obj/structure/showcase/cyborg{
	desc = "A stand with the empty body of a Cybersun cyborg bolted to it.";
	dir = 8;
	icon = 'icons/mob/silicon/robots.dmi';
	icon_state = "synd_sec";
	name = "syndicate cyborg showcase";
	pixel_x = 6
	},
/turf/open/floor/mineral/plastitanium/red,
/area/misc/condo)
"sx" = (
/obj/effect/turf_decal/skyrat_decals/syndicate/top/left,
/obj/structure/table/reinforced/plastitaniumglass,
/obj/item/storage/fancy/cigarettes/cigpack_syndicate{
	pixel_y = 2;
	pixel_x = -6
	},
/obj/item/lighter/skull{
	pixel_x = -5;
	pixel_y = -2
	},
/turf/open/floor/mineral/plastitanium/red,
/area/misc/condo)
"sH" = (
/obj/item/reagent_containers/cup/glass/bottle/vodka/badminka{
	pixel_y = 20
	},
/obj/item/reagent_containers/cup/glass/drinkingglass/shotglass{
	pixel_x = -8;
	pixel_y = 7
	},
/obj/item/reagent_containers/cup/glass/drinkingglass/shotglass{
	pixel_x = 8;
	pixel_y = 7
	},
/obj/item/reagent_containers/cup/glass/drinkingglass/shotglass{
	pixel_y = 2
	},
/obj/structure/table/reinforced/plastitaniumglass,
/turf/open/indestructible/dark/textured,
/area/misc/condo)
"sV" = (
/obj/item/kirbyplants/organic/plant22,
/obj/effect/turf_decal/trimline/dark_red/filled,
/turf/open/indestructible/dark/textured,
/area/misc/condo)
"sW" = (
/obj/effect/turf_decal/siding/thinplating_new/dark,
/obj/structure/chair/comfy/shuttle{
	color = "#474747"
	},
/turf/open/indestructible/dark/textured,
/area/misc/condo)
"tF" = (
/obj/effect/turf_decal/siding/thinplating_new/dark{
	dir = 5
	},
/turf/open/floor/wood/large,
/area/misc/condo)
"vE" = (
/turf/closed/wall/space{
	space_lit = 1
	},
/area/misc/condo)
"vO" = (
/obj/effect/turf_decal/siding/thinplating_new/dark/corner{
	dir = 4
	},
/turf/open/floor/wood/large,
/area/misc/condo)
"vX" = (
/obj/effect/turf_decal/siding/thinplating_new/dark{
	dir = 1
	},
/turf/closed/indestructible/syndicate,
/area/misc/condo)
"wa" = (
/obj/machinery/vending/cigarette/syndicate,
/obj/effect/turf_decal/delivery,
/turf/open/indestructible/dark/textured{
	icon_state = "engine"
	},
/area/misc/condo)
"wg" = (
/obj/effect/turf_decal/siding/thinplating_new/dark{
	dir = 8
	},
/obj/structure/chair/comfy/shuttle{
	color = "#DD2211";
	dir = 8
	},
/turf/open/indestructible/dark/textured,
/area/misc/condo)
"wU" = (
/obj/effect/turf_decal/skyrat_decals/syndicate/top/right,
/obj/structure/table/reinforced/plastitaniumglass,
/obj/item/reagent_containers/cup/glass/coffee/colonial{
	pixel_x = -14;
	pixel_y = 11
	},
/obj/item/paper_bin{
	pixel_y = 4
	},
/obj/item/pen/fountain{
	pixel_y = 5
	},
/turf/open/floor/mineral/plastitanium/red,
/area/misc/condo)
"xb" = (
/turf/closed/indestructible/syndicate,
/area/misc/condo)
"xi" = (
/obj/effect/turf_decal/skyrat_decals/syndicate/middle/left,
/turf/open/floor/mineral/plastitanium/red,
/area/misc/condo)
"xn" = (
/obj/effect/turf_decal/trimline/dark_red/filled/warning{
	dir = 6
	},
/obj/effect/turf_decal/trimline/neutral/filled/line{
	dir = 4
	},
/turf/open/indestructible/dark/textured,
/area/misc/condo)
"xD" = (
/obj/effect/turf_decal/trimline/neutral/filled/line,
/obj/effect/turf_decal/trimline/dark_red/filled/warning,
/turf/open/indestructible/dark/textured,
/area/misc/condo)
"xQ" = (
/obj/effect/turf_decal/trimline/dark_red/filled/line{
	dir = 5
	},
/turf/open/indestructible/dark/textured,
/area/misc/condo)
"yh" = (
/obj/effect/turf_decal/siding/thinplating_new/dark{
	dir = 6
	},
/turf/open/floor/wood/large,
/area/misc/condo)
"yr" = (
/obj/effect/turf_decal/skyrat_decals/syndicate/bottom/left,
/obj/structure/table/reinforced/plastitaniumglass,
/obj/item/folder/red{
	pixel_x = 4;
	pixel_y = 1
	},
/obj/item/pen/fountain{
	pixel_x = 4;
	pixel_y = 1
	},
/obj/item/reagent_containers/cup/glass/coffee/colonial{
	pixel_x = -7;
	pixel_y = 3
	},
/turf/open/floor/mineral/plastitanium/red,
/area/misc/condo)
"yG" = (
/obj/effect/turf_decal/skyrat_decals/syndicate/top/middle,
/obj/structure/table/reinforced/plastitaniumglass,
/obj/item/storage/fancy/cigarettes/cigars/havana{
	pixel_y = 5;
	pixel_x = 4
	},
/turf/open/floor/mineral/plastitanium/red,
/area/misc/condo)
"BE" = (
/obj/effect/turf_decal/siding/thinplating_new/dark{
	dir = 8
	},
/obj/structure/railing/unbreakable{
	dir = 8
	},
/obj/structure/showcase/mecha/marauder{
	icon_state = "darkgygax"
	},
/turf/open/floor/mineral/plastitanium/red,
/area/misc/condo)
"Dc" = (
/obj/effect/turf_decal/trimline/dark_red/filled/line{
	dir = 1
	},
/turf/open/indestructible/dark/textured,
/area/misc/condo)
"EM" = (
/obj/effect/turf_decal/siding/thinplating_new/dark/corner{
	dir = 8
	},
/obj/effect/turf_decal/trimline/dark_red/filled/warning{
	dir = 4
	},
/obj/effect/turf_decal/trimline/neutral/filled/line{
	dir = 4
	},
/turf/open/indestructible/dark/textured,
/area/misc/condo)
"FL" = (
/obj/item/kirbyplants/organic/plant21,
/obj/effect/turf_decal/trimline/dark_red/filled/line{
	dir = 8
	},
/turf/open/indestructible/dark/textured,
/area/misc/condo)
"GJ" = (
/obj/effect/turf_decal/trimline/dark_red/filled/line{
	dir = 9
	},
/obj/machinery/light/directional/north,
/obj/machinery/recharge_station,
/turf/open/indestructible/dark/textured,
/area/misc/condo)
"Hc" = (
/obj/effect/turf_decal/siding/thinplating_new/dark/corner,
/turf/open/floor/wood/large,
/area/misc/condo)
"Hd" = (
/obj/effect/turf_decal/trimline/dark_red/filled/corner{
	dir = 8
	},
/turf/open/indestructible/dark/textured,
/area/misc/condo)
"Hf" = (
/obj/effect/turf_decal/siding/thinplating_new/dark{
	dir = 8
	},
/obj/structure/railing/unbreakable{
	dir = 8
	},
/turf/open/floor/wood/large,
/area/misc/condo)
"Hq" = (
/obj/effect/turf_decal/trimline/dark_red/filled/line{
	dir = 9
	},
/turf/open/indestructible/dark/textured,
/area/misc/condo)
"Hw" = (
/obj/effect/turf_decal/trimline/dark_red/filled/warning{
	dir = 5
	},
/obj/effect/turf_decal/trimline/neutral/filled/line{
	dir = 4
	},
/turf/open/indestructible/dark/textured,
/area/misc/condo)
"HD" = (
/obj/effect/turf_decal/siding/thinplating_new/dark/corner,
/turf/open/indestructible/dark/textured,
/area/misc/condo)
"HI" = (
/turf/closed/indestructible/hoteldoor/fakedoor,
/area/misc/condo)
"HW" = (
/obj/effect/turf_decal/trimline/dark_red/filled/line{
	dir = 4
	},
/turf/open/indestructible/dark/textured,
/area/misc/condo)
"IK" = (
/turf/open/indestructible/dark/textured,
/area/misc/condo)
"Lb" = (
/obj/structure/railing/corner/end/flip{
	dir = 8
	},
/obj/effect/turf_decal/trimline/dark_red/filled/line{
	dir = 8
	},
/turf/open/indestructible/dark/textured,
/area/misc/condo)
"Mk" = (
/obj/effect/turf_decal/delivery,
/obj/machinery/suit_storage_unit,
/turf/open/indestructible/dark/textured{
	icon_state = "engine"
	},
/area/misc/condo)
"Mw" = (
/turf/open/floor/carpet/black,
/area/misc/condo)
"MC" = (
/obj/structure/table/reinforced/plastitaniumglass,
/obj/item/stamp{
	pixel_x = 9;
	pixel_y = 11
	},
/obj/item/stamp/denied{
	pixel_x = 9;
	pixel_y = 7
	},
/obj/item/paper_bin{
	pixel_y = 6;
	pixel_x = -4
	},
/turf/open/floor/carpet/royalblack,
/area/misc/condo)
"MJ" = (
/obj/machinery/vending/wardrobe/syndie_wardrobe/ghost_cafe,
/obj/effect/turf_decal/delivery,
/turf/open/indestructible/dark/textured{
	icon_state = "engine"
	},
/area/misc/condo)
"No" = (
/obj/effect/turf_decal/trimline/dark_red/filled/line{
	dir = 6
	},
/obj/item/kirbyplants/organic/plant22,
/turf/open/indestructible/dark/textured,
/area/misc/condo)
"NS" = (
/obj/structure/chair/comfy{
	color = "#DD2211";
	dir = 8
	},
/obj/effect/turf_decal/siding/thinplating_new/dark{
	dir = 4
	},
/turf/open/floor/carpet/royalblack,
/area/misc/condo)
"OS" = (
/obj/effect/turf_decal/siding/thinplating_new/dark{
	dir = 4
	},
/obj/structure/railing/unbreakable{
	dir = 4
	},
/obj/structure/showcase/mecha/ripley{
	icon_state = "mauler"
	},
/turf/open/floor/mineral/plastitanium/red,
/area/misc/condo)
"Qg" = (
/obj/effect/turf_decal/skyrat_decals/syndicate/middle/middle,
/turf/open/floor/mineral/plastitanium/red,
/area/misc/condo)
"QG" = (
/obj/effect/turf_decal/siding/thinplating_new/dark{
	dir = 8
	},
/obj/structure/railing/unbreakable{
	dir = 8
	},
/obj/structure/showcase/mecha/ripley{
	icon_state = "mauler"
	},
/turf/open/floor/mineral/plastitanium/red,
/area/misc/condo)
"QH" = (
/obj/effect/turf_decal/trimline/dark_red/filled/corner{
	dir = 1
	},
/turf/open/indestructible/dark/textured,
/area/misc/condo)
"Rb" = (
/obj/effect/turf_decal/siding/thinplating_new/dark{
	dir = 5
	},
/obj/structure/railing/unbreakable{
	dir = 5
	},
/obj/structure/showcase/cyborg{
	desc = "A stand with the empty body of a Cybersun cyborg bolted to it.";
	dir = 4;
	icon = 'icons/mob/silicon/robots.dmi';
	icon_state = "synd_sec";
	name = "syndicate cyborg showcase";
	pixel_x = -6
	},
/turf/open/floor/mineral/plastitanium/red,
/area/misc/condo)
"Rv" = (
/obj/structure/railing/corner/end/unbreakable{
	dir = 8
	},
/obj/effect/turf_decal/trimline/dark_red/filled/line{
	dir = 8
	},
/turf/open/indestructible/dark/textured,
/area/misc/condo)
"RJ" = (
/obj/effect/turf_decal/siding/thinplating_new/dark{
	dir = 8
	},
/obj/effect/turf_decal/trimline/dark_red/filled/corner,
/obj/machinery/light/floor,
/turf/open/indestructible/dark/textured,
/area/misc/condo)
"Sb" = (
/obj/machinery/light/directional/north,
/turf/open/floor/iron/stairs/left{
	dir = 8
	},
/area/misc/condo)
"Sd" = (
/obj/effect/turf_decal/siding/thinplating_new/dark{
	dir = 1
	},
/obj/structure/chair/comfy/shuttle{
	color = "#474747";
	dir = 1
	},
/turf/open/indestructible/dark/textured,
/area/misc/condo)
"Sk" = (
/obj/effect/turf_decal/siding/thinplating_new/dark{
	dir = 8
	},
/obj/effect/turf_decal/trimline/dark_red/filled/corner{
	dir = 4
	},
/obj/machinery/light/floor,
/turf/open/indestructible/dark/textured,
/area/misc/condo)
"Su" = (
/obj/effect/turf_decal/siding/thinplating_new/dark/corner{
	dir = 1
	},
/obj/structure/railing/corner{
	dir = 1
	},
/turf/open/floor/wood/large,
/area/misc/condo)
"SJ" = (
/obj/effect/turf_decal/trimline/dark_red/filled/corner{
	dir = 4
	},
/turf/open/indestructible/dark/textured,
/area/misc/condo)
"TM" = (
/obj/effect/turf_decal/trimline/dark_red/filled/line{
	dir = 10
	},
/obj/machinery/light/directional/south,
/obj/item/kirbyplants/organic/plant24,
/turf/open/indestructible/dark/textured,
/area/misc/condo)
"TN" = (
/obj/effect/turf_decal/siding/thinplating_new/dark,
/turf/open/floor/wood/large,
/area/misc/condo)
"TY" = (
/obj/effect/turf_decal/siding/thinplating_new/dark{
	dir = 4
	},
/turf/open/indestructible/dark/textured,
/area/misc/condo)
"Vp" = (
/obj/effect/turf_decal/siding/thinplating_new/dark/corner{
	dir = 8
	},
/obj/structure/railing/corner{
	dir = 8
	},
/turf/open/floor/wood/large,
/area/misc/condo)
"Vz" = (
/obj/structure/railing/corner/end/unbreakable{
	dir = 4
	},
/turf/open/floor/carpet/black,
/area/misc/condo)
"VU" = (
/turf/open/floor/iron/stairs/medium{
	dir = 8
	},
/area/misc/condo)
"WP" = (
/obj/effect/turf_decal/siding/thinplating_new/dark{
	dir = 4
	},
/obj/structure/railing/unbreakable{
	dir = 4
	},
/obj/structure/showcase/mecha/marauder{
	icon_state = "darkgygax"
	},
/turf/open/floor/mineral/plastitanium/red,
/area/misc/condo)
"Xp" = (
/obj/effect/turf_decal/skyrat_decals/syndicate/bottom/middle,
/obj/structure/table/reinforced/plastitaniumglass,
/obj/item/sign/flag/syndicate{
	pixel_y = 3
	},
/turf/open/floor/mineral/plastitanium/red,
/area/misc/condo)
"Xu" = (
/obj/structure/railing/corner/end/flip{
	dir = 4
	},
/turf/open/floor/carpet/black,
/area/misc/condo)
"Xv" = (
/obj/effect/turf_decal/siding/thinplating_new/dark{
	dir = 1
	},
/turf/open/floor/wood/large,
/area/misc/condo)
"Yv" = (
/obj/effect/turf_decal/trimline/dark_red/filled/line{
	dir = 10
	},
/turf/open/indestructible/dark/textured,
/area/misc/condo)
"YG" = (
/obj/item/kirbyplants/organic/plant24,
/obj/effect/turf_decal/trimline/dark_red/filled/line{
	dir = 8
	},
/turf/open/indestructible/dark/textured,
/area/misc/condo)
"Zv" = (
/obj/effect/turf_decal/siding/thinplating_new/dark/corner{
	dir = 4
	},
/turf/open/indestructible/dark/textured,
/area/misc/condo)
"ZW" = (
/obj/effect/turf_decal/trimline/neutral/filled/line{
	dir = 1
	},
/obj/effect/turf_decal/trimline/dark_red/filled/warning{
	dir = 1
	},
/turf/open/indestructible/dark/textured,
/area/misc/condo)

(1,1,1) = {"
vE
vE
vE
vE
xb
xb
qx
HI
qx
xb
xb
vE
vE
vE
vE
"}
(2,1,1) = {"
vE
mq
mq
mq
xb
gR
Xu
Mw
Vz
sV
xb
mq
mq
mq
vE
"}
(3,1,1) = {"
vE
mq
xb
xb
xb
qx
nj
VU
gE
qx
xb
xb
mq
mq
vE
"}
(4,1,1) = {"
vE
xb
xb
xb
GJ
FL
Rv
eF
Lb
YG
TM
vX
xb
xb
vE
"}
(5,1,1) = {"
vE
xb
WP
jM
Dc
HD
TY
iN
TY
Zv
my
Rb
OS
xb
vE
"}
(6,1,1) = {"
vE
xb
Hq
eF
QH
sW
sx
xi
yr
Sd
Hd
eF
Yv
xb
vE
"}
(7,1,1) = {"
vE
HI
ZW
kS
IK
sW
yG
Qg
Xp
Sd
IK
kS
xD
HI
vE
"}
(8,1,1) = {"
vE
xb
xQ
HW
SJ
sW
wU
qD
gj
Sd
nX
HW
ou
xb
vE
"}
(9,1,1) = {"
vE
xb
QG
nS
Hw
EM
Sk
wg
RJ
hO
xn
ry
BE
xb
vE
"}
(10,1,1) = {"
vE
xb
xb
xb
Sb
gE
iG
HW
No
nj
jc
xb
xb
xb
vE
"}
(11,1,1) = {"
vE
mq
xb
wa
Xv
Vp
Hf
Hf
Hf
Su
TN
MJ
xb
mq
vE
"}
(12,1,1) = {"
vE
mq
xb
jV
tF
vO
et
gH
MC
Hc
nr
Mk
xb
mq
vE
"}
(13,1,1) = {"
vE
mq
xb
xb
xb
dk
nW
NS
nW
yh
xb
xb
xb
mq
vE
"}
(14,1,1) = {"
vE
mq
mq
mq
qx
qx
sH
IK
qE
qx
qx
mq
mq
mq
vE
"}
(15,1,1) = {"
vE
mq
mq
mq
mq
qx
qx
qx
qx
qx
mq
mq
mq
mq
vE
"}
(16,1,1) = {"
vE
vE
vE
vE
vE
vE
vE
vE
vE
vE
vE
vE
vE
vE
vE
"}
