//MAP CONVERTED BY dmm2tgm.py THIS HEADER COMMENT PREVENTS RECONVERSION, DO NOT REMOVE
"aC" = (
/turf/open/floor/iron/dark,
/area/misc/hilbertshotel)
"cy" = (
/turf/open/floor/iron/goonplaque,
/area/misc/hilbertshotel)
"jT" = (
/turf/open/floor/iron,
/area/misc/hilbertshotel)
"FN" = (
/turf/open/space/bluespace,
/area/misc/hilbertshotel)
"SS" = (
/turf/closed/indestructible/hoteldoor{
	icon_state = "door_closed";
	icon = 'icons/obj/doors/puzzledoor/default.dmi'
	},
/area/misc/hilbertshotel)

(1,1,1) = {"
FN
FN
FN
FN
FN
FN
FN
FN
FN
FN
FN
FN
FN
FN
FN
"}
(2,1,1) = {"
FN
aC
aC
aC
aC
aC
SS
aC
aC
aC
aC
aC
aC
aC
FN
"}
(3,1,1) = {"
FN
aC
jT
jT
jT
jT
cy
jT
jT
jT
jT
jT
jT
aC
FN
"}
(4,1,1) = {"
FN
aC
jT
jT
jT
jT
jT
jT
jT
jT
jT
jT
jT
aC
FN
"}
(5,1,1) = {"
FN
aC
jT
jT
jT
jT
jT
jT
jT
jT
jT
jT
jT
aC
FN
"}
(6,1,1) = {"
FN
aC
jT
jT
jT
jT
jT
jT
jT
jT
jT
jT
jT
aC
FN
"}
(7,1,1) = {"
FN
aC
jT
jT
jT
jT
jT
jT
jT
jT
jT
jT
jT
aC
FN
"}
(8,1,1) = {"
FN
aC
jT
jT
jT
jT
jT
jT
jT
jT
jT
jT
jT
aC
FN
"}
(9,1,1) = {"
FN
aC
jT
jT
jT
jT
jT
jT
jT
jT
jT
jT
jT
aC
FN
"}
(10,1,1) = {"
FN
aC
jT
jT
jT
jT
jT
jT
jT
jT
jT
jT
jT
aC
FN
"}
(11,1,1) = {"
FN
aC
jT
jT
jT
jT
jT
jT
jT
jT
jT
jT
jT
aC
FN
"}
(12,1,1) = {"
FN
aC
jT
jT
jT
jT
jT
jT
jT
jT
jT
jT
jT
aC
FN
"}
(13,1,1) = {"
FN
aC
jT
jT
jT
jT
jT
jT
jT
jT
jT
jT
jT
aC
FN
"}
(14,1,1) = {"
FN
aC
jT
jT
jT
jT
jT
jT
jT
jT
jT
jT
jT
aC
FN
"}
(15,1,1) = {"
FN
aC
aC
aC
aC
aC
aC
aC
aC
aC
aC
aC
aC
aC
FN
"}
(16,1,1) = {"
FN
FN
FN
FN
FN
FN
FN
FN
FN
FN
FN
FN
FN
FN
FN
"}
