//MAP CONVERTED BY dmm2tgm.py THIS HEADER COMMENT PREVENTS RECONVERSION, DO NOT REMOVE
"aj" = (
/turf/open/floor/wood/tile,
/area/misc/condo)
"aI" = (
/obj/structure/flora/bush/snow/style_random,
/mob/living/basic/pet/penguin/baby/permanent/snowdin,
/obj/effect/overlay/light_snow,
/turf/open/floor/fake_snow/safe,
/area/misc/condo)
"aL" = (
/obj/effect/turf_decal/siding/wood{
	dir = 1
	},
/obj/item/stack/sheet/mineral/wood/fifty{
	pixel_x = 0;
	pixel_y = 8
	},
/obj/item/assembly/igniter{
	pixel_x = -10;
	pixel_y = 9
	},
/turf/open/floor/wood/tile,
/area/misc/condo)
"by" = (
/obj/structure/flora/bush/snow/style_4,
/obj/effect/turf_decal/weather/snow/corner{
	dir = 8
	},
/obj/effect/overlay/light_snow,
/turf/open/floor/fake_snow/safe,
/area/misc/condo)
"cg" = (
/obj/structure/railing/wooden_fencing{
	dir = 4
	},
/obj/effect/overlay/light_snow,
/turf/open/floor/fake_snow/safe,
/area/misc/condo)
"de" = (
/obj/structure/fireplace,
/obj/effect/turf_decal/siding/wood{
	dir = 1
	},
/obj/effect/turf_decal/siding/wood{
	dir = 8
	},
/turf/open/floor/wood/tile,
/area/misc/condo)
"eh" = (
/obj/structure/closet/crate/wooden,
/obj/item/clothing/suit/modern_winter,
/obj/item/clothing/suit/modern_winter,
/obj/item/clothing/shoes/winterboots,
/obj/item/clothing/shoes/winterboots,
/obj/item/clothing/head/costume/ushanka,
/obj/item/clothing/head/costume/ushanka,
/obj/item/clothing/head/costume/ushanka/frosty,
/obj/item/clothing/head/costume/ushanka/frosty,
/obj/item/clothing/mask/gas,
/obj/item/clothing/mask/gas,
/obj/item/tank/internals/emergency_oxygen/double,
/obj/item/tank/internals/emergency_oxygen/double,
/obj/item/clothing/under/costume/soviet,
/obj/item/clothing/under/costume/soviet,
/obj/effect/overlay/light_snow,
/obj/item/gun/ballistic/revolver/nagant,
/turf/open/floor/fake_snow/safe,
/area/misc/condo)
"es" = (
/obj/item/grown/log/tree,
/obj/effect/overlay/light_snow,
/turf/open/floor/fake_snow/safe,
/area/misc/condo)
"fQ" = (
/obj/effect/turf_decal/weather/snow/corner,
/obj/effect/overlay/light_snow,
/turf/open/floor/fake_snow/safe,
/area/misc/condo)
"fS" = (
/obj/structure/chair/wood{
	dir = 4
	},
/obj/effect/turf_decal/siding/wood{
	dir = 8
	},
/obj/effect/turf_decal/siding/wood,
/turf/open/floor/wood/tile,
/area/misc/condo)
"gD" = (
/obj/effect/turf_decal/weather/snow/corner,
/obj/effect/overlay/light_snow,
/turf/closed/indestructible/rock/snow/ice/ore,
/area/misc/condo)
"ht" = (
/obj/effect/turf_decal/siding/wood{
	dir = 8
	},
/obj/structure/bed/double{
	dir = 1
	},
/obj/item/bedsheet/runtime/double{
	dir = 1
	},
/obj/item/toy/plush/skyrat/snow_owl,
/turf/open/floor/wood/tile,
/area/misc/condo)
"kv" = (
/obj/structure/chair/sofa/bench/left{
	dir = 4;
	color = "#76502e";
	name = "Lover's Watch"
	},
/obj/effect/overlay/light_snow,
/turf/open/floor/fake_snow/safe,
/area/misc/condo)
"lf" = (
/obj/effect/overlay/light_snow,
/obj/structure/flora/bush/snow/style_4,
/obj/structure/flora/tree/pine,
/turf/open/floor/fake_snow/safe,
/area/misc/condo)
"mU" = (
/obj/effect/overlay/light_snow,
/obj/structure/flora/bush/snow/style_4,
/turf/open/floor/fake_snow/safe,
/area/misc/condo)
"pI" = (
/obj/structure/table/wood/shuttle_bar,
/obj/effect/turf_decal/siding/wood,
/obj/item/flashlight/lantern/on{
	pixel_x = -5;
	pixel_y = 15
	},
/obj/item/reagent_containers/cup/glass/bottle/vodka{
	pixel_x = 8;
	pixel_y = 17
	},
/obj/item/storage/toolbox/guncase/soviet{
	pixel_x = 0;
	pixel_y = -5
	},
/obj/item/reagent_containers/cup/glass/drinkingglass/shotglass{
	pixel_x = 2;
	pixel_y = 8
	},
/obj/item/reagent_containers/cup/glass/drinkingglass/shotglass{
	pixel_x = -11;
	pixel_y = 8
	},
/turf/open/floor/wood/tile,
/area/misc/condo)
"rB" = (
/turf/closed/indestructible/rock/snow/ice/ore,
/area/misc/condo)
"tT" = (
/obj/structure/flora/bush/snow/style_random,
/obj/effect/overlay/light_snow,
/turf/open/floor/fake_snow/safe,
/area/misc/condo)
"ua" = (
/obj/effect/turf_decal/siding/wood{
	dir = 1
	},
/obj/effect/turf_decal/siding/wood{
	dir = 4
	},
/obj/item/storage/box/colonial_rations{
	pixel_x = 7;
	pixel_y = -6
	},
/obj/item/storage/box/colonial_rations{
	pixel_x = -6;
	pixel_y = 8
	},
/obj/item/storage/box/colonial_rations{
	pixel_x = -6;
	pixel_y = -7
	},
/obj/structure/rack/wooden,
/turf/open/floor/wood/tile,
/area/misc/condo)
"uY" = (
/obj/item/wisp_lantern,
/obj/effect/overlay/light_snow,
/turf/open/floor/fake_snow/safe,
/area/misc/condo)
"wq" = (
/obj/effect/overlay/light_snow,
/obj/effect/decal/remains/plasma,
/turf/open/floor/fakeice/slippery,
/area/misc/condo)
"wr" = (
/obj/structure/flora/tree/dead/style_random,
/obj/effect/overlay/light_snow,
/turf/open/floor/fake_snow/safe,
/area/misc/condo)
"wK" = (
/obj/effect/spawner/structure/window/ice,
/obj/structure/barricade/wooden/crude/snow,
/obj/structure/curtain/bounty/start_closed,
/turf/open/floor/fake_snow/safe,
/area/misc/condo)
"xR" = (
/obj/structure/flora/tree/pine/style_random,
/obj/effect/overlay/light_snow,
/turf/open/floor/fake_snow/safe,
/area/misc/condo)
"yd" = (
/obj/effect/overlay/light_snow,
/turf/open/floor/fake_snow/safe,
/area/misc/condo)
"yf" = (
/obj/effect/overlay/light_snow,
/obj/structure/flora/tree/dead/style_random,
/turf/open/floor/fake_snow/safe,
/area/misc/condo)
"AG" = (
/turf/closed/indestructible/wood,
/area/misc/condo)
"AY" = (
/obj/structure/flora/grass/both/style_random,
/obj/effect/overlay/light_snow,
/turf/open/floor/fake_snow/safe,
/area/misc/condo)
"Cs" = (
/obj/effect/overlay/light_snow,
/obj/structure/flora/tree/pine,
/turf/open/floor/fake_snow/safe,
/area/misc/condo)
"CC" = (
/obj/effect/overlay/light_snow,
/turf/open/lava/plasma/biodome,
/area/misc/condo)
"Dx" = (
/obj/effect/overlay/light_snow,
/obj/structure/flora/grass/both/style_random,
/turf/open/floor/fake_snow/safe,
/area/misc/condo)
"EN" = (
/obj/effect/overlay/light_snow,
/turf/open/floor/fakeice/slippery,
/area/misc/condo)
"ET" = (
/obj/structure/barricade/wooden/snowed,
/turf/open/floor/fake_snow/safe,
/area/misc/condo)
"FP" = (
/obj/effect/turf_decal/siding/wood{
	dir = 8
	},
/turf/open/floor/wood/tile,
/area/misc/condo)
"Hg" = (
/obj/effect/turf_decal/weather/snow/corner,
/obj/effect/overlay/light_snow,
/obj/structure/statue/snow/snowman,
/turf/open/floor/fake_snow/safe,
/area/misc/condo)
"HG" = (
/obj/structure/chair/wood/wings{
	dir = 8
	},
/obj/effect/turf_decal/siding/wood,
/obj/effect/turf_decal/siding/wood{
	dir = 4
	},
/turf/open/floor/wood/tile,
/area/misc/condo)
"Jn" = (
/obj/structure/sign/poster/contraband/soviet_propaganda,
/turf/closed/indestructible/wood,
/area/misc/condo)
"Jv" = (
/obj/effect/overlay/light_snow,
/turf/open/floor/plating/snowed/smoothed{
	planetary_atmos = 0
	},
/area/misc/condo)
"KZ" = (
/obj/structure/mineral_door/wood,
/obj/effect/turf_decal/weather/snow,
/turf/open/floor/fake_snow/safe,
/area/misc/condo)
"Lw" = (
/obj/effect/overlay/light_snow,
/turf/closed/indestructible/rock/snow/ice/ore,
/area/misc/condo)
"Mr" = (
/obj/effect/turf_decal/weather/snow,
/obj/effect/overlay/light_snow,
/turf/open/misc/dirt/jungle,
/area/misc/condo)
"MJ" = (
/obj/structure/flora/tree/pine,
/obj/effect/overlay/light_snow,
/turf/open/floor/fake_snow/safe,
/area/misc/condo)
"Nh" = (
/obj/effect/spawner/structure/window/ice,
/obj/structure/barricade/wooden/crude/snow,
/turf/open/floor/fake_snow/safe,
/area/misc/condo)
"No" = (
/obj/effect/turf_decal/weather/snow/corner,
/obj/effect/overlay/light_snow,
/turf/open/floor/plating/snowed/smoothed{
	planetary_atmos = 0
	},
/area/misc/condo)
"OB" = (
/obj/structure/bonfire/prelit,
/obj/effect/turf_decal/weather/snow,
/obj/effect/overlay/light_snow,
/turf/open/misc/dirt/jungle,
/area/misc/condo)
"OH" = (
/mob/living/basic/pet/penguin/baby/permanent/snowdin,
/obj/effect/overlay/light_snow,
/turf/open/floor/fake_snow/safe,
/area/misc/condo)
"ON" = (
/obj/effect/turf_decal/weather/snow/corner{
	dir = 8
	},
/obj/effect/overlay/light_snow,
/turf/open/floor/fake_snow/safe,
/area/misc/condo)
"Qb" = (
/obj/structure/railing/wooden_fencing{
	dir = 4
	},
/obj/structure/railing/wooden_fencing,
/obj/effect/overlay/light_snow,
/turf/open/floor/fake_snow/safe,
/area/misc/condo)
"Tt" = (
/obj/structure/flora/grass/both/style_random,
/obj/effect/turf_decal/weather/snow/corner,
/obj/effect/overlay/light_snow,
/turf/open/floor/fake_snow/safe,
/area/misc/condo)
"Ve" = (
/obj/structure/barricade/wooden/snowed,
/obj/effect/overlay/light_snow,
/turf/open/floor/fake_snow/safe,
/area/misc/condo)
"Yk" = (
/turf/closed/indestructible/hoteldoor/fakedoor{
	icon = 'icons/obj/doors/mineral_doors.dmi';
	icon_state = "wood"
	},
/area/misc/condo)
"YY" = (
/obj/structure/chair/sofa/bench/right{
	dir = 4;
	color = "#76502e";
	name = "Lover's Watch"
	},
/obj/structure/railing/wooden_fencing,
/obj/effect/overlay/light_snow,
/turf/open/floor/fake_snow/safe,
/area/misc/condo)
"ZK" = (
/obj/effect/turf_decal/siding/wood{
	dir = 4
	},
/turf/open/floor/wood/tile,
/area/misc/condo)

(1,1,1) = {"
rB
rB
rB
rB
rB
rB
rB
rB
rB
rB
rB
rB
rB
rB
rB
"}
(2,1,1) = {"
rB
Lw
Lw
yd
yd
Lw
Lw
gD
AG
Yk
AG
AG
AG
AG
rB
"}
(3,1,1) = {"
rB
Lw
tT
yd
wr
yd
yd
fQ
AG
de
ht
FP
fS
AG
rB
"}
(4,1,1) = {"
rB
yd
yd
yd
yd
yd
yf
Tt
wK
aL
aj
aj
pI
wK
rB
"}
(5,1,1) = {"
rB
yd
MJ
yd
lf
yd
EN
fQ
ET
ua
ZK
ZK
HG
Nh
rB
"}
(6,1,1) = {"
rB
yd
yd
Mr
yd
yd
wr
fQ
AG
Jn
KZ
ET
AG
AG
rB
"}
(7,1,1) = {"
rB
MJ
Mr
OB
Mr
EN
Hg
by
ON
eh
Jv
yd
yd
yd
rB
"}
(8,1,1) = {"
rB
yd
es
Mr
yd
wr
No
Jv
AY
Jv
yd
yd
yd
MJ
rB
"}
(9,1,1) = {"
rB
yd
AY
EN
yd
yd
Jv
Jv
Jv
Jv
yd
MJ
EN
yd
rB
"}
(10,1,1) = {"
rB
yd
wr
yd
wr
yd
Cs
EN
yd
wr
uY
kv
YY
Lw
rB
"}
(11,1,1) = {"
rB
Dx
OH
yd
Dx
yd
yd
wr
yd
MJ
cg
cg
Qb
CC
rB
"}
(12,1,1) = {"
rB
MJ
yd
wr
yd
yd
yf
yd
yd
EN
CC
CC
CC
CC
rB
"}
(13,1,1) = {"
rB
yd
Dx
yd
AY
yd
Jv
yd
MJ
CC
CC
CC
CC
Lw
rB
"}
(14,1,1) = {"
rB
yd
xR
EN
yd
Cs
yd
Dx
EN
CC
CC
CC
CC
CC
rB
"}
(15,1,1) = {"
rB
yd
Ve
yd
yd
yd
mU
yd
aI
wq
CC
CC
CC
Lw
rB
"}
(16,1,1) = {"
rB
rB
rB
rB
rB
rB
rB
rB
rB
rB
rB
rB
rB
rB
rB
"}
