//MAP CONVERTED BY dmm2tgm.py THIS HEADER COMMENT PREVENTS RECONVERSION, DO NOT REMOVE
"a" = (
/turf/closed/wall,
/area/space)
"b" = (
/obj/structure/closet/crate,
/obj/effect/spawner/random/maintenance,
/turf/open/floor/plating,
/area/space)
"d" = (
/obj/effect/decal/cleanable/dirt/dust,
/obj/effect/spawner/random/trash/moisture_trap,
/turf/open/floor/plating,
/area/space)
"e" = (
/obj/machinery/light/very_dim/directional/east,
/obj/structure/disposalpipe/segment,
/turf/open/floor/plating,
/area/space)
"g" = (
/obj/effect/decal/cleanable/plasma,
/turf/open/floor/plating,
/area/space)
"h" = (
/turf/open/floor/plating,
/area/space)
"i" = (
/obj/effect/spawner/random/structure/grille,
/obj/effect/spawner/random/structure/girder,
/turf/open/floor/plating,
/area/space)
"j" = (
/obj/machinery/camera/xray/directional/north,
/turf/open/floor/plating,
/area/space)
"k" = (
/obj/machinery/door/airlock/maintenance,
/obj/structure/holosign/barrier/atmos,
/turf/open/floor/plating,
/area/space)
"l" = (
/obj/machinery/door/airlock/maintenance,
/obj/structure/holosign/barrier/atmos,
/turf/open/misc/grass/jungle,
/area/space)
"m" = (
/obj/structure/disposalpipe/segment{
	dir = 5
	},
/turf/open/floor/plating,
/area/space)
"n" = (
/obj/effect/spawner/random/structure/grille,
/turf/open/floor/plating,
/area/space)
"p" = (
/obj/effect/mapping_helpers/broken_floor,
/turf/open/floor/plating,
/area/space)
"q" = (
/obj/machinery/light/red/directional/west,
/turf/open/floor/plating,
/area/space)
"s" = (
/obj/effect/mapping_helpers/broken_floor,
/obj/effect/spawner/random/structure/steam_vent,
/turf/open/floor/plating,
/area/space)
"u" = (
/obj/effect/mapping_helpers/airlock/locked,
/obj/effect/mapping_helpers/airlock/access/any/cent_com/rep_or_captain,
/obj/machinery/door/airlock/vault,
/obj/effect/decal/cleanable/blood/tracks{
	dir = 1
	},
/turf/open/floor/plating,
/area/space)
"v" = (
/obj/effect/mapping_helpers/airlock/locked,
/obj/effect/mapping_helpers/airlock/access/any/cent_com/rep_or_captain,
/obj/machinery/door/airlock/vault,
/turf/open/floor/plating,
/area/space)
"x" = (
/turf/open/floor/plating/foam,
/area/space)
"z" = (
/obj/machinery/door/airlock/maintenance,
/obj/effect/mapping_helpers/airlock/locked,
/turf/open/floor/plating,
/area/space)
"A" = (
/obj/effect/spawner/random/structure/closet_maintenance,
/turf/open/floor/plating,
/area/space)
"C" = (
/obj/machinery/camera/xray/directional/north,
/obj/effect/mapping_helpers/broken_floor,
/turf/open/floor/plating,
/area/space)
"D" = (
/obj/structure/closet/crate/secure/loot,
/turf/open/floor/plating,
/area/space)
"E" = (
/obj/effect/spawner/random/trash/moisture_trap,
/turf/open/floor/plating,
/area/space)
"F" = (
/obj/machinery/light/red/directional/north,
/turf/open/floor/plating,
/area/space)
"G" = (
/obj/machinery/light/very_dim/directional/west,
/turf/open/floor/plating,
/area/space)
"H" = (
/obj/effect/mapping_helpers/burnt_floor,
/turf/open/floor/plating,
/area/space)
"I" = (
/obj/machinery/door/airlock/maintenance,
/obj/structure/disposalpipe/segment,
/turf/open/floor/plating,
/area/space)
"J" = (
/turf/closed/indestructible/reinforced,
/area/space)
"K" = (
/obj/effect/decal/cleanable/dirt/dust,
/turf/open/floor/plating,
/area/space)
"M" = (
/obj/machinery/door/airlock/maintenance,
/turf/open/floor/plating,
/area/space)
"O" = (
/turf/open/space/basic,
/area/space)
"Q" = (
/obj/structure/falsewall,
/turf/open/floor/plating,
/area/space)
"R" = (
/obj/machinery/door/airlock/maintenance,
/obj/structure/disposalpipe/segment{
	dir = 4
	},
/turf/open/floor/plating,
/area/space)
"T" = (
/obj/machinery/door/airlock/maintenance,
/obj/structure/barricade/wooden/crude,
/obj/effect/mapping_helpers/airlock/welded,
/turf/open/floor/mineral/plastitanium/red,
/area/space)
"U" = (
/turf/closed/wall/r_wall,
/area/space)
"V" = (
/obj/machinery/light/red/directional/west,
/obj/effect/decal/cleanable/dirt/dust,
/turf/open/floor/plating,
/area/space)
"W" = (
/obj/machinery/door/airlock/maintenance,
/obj/effect/mapping_helpers/airlock/locked,
/turf/open/floor/circuit/red,
/area/space)
"X" = (
/obj/structure/disposalpipe/segment,
/turf/open/floor/plating,
/area/space)
"Y" = (
/obj/machinery/light/red,
/turf/open/floor/plating,
/area/space)
"Z" = (
/turf/closed/indestructible/fakedoor/maintenance,
/area/space)

(1,1,1) = {"
O
O
O
O
O
O
O
O
O
O
O
O
O
O
O
O
O
O
O
O
O
O
O
O
a
a
a
O
O
O
O
O
O
"}
(2,1,1) = {"
J
J
J
J
J
J
O
a
a
a
a
a
a
a
a
a
O
O
J
U
U
U
a
k
a
h
l
O
O
O
O
O
O
"}
(3,1,1) = {"
a
h
h
h
h
a
O
a
h
h
h
h
h
h
h
a
O
O
J
a
a
a
a
h
h
h
a
a
a
a
a
a
a
"}
(4,1,1) = {"
a
h
h
h
h
a
O
a
h
h
h
h
h
h
h
a
O
O
J
D
a
h
h
h
h
h
h
h
h
h
h
h
a
"}
(5,1,1) = {"
a
h
h
h
h
a
O
a
h
h
h
h
h
h
h
a
O
O
J
n
a
h
h
h
h
h
h
h
h
h
h
h
k
"}
(6,1,1) = {"
a
h
h
h
h
Q
O
a
h
h
h
H
h
h
h
a
O
O
J
A
i
h
h
h
h
h
h
h
h
h
h
h
a
"}
(7,1,1) = {"
a
h
h
h
h
a
O
a
h
h
h
h
h
h
h
a
O
O
J
a
a
h
h
h
h
h
h
h
h
h
h
h
a
"}
(8,1,1) = {"
a
h
h
h
h
a
O
a
h
h
h
h
h
h
h
a
O
O
J
s
h
h
h
h
h
h
h
h
h
h
h
h
a
"}
(9,1,1) = {"
a
h
h
h
h
a
O
a
h
h
h
h
h
h
h
a
O
O
J
a
a
h
h
h
h
h
h
h
h
h
h
h
a
"}
(10,1,1) = {"
a
a
a
a
a
a
O
a
h
h
h
h
h
h
h
a
O
O
J
b
n
h
h
h
h
h
h
h
h
h
h
h
a
"}
(11,1,1) = {"
O
O
O
O
O
O
O
a
a
M
a
a
a
a
a
a
O
O
J
b
n
h
h
h
h
h
h
h
h
h
h
h
a
"}
(12,1,1) = {"
O
O
O
O
O
O
O
O
a
h
h
h
h
h
h
a
O
O
J
b
n
h
h
h
h
h
h
h
h
h
h
h
a
"}
(13,1,1) = {"
O
O
O
O
O
O
O
O
a
h
h
h
h
h
h
a
O
O
J
a
a
h
h
h
h
h
h
h
h
h
h
h
a
"}
(14,1,1) = {"
O
O
O
O
O
O
O
O
a
h
h
h
h
h
h
a
O
O
J
x
x
h
h
h
h
h
h
h
h
h
h
h
a
"}
(15,1,1) = {"
O
O
O
O
O
O
O
O
a
h
h
h
h
h
h
a
O
O
v
x
x
x
h
h
h
h
h
h
h
h
h
h
a
"}
(16,1,1) = {"
O
O
O
O
O
O
O
O
a
h
h
h
h
h
h
a
O
O
u
x
x
x
h
h
h
h
h
h
h
h
h
h
a
"}
(17,1,1) = {"
O
O
O
O
O
O
O
O
a
h
h
h
h
h
h
a
O
O
v
x
x
x
h
h
h
h
h
h
h
h
h
h
h
"}
(18,1,1) = {"
O
O
a
a
a
a
a
O
a
h
h
h
h
h
h
a
O
O
J
x
x
h
h
h
h
h
h
h
h
h
h
h
h
"}
(19,1,1) = {"
O
O
a
d
h
p
a
O
T
h
h
h
h
h
h
a
O
O
J
J
J
J
J
J
J
J
k
J
J
k
J
J
J
"}
(20,1,1) = {"
O
O
a
F
K
h
a
O
a
M
a
a
a
a
a
a
O
O
O
O
O
O
O
O
O
O
O
O
O
O
O
O
O
"}
(21,1,1) = {"
O
O
W
p
K
h
a
O
a
h
h
h
h
h
h
a
O
a
a
a
a
a
a
a
O
a
M
a
a
a
a
a
a
"}
(22,1,1) = {"
O
O
a
a
a
z
a
O
a
h
h
h
h
h
h
a
O
a
H
h
G
h
H
a
O
a
h
h
h
h
E
h
a
"}
(23,1,1) = {"
O
O
a
C
V
h
a
O
a
h
h
h
h
h
h
a
O
a
h
p
h
h
h
a
O
a
h
h
h
h
h
h
a
"}
(24,1,1) = {"
O
O
a
h
K
h
a
O
a
h
h
h
h
a
a
a
O
a
h
h
h
h
h
a
O
a
h
h
h
h
h
h
a
"}
(25,1,1) = {"
O
O
a
d
g
h
a
O
a
a
a
a
M
a
O
O
O
a
h
h
h
h
h
a
O
a
h
h
h
h
h
h
a
"}
(26,1,1) = {"
O
O
a
a
a
W
a
O
O
O
O
O
O
O
O
O
O
I
X
X
e
X
m
a
O
a
h
h
h
h
h
h
a
"}
(27,1,1) = {"
O
O
O
a
q
K
a
O
O
O
O
O
O
O
O
O
O
a
a
a
a
a
R
a
O
a
h
h
h
h
h
h
a
"}
(28,1,1) = {"
O
O
O
a
h
p
a
O
O
O
O
O
O
O
O
O
O
O
O
O
O
O
O
O
O
a
a
a
a
a
a
a
a
"}
(29,1,1) = {"
O
O
O
a
h
h
z
O
O
O
O
O
O
O
O
O
O
O
O
O
O
O
O
O
O
O
O
O
O
O
O
O
O
"}
(30,1,1) = {"
O
O
O
a
K
h
a
O
O
O
O
O
O
O
O
O
O
O
O
J
J
J
J
J
J
J
J
J
J
J
J
J
J
"}
(31,1,1) = {"
O
O
O
a
p
h
a
O
O
O
O
O
O
O
O
O
O
O
O
Q
h
h
Q
h
h
a
h
h
h
h
h
h
J
"}
(32,1,1) = {"
O
O
O
z
K
K
a
O
O
O
O
O
O
O
O
O
O
O
O
a
h
Y
a
h
h
a
h
h
h
h
h
h
J
"}
(33,1,1) = {"
O
O
O
a
a
a
a
O
O
O
O
O
O
O
O
O
O
O
O
a
h
h
a
j
h
a
h
h
h
h
h
h
J
"}
(34,1,1) = {"
O
O
O
O
O
O
O
O
O
O
O
O
O
O
O
O
O
O
O
a
a
a
a
a
a
a
a
a
a
a
a
Z
J
"}
