"a" = (/turf/closed/wall/r_wall,/area/station/command/heads_quarters/blueshield)
"b" = (/obj/machinery/computer/crew{dir = 1},/obj/machinery/light/warm/dim/directional/south,/obj/machinery/airalarm/directional/south,/obj/effect/turf_decal/siding/dark{dir = 5},/obj/effect/turf_decal/bot,/turf/open/floor/iron/dark/textured,/area/station/command/heads_quarters/blueshield)
"c" = (/obj/effect/spawner/structure/window/reinforced,/obj/structure/cable,/obj/structure/curtain/cloth/fancy/mechanical{icon_state = "bounty-open"; icon_type = "bounty"; id = "blueshield_priv"; name = "curtain"},/turf/open/floor/plating,/area/station/command/heads_quarters/blueshield)
"d" = (/obj/effect/turf_decal/siding/dark{dir = 6},/turf/closed/wall/r_wall,/area/station/command/heads_quarters/blueshield)
"i" = (/obj/machinery/button/curtain{pixel_y = -6; pixel_x = -3; id = "blueshield_priv"},/turf/closed/wall/r_wall,/area/station/command/heads_quarters/blueshield)
"j" = (/obj/structure/table/wood,/obj/machinery/fax{name = "Blueshield's Fax Machine"; fax_name = "Blueshield's Office"},/obj/item/radio/intercom/directional/east,/obj/machinery/atmospherics/pipe/smart/manifold4w/supply/hidden/layer4,/obj/effect/turf_decal/siding/dark{dir = 6},/turf/open/floor/carpet/royalblue,/area/station/command/heads_quarters/blueshield)
"n" = (/obj/structure/cable,/obj/structure/cable,/obj/machinery/atmospherics/pipe/smart/manifold4w/supply/hidden/layer4,/obj/machinery/atmospherics/pipe/smart/manifold4w/scrubbers/hidden/layer2,/obj/effect/turf_decal/tile/dark_blue/opposingcorners,/turf/open/floor/iron/dark,/area/station/command/heads_quarters/blueshield)
"r" = (/obj/machinery/status_display/evac/directional/south,/obj/machinery/photocopier/prebuilt,/obj/effect/turf_decal/tile/dark_blue/opposingcorners,/obj/effect/turf_decal/bot,/turf/open/floor/iron/dark,/area/station/command/heads_quarters/blueshield)
"s" = (/obj/effect/landmark/start/blueshield,/obj/machinery/light/small/directional/west,/obj/machinery/atmospherics/pipe/smart/manifold4w/supply/hidden/layer4,/obj/machinery/atmospherics/components/unary/vent_scrubber/on/layer2,/turf/open/floor/wood,/area/station/command/heads_quarters/blueshield)
"t" = (/obj/structure/cable,/obj/machinery/atmospherics/pipe/smart/manifold4w/supply/hidden/layer4,/obj/machinery/atmospherics/pipe/smart/manifold4w/supply/hidden/layer4,/obj/effect/mapping_helpers/turn_off_lights_with_lightswitch,/obj/machinery/atmospherics/pipe/smart/manifold4w/scrubbers/hidden/layer2,/obj/effect/turf_decal/tile/dark_blue/opposingcorners,/turf/open/floor/iron/dark,/area/station/command/heads_quarters/blueshield)
"y" = (/obj/structure/cable,/obj/machinery/atmospherics/pipe/smart/manifold4w/supply/hidden/layer4,/obj/machinery/atmospherics/pipe/smart/manifold4w/scrubbers/hidden/layer2,/obj/machinery/door/firedoor,/obj/effect/landmark/navigate_destination/autoname,/obj/effect/mapping_helpers/airlock/access/any/cent_com/rep_or_captain,/obj/machinery/door/airlock/corporate{id_tag = "BSdoor"; name = "Blueshield's Office"},/turf/open/floor/iron,/area/station/command/heads_quarters/blueshield)
"A" = (/obj/structure/chair/comfy/black,/obj/structure/sign/plaques/kiddie/perfect_man{pixel_y = 32},/obj/machinery/atmospherics/components/unary/vent_pump/on/layer4{dir = 4},/obj/machinery/light/warm/dim/directional/north,/obj/effect/turf_decal/siding/dark{dir = 1},/obj/effect/landmark/start/blueshield,/turf/open/floor/carpet/royalblue,/area/station/command/heads_quarters/blueshield)
"B" = (/obj/machinery/requests_console/auto_name/directional/west,/obj/effect/mapping_helpers/requests_console/assistance,/obj/effect/mapping_helpers/requests_console/supplies,/obj/effect/mapping_helpers/requests_console/information,/obj/effect/mapping_helpers/requests_console/announcement,/obj/machinery/modular_computer/preset/command{dir = 4},/obj/effect/turf_decal/siding/dark{dir = 9},/obj/machinery/newscaster/directional/north,/obj/effect/turf_decal/bot,/turf/open/floor/carpet/royalblue,/area/station/command/heads_quarters/blueshield)
"C" = (/obj/effect/mapping_helpers/airlock/access/all/command/captain,/obj/machinery/atmospherics/pipe/smart/manifold4w/supply/hidden/layer4,/obj/machinery/door/airlock/highsecurity{name = "Blueshield's Quarters"},/turf/open/floor/iron/dark/textured,/area/station/command/heads_quarters/blueshield)
"D" = (/obj/structure/cable,/obj/machinery/computer/records/medical{dir = 1},/obj/machinery/firealarm/directional/west,/obj/machinery/power/apc/auto_name/directional/south,/obj/effect/turf_decal/siding/dark{dir = 1},/obj/effect/turf_decal/bot,/turf/open/floor/iron/dark/textured,/area/station/command/heads_quarters/blueshield)
"E" = (/obj/structure/closet/secure_closet/blueshield,/obj/structure/window/reinforced/spawner/directional/north,/obj/item/clothing/gloves/tackler/combat/insulated/blueshield,/obj/effect/turf_decal/delivery/red,/obj/item/clothing/head/cowboy/skyrat/cattleman/sec,/obj/structure/window/reinforced/spawner/directional/east,/obj/item/chair/plastic{pixel_y = 10},/obj/item/modular_computer/laptop/preset/security{pixel_y = 5},/obj/item/taperecorder{name = "Captain's Log"},/obj/structure/window/reinforced/spawner/directional/west,/turf/open/floor/iron/dark/textured,/area/station/command/heads_quarters/blueshield)
"F" = (/obj/machinery/atmospherics/components/unary/vent_pump/on/layer4,/obj/structure/reagent_dispensers/wall/peppertank/directional/north,/turf/open/floor/wood,/area/station/command/heads_quarters/blueshield)
"G" = (/obj/structure/table/wood,/obj/machinery/recharger{pixel_x = 7; pixel_y = 6},/obj/item/paper_bin{pixel_y = 4; pixel_x = -5},/obj/item/pen/fourcolor{pixel_x = -5; pixel_y = 5},/obj/effect/turf_decal/siding/dark,/obj/item/pen/fountain{pixel_x = -5; pixel_y = 5},/obj/machinery/atmospherics/components/unary/vent_scrubber/on/layer2,/turf/open/floor/carpet/royalblue,/area/station/command/heads_quarters/blueshield)
"J" = (/obj/machinery/computer/security/wooden_tv,/obj/structure/table/wood/fancy/blue,/obj/structure/sign/poster/official/obey/directional/south,/obj/structure/secure_safe/directional/west,/turf/open/floor/wood,/area/station/command/heads_quarters/blueshield)
"K" = (/obj/structure/sign/clock/directional/east,/obj/structure/bed,/obj/item/bedsheet/nanotrasen,/obj/machinery/vending/wallmed/directional/north,/turf/open/floor/wood,/area/station/command/heads_quarters/blueshield)
"M" = (/obj/structure/table/wood,/obj/machinery/computer/records/security/laptop{dir = 4; pixel_x = 1; pixel_y = 3},/obj/effect/turf_decal/siding/dark{dir = 10},/obj/item/phone{pixel_x = -3; pixel_y = 7},/obj/item/reagent_containers/cup/glass/mug/nanotrasen,/turf/open/floor/carpet/royalblue,/area/station/command/heads_quarters/blueshield)
"N" = (/obj/effect/turf_decal/siding/dark/corner{dir = 4},/obj/structure/safe/abovetilefloor,/obj/item/storage/fancy/cigarettes/cigars,/obj/item/storage/fancy/donut_box,/obj/item/storage/medkit/tactical/blueshield,/obj/item/reagent_containers/cup/glass/bottle/navy_rum,/obj/item/holocigarette/masvedishcigar,/obj/effect/turf_decal/siding/dark{dir = 5},/obj/machinery/light_switch/directional/north{pixel_x = 7},/obj/machinery/atmospherics/pipe/smart/manifold4w/supply/hidden/layer4,/obj/item/paperwork/captain{pixel_x = -3; pixel_y = 4; name = "Asset Protection case records"; desc = "A messily compiled stack of DAP records, containing incident reports, asset recovery briefings and classified paramilitary activities, with substantial portions censored and redacted. You probably shouldn't be reading this, unless you yearn for a one-way trip to Space Guantanamo."},/turf/open/floor/carpet/royalblue,/area/station/command/heads_quarters/blueshield)
"P" = (/obj/machinery/suit_storage_unit/security,/obj/structure/window/reinforced/spawner/directional/south,/obj/effect/turf_decal/delivery/red,/obj/structure/window/reinforced/spawner/directional/east,/obj/structure/window/reinforced/spawner/directional/west,/turf/open/floor/iron/dark/textured,/area/station/command/heads_quarters/blueshield)
"Q" = (/obj/structure/cable,/obj/machinery/holopad,/obj/machinery/atmospherics/pipe/smart/manifold4w/supply/hidden/layer4,/obj/machinery/atmospherics/pipe/smart/manifold4w/scrubbers/hidden/layer2,/obj/effect/landmark/start/blueshield,/obj/effect/turf_decal/tile/dark_blue/opposingcorners,/turf/open/floor/iron/dark,/area/station/command/heads_quarters/blueshield)
"S" = (/obj/machinery/atmospherics/pipe/smart/manifold4w/supply/hidden/layer4,/obj/machinery/atmospherics/pipe/smart/manifold4w/scrubbers/hidden/layer2,/turf/open/floor/wood,/area/station/command/heads_quarters/blueshield)
"X" = (/obj/effect/mapping_helpers/airlock/access/all/command/captain,/obj/machinery/door/airlock/highsecurity{name = "Blueshield's Quarters"},/turf/open/floor/iron/dark/textured,/area/station/command/heads_quarters/blueshield)
"Y" = (/obj/structure/closet/secure_closet/tac{req_access = list("captain")},/obj/item/gun_maintenance_supplies,/obj/item/clothing/suit/armor/riot,/obj/item/clothing/head/helmet/toggleable/riot{pixel_y = 6},/obj/effect/turf_decal/delivery/red,/obj/structure/window/reinforced/spawner/directional/east,/obj/item/ammo_box/magazine/wt550m9,/obj/machinery/door/window/brigdoor/right/directional/east{req_access = list("captain"); name = "Blueshield's Armory"; dir = 8},/turf/open/floor/iron/dark/textured,/area/station/command/heads_quarters/blueshield)

(1,1,1) = {"
aaaiaaaa
aBANXFKa
cMGjasEa
ynQtCSYa
aDbrdJPa
aaaaaaaa
"}
