//MAP CONVERTED BY dmm2tgm.py THIS HEADER COMMENT PREVENTS RECONVERSION, DO NOT REMOVE
"a" = (
/obj/structure/closet/secure_closet/security/cargo,
/obj/item/clothing/mask/whistle,
/obj/effect/turf_decal/trimline/red/filled/line{
	dir = 8
	},
/turf/open/floor/iron,
/area/station/security/checkpoint/supply)
"c" = (
/obj/effect/turf_decal/siding/thinplating{
	dir = 4
	},
/obj/structure/railing{
	dir = 4
	},
/obj/effect/turf_decal/trimline/red/filled/line{
	dir = 6
	},
/turf/open/floor/iron,
/area/station/security/checkpoint/supply)
"d" = (
/turf/open/floor/iron,
/area/station/security/checkpoint/supply)
"g" = (
/obj/machinery/atmospherics/pipe/smart/manifold4w/supply/hidden/layer4,
/obj/machinery/atmospherics/pipe/smart/manifold4w/scrubbers/hidden/layer2,
/obj/effect/landmark/event_spawn,
/turf/open/floor/iron,
/area/station/security/checkpoint/supply)
"h" = (
/obj/effect/turf_decal/siding/thinplating/corner{
	dir = 8
	},
/obj/structure/railing/corner{
	dir = 8
	},
/obj/effect/turf_decal/trimline/red/corner{
	dir = 8
	},
/turf/open/floor/iron,
/area/station/security/checkpoint/supply)
"i" = (
/obj/effect/decal/cleanable/dirt,
/obj/machinery/door/airlock/maintenance_hatch{
	name = "Security Maintenance"
	},
/obj/machinery/atmospherics/pipe/smart/manifold4w/supply/hidden/layer4,
/obj/machinery/atmospherics/pipe/smart/manifold4w/scrubbers/hidden/layer2,
/obj/effect/mapping_helpers/airlock/access/all/supply/customs,
/turf/open/floor/plating,
/area/station/maintenance/starboard/greater)
"p" = (
/turf/template_noop,
/area/template_noop)
"q" = (
/obj/structure/stairs/south,
/turf/open/floor/iron/stairs/medium,
/area/station/security/checkpoint/supply)
"w" = (
/obj/effect/turf_decal/trimline/red/filled/line{
	dir = 8
	},
/obj/structure/reagent_dispensers/wall/peppertank/directional/west,
/obj/machinery/computer/records/security{
	dir = 4
	},
/turf/open/floor/iron,
/area/station/security/checkpoint/supply)
"x" = (
/obj/effect/turf_decal/siding/thinplating/corner,
/obj/structure/railing/corner,
/obj/effect/turf_decal/trimline/red/corner,
/turf/open/floor/iron,
/area/station/security/checkpoint/supply)
"y" = (
/obj/effect/turf_decal/trimline/red/filled/line{
	dir = 5
	},
/obj/structure/chair,
/turf/open/floor/iron,
/area/station/security/checkpoint/supply)
"z" = (
/obj/effect/turf_decal/trimline/red/filled/corner{
	dir = 4
	},
/obj/effect/turf_decal/trimline/red/filled/corner{
	dir = 1
	},
/obj/machinery/atmospherics/pipe/smart/manifold4w/supply/hidden/layer4,
/obj/machinery/atmospherics/pipe/smart/manifold4w/scrubbers/hidden/layer2,
/turf/open/floor/iron,
/area/station/security/checkpoint/supply)
"A" = (
/obj/structure/filingcabinet,
/obj/item/book/manual/wiki/security_space_law,
/obj/effect/turf_decal/trimline/red/filled/line{
	dir = 5
	},
/turf/open/floor/iron,
/area/station/security/checkpoint/supply)
"C" = (
/obj/effect/turf_decal/trimline/red/filled/line{
	dir = 1
	},
/turf/open/floor/iron,
/area/station/security/checkpoint/supply)
"D" = (
/obj/machinery/computer/security/mining{
	dir = 4
	},
/obj/item/radio/intercom/directional/west,
/obj/effect/turf_decal/trimline/red/filled/line{
	dir = 8
	},
/turf/open/floor/iron,
/area/station/security/checkpoint/supply)
"F" = (
/obj/effect/turf_decal/trimline/red/filled/line,
/obj/effect/turf_decal/trimline/neutral/filled/warning,
/obj/effect/turf_decal/siding/thinplating,
/turf/open/floor/iron,
/area/station/security/checkpoint/supply)
"G" = (
/obj/structure/table/reinforced,
/obj/effect/turf_decal/trimline/red/filled/line{
	dir = 6
	},
/obj/machinery/light/directional/south,
/turf/open/floor/iron,
/area/station/security/checkpoint/supply)
"J" = (
/obj/effect/turf_decal/siding/thinplating{
	dir = 8
	},
/obj/structure/railing{
	dir = 8
	},
/obj/effect/turf_decal/trimline/red/filled/line{
	dir = 10
	},
/obj/structure/table/reinforced,
/obj/item/paper_bin,
/obj/item/pen,
/obj/structure/sign/poster/official/here_for_your_safety/directional/south,
/turf/open/floor/iron,
/area/station/security/checkpoint/supply)
"L" = (
/obj/effect/turf_decal/trimline/red/filled/line{
	dir = 1
	},
/obj/structure/chair,
/turf/open/floor/iron,
/area/station/security/checkpoint/supply)
"N" = (
/obj/structure/table/reinforced,
/obj/machinery/recharger{
	pixel_y = 4
	},
/obj/effect/turf_decal/trimline/red/filled/line{
	dir = 9
	},
/obj/machinery/light/directional/north,
/turf/open/floor/iron,
/area/station/security/checkpoint/supply)
"O" = (
/obj/effect/turf_decal/trimline/red/filled/line{
	dir = 10
	},
/obj/item/kirbyplants/random,
/turf/open/floor/iron,
/area/station/security/checkpoint/supply)
"R" = (
/obj/effect/turf_decal/trimline/red/filled/corner{
	dir = 4
	},
/obj/machinery/atmospherics/components/unary/vent_pump/on/layer4{
	dir = 1
	},
/turf/open/floor/iron,
/area/station/security/checkpoint/supply)
"S" = (
/turf/closed/wall/r_wall,
/area/station/maintenance/starboard/greater)
"T" = (
/obj/structure/chair/office{
	dir = 8
	},
/obj/machinery/atmospherics/pipe/smart/manifold4w/scrubbers/hidden/layer2,
/obj/effect/landmark/start/customs_agent,
/turf/open/floor/iron,
/area/station/security/checkpoint/supply)
"W" = (
/obj/effect/turf_decal/trimline/red/filled/line{
	dir = 4
	},
/turf/open/floor/iron,
/area/station/security/checkpoint/supply)
"X" = (
/obj/effect/turf_decal/trimline/red/filled/line{
	dir = 4
	},
/obj/machinery/airalarm/directional/east,
/obj/machinery/camera/directional/east{
	c_tag = "Cargo - Lower Security Outpost"
	},
/obj/machinery/atmospherics/pipe/smart/manifold4w/supply/hidden/layer4,
/turf/open/floor/iron,
/area/station/security/checkpoint/supply)
"Y" = (
/turf/closed/wall/r_wall,
/area/station/security/checkpoint/supply)
"Z" = (
/obj/machinery/atmospherics/components/unary/vent_scrubber/on/layer2{
	dir = 1
	},
/obj/effect/landmark/start/customs_agent,
/turf/open/floor/iron,
/area/station/security/checkpoint/supply)

(1,1,1) = {"
S
Y
Y
Y
Y
Y
Y
"}
(2,1,1) = {"
S
N
D
w
a
O
Y
"}
(3,1,1) = {"
S
C
T
Z
x
c
Y
"}
(4,1,1) = {"
i
z
g
d
F
q
Y
"}
(5,1,1) = {"
S
A
X
R
F
q
Y
"}
(6,1,1) = {"
S
S
S
L
h
J
Y
"}
(7,1,1) = {"
p
p
S
y
W
G
Y
"}
(8,1,1) = {"
p
p
S
S
S
S
S
"}
