//MAP CONVERTED BY dmm2tgm.py THIS HEADER COMMENT PREVENTS RECONVERSION, DO NOT REMOVE
"a" = (
/turf/closed/wall/r_wall,
/area/station/command/heads_quarters/nt_rep)
"b" = (
/obj/structure/chair/sofa/corp/right{
	desc = "Looks like someone threw it out. Covered in donut crumbs.";
	dir = 1;
	name = "couch"
	},
/turf/open/floor/wood,
/area/station/command/heads_quarters/nt_rep)
"c" = (
/obj/structure/chair/sofa/corp/corner{
	desc = "Looks like someone threw it out. Covered in donut crumbs.";
	dir = 1;
	name = "couch"
	},
/obj/machinery/light/warm/dim/directional/south,
/turf/open/floor/wood,
/area/station/command/heads_quarters/nt_rep)
"d" = (
/obj/machinery/door/firedoor,
/obj/effect/mapping_helpers/airlock/access/all/cent_com/rep_door,
/obj/effect/mapping_helpers/airlock/unres/delayed{
	dir = 1
	},
/obj/effect/turf_decal/tile/dark_green/opposingcorners,
/obj/machinery/door/airlock/corporate{
	name = "Consultant's Quarters"
	},
/turf/open/floor/iron/dark,
/area/station/command/heads_quarters/nt_rep)
"e" = (
/obj/effect/turf_decal/tile/dark_green/opposingcorners,
/obj/structure/table/wood,
/obj/machinery/computer/security/wooden_tv{
	pixel_y = 10
	},
/obj/item/book/manual/wiki/security_space_law{
	pixel_y = 3;
	pixel_x = 7
	},
/turf/open/floor/iron/dark,
/area/station/command/heads_quarters/nt_rep)
"f" = (
/obj/machinery/atmospherics/pipe/smart/manifold4w/supply/hidden/layer4,
/obj/structure/bed/dogbed,
/mob/living/basic/pet/cat/jerry{
	name = "Bailey";
	desc = "The Consultant's trusted companion, ever increasing the profit margin and the amount of scratches on the couch."
	},
/turf/open/floor/wood,
/area/station/command/heads_quarters/nt_rep)
"g" = (
/obj/structure/table/wood,
/obj/machinery/fax{
	fax_name = "Nanotrasen Consultant's Office";
	name = "Nanotrasen Consultant's Fax Machine"
	},
/obj/item/radio/intercom/command/directional/north,
/obj/machinery/light/warm/dim/directional/north,
/turf/open/floor/carpet/green,
/area/station/command/heads_quarters/nt_rep)
"h" = (
/obj/machinery/atmospherics/components/unary/vent_pump/on/layer4{
	dir = 4
	},
/obj/effect/turf_decal/tile/dark_green/opposingcorners,
/turf/open/floor/iron/dark,
/area/station/command/heads_quarters/nt_rep)
"i" = (
/obj/effect/turf_decal/siding/wood/corner{
	dir = 8
	},
/turf/closed/wall/r_wall,
/area/station/command/heads_quarters/nt_rep)
"j" = (
/obj/structure/cable,
/obj/effect/turf_decal/siding/dark{
	dir = 1
	},
/turf/open/floor/wood,
/area/station/command/heads_quarters/nt_rep)
"k" = (
/obj/machinery/firealarm/directional/east,
/obj/machinery/atmospherics/pipe/smart/manifold4w/supply/hidden/layer4,
/turf/open/floor/carpet/green,
/area/station/command/heads_quarters/nt_rep)
"l" = (
/obj/effect/turf_decal/siding/wood/corner{
	dir = 1
	},
/obj/machinery/vending/boozeomat,
/turf/closed/wall,
/area/station/command/heads_quarters/nt_rep)
"m" = (
/obj/machinery/button/door/directional/east{
	id = "nt_rep_priv"
	},
/obj/machinery/light_switch/directional/east{
	pixel_x = 32;
	pixel_y = -1
	},
/obj/machinery/newscaster/directional/north,
/obj/structure/filingcabinet/employment,
/obj/structure/filingcabinet/security{
	pixel_x = 10
	},
/obj/structure/filingcabinet/medical{
	pixel_x = -10
	},
/turf/open/floor/carpet/green,
/area/station/command/heads_quarters/nt_rep)
"n" = (
/obj/machinery/atmospherics/components/unary/vent_scrubber/on/layer2{
	dir = 4
	},
/obj/structure/cable,
/obj/effect/turf_decal/siding/dark{
	dir = 5
	},
/turf/open/floor/wood,
/area/station/command/heads_quarters/nt_rep)
"o" = (
/obj/effect/turf_decal/siding/wood{
	dir = 8
	},
/turf/closed/wall/r_wall,
/area/station/command/heads_quarters/nt_rep)
"p" = (
/obj/structure/sign/calendar/directional/west,
/obj/structure/aquarium/prefilled,
/obj/item/reagent_containers/cup/fish_feed{
	pixel_x = 1;
	pixel_y = 19
	},
/obj/effect/turf_decal/tile/dark_green/opposingcorners,
/turf/open/floor/iron/dark,
/area/station/command/heads_quarters/nt_rep)
"q" = (
/obj/structure/table/wood,
/obj/item/flashlight/lamp{
	pixel_y = 9
	},
/turf/open/floor/carpet/green,
/area/station/command/heads_quarters/nt_rep)
"r" = (
/obj/structure/cable,
/obj/machinery/atmospherics/pipe/smart/manifold4w/scrubbers/hidden/layer2,
/obj/machinery/atmospherics/pipe/smart/manifold4w/supply/hidden/layer4,
/obj/machinery/door/firedoor,
/obj/effect/landmark/navigate_destination/autoname,
/obj/effect/mapping_helpers/airlock/unres/delayed{
	dir = 1
	},
/obj/effect/turf_decal/siding/dark/corner{
	dir = 4
	},
/obj/effect/mapping_helpers/airlock/access/any/cent_com/rep_or_captain,
/obj/machinery/door/airlock/corporate{
	id_tag = "consultantdoor";
	name = "Consultant's Office"
	},
/turf/open/floor/iron/dark,
/area/station/command/heads_quarters/nt_rep)
"s" = (
/obj/structure/safe/abovetilefloor,
/obj/item/paperwork{
	desc = "A densely compiled stack of Internal Affairs records, documenting various investigations, audits and disciplinary proceedings, extensively redacted under CENTCOM authority.";
	name = "internal affairs records"
	},
/obj/item/folder/documents,
/obj/item/storage/fancy/cigarettes/cigars/cohiba,
/obj/item/storage/box/matches,
/obj/item/storage/toolbox/guncase/skyrat/pistol/sec_glock,
/obj/item/folder/ancient_paperwork,
/turf/open/floor/carpet/green,
/area/station/command/heads_quarters/nt_rep)
"t" = (
/obj/structure/flora/bush/grassy,
/obj/structure/flora/bush/flowers_yw,
/obj/structure/curtain/cloth/fancy/mechanical{
	icon_state = "bounty-open";
	icon_type = "bounty";
	id = "nt_rep_priv";
	name = "curtain"
	},
/obj/structure/curtain/cloth/fancy/mechanical{
	icon_state = "bounty-open";
	icon_type = "bounty";
	id = "nt_rep_priv";
	name = "curtain"
	},
/obj/structure/window/reinforced/fulltile,
/obj/structure/cable,
/turf/open/floor/grass,
/area/station/command/heads_quarters/nt_rep)
"u" = (
/obj/machinery/modular_computer/preset/time_clock,
/turf/closed/wall/r_wall,
/area/station/command/heads_quarters/nt_rep)
"v" = (
/obj/machinery/computer/station_goal,
/obj/structure/sign/poster/official/corporate_perks_vacation/directional/north,
/turf/open/floor/carpet/green,
/area/station/command/heads_quarters/nt_rep)
"w" = (
/obj/structure/table/wood,
/obj/item/paper_bin{
	pixel_y = 4;
	pixel_x = -5
	},
/obj/item/stamp/granted{
	pixel_y = 12;
	pixel_x = 8
	},
/obj/item/stamp/denied{
	pixel_x = 8;
	pixel_y = 6
	},
/obj/item/stamp/centcom{
	pixel_x = 8
	},
/obj/item/pen/fourcolor{
	pixel_x = -5;
	pixel_y = 5
	},
/obj/item/pen/fountain{
	pixel_x = -5;
	pixel_y = 5
	},
/turf/open/floor/carpet/green,
/area/station/command/heads_quarters/nt_rep)
"x" = (
/obj/machinery/atmospherics/pipe/smart/manifold4w/supply/hidden/layer4,
/obj/structure/chair/office{
	dir = 1
	},
/obj/structure/cable,
/obj/effect/turf_decal/siding/dark{
	dir = 1
	},
/turf/open/floor/wood,
/area/station/command/heads_quarters/nt_rep)
"A" = (
/obj/machinery/atmospherics/components/unary/vent_pump/on/layer4{
	dir = 8
	},
/obj/structure/cable,
/obj/effect/turf_decal/trimline/dark_green/filled/corner{
	dir = 4
	},
/obj/effect/turf_decal/trimline/dark_green/filled/corner{
	dir = 1
	},
/turf/open/floor/iron,
/area/station/command/heads_quarters/nt_rep)
"B" = (
/obj/machinery/light/warm/dim/directional/south,
/obj/effect/turf_decal/trimline/dark_green/filled/line,
/obj/machinery/light_switch/directional/south{
	pixel_x = -9
	},
/turf/open/floor/iron,
/area/station/command/heads_quarters/nt_rep)
"C" = (
/obj/structure/table/wood,
/obj/item/storage/box/drinkingglasses,
/obj/machinery/coffeemaker/impressa,
/obj/item/storage/box/coffeepack,
/turf/open/floor/wood,
/area/station/command/heads_quarters/nt_rep)
"E" = (
/obj/machinery/photocopier/prebuilt,
/obj/effect/turf_decal/tile/dark_green/opposingcorners,
/turf/open/floor/iron/dark,
/area/station/command/heads_quarters/nt_rep)
"F" = (
/obj/machinery/atmospherics/pipe/smart/manifold4w/supply/hidden/layer4,
/obj/effect/turf_decal/siding/dark{
	dir = 4
	},
/turf/open/floor/wood,
/area/station/command/heads_quarters/nt_rep)
"G" = (
/obj/machinery/atmospherics/pipe/smart/manifold4w/supply/hidden/layer4,
/obj/structure/table/wood,
/obj/item/clipboard{
	pixel_x = 4;
	pixel_y = 3
	},
/obj/item/reagent_containers/cup/glass/mug/nanotrasen,
/turf/open/floor/carpet/green,
/area/station/command/heads_quarters/nt_rep)
"H" = (
/obj/effect/landmark/start/nanotrasen_consultant,
/obj/structure/cable,
/obj/structure/chair/sofa/corp/left{
	desc = "Looks like someone threw it out. Covered in donut crumbs.";
	dir = 4;
	name = "couch"
	},
/obj/item/newspaper{
	pixel_x = 3;
	pixel_y = -8
	},
/obj/effect/turf_decal/siding/dark{
	dir = 1
	},
/turf/open/floor/wood,
/area/station/command/heads_quarters/nt_rep)
"I" = (
/obj/effect/turf_decal/tile/dark_green/opposingcorners,
/turf/open/floor/iron/dark,
/area/station/command/heads_quarters/nt_rep)
"J" = (
/obj/effect/turf_decal/tile/dark_green/opposingcorners,
/obj/structure/fireplace,
/turf/open/floor/iron/dark,
/area/station/command/heads_quarters/nt_rep)
"K" = (
/obj/machinery/chem_dispenser/drinks/beer{
	dir = 8
	},
/obj/machinery/firealarm/directional/east,
/obj/structure/table/wood/fancy/green,
/obj/effect/turf_decal/trimline/dark_green/filled/line{
	dir = 6
	},
/turf/open/floor/iron,
/area/station/command/heads_quarters/nt_rep)
"M" = (
/obj/structure/flora/bush/grassy,
/obj/structure/curtain/cloth/fancy/mechanical{
	icon_state = "bounty-open";
	icon_type = "bounty";
	id = "nt_rep_priv";
	name = "curtain"
	},
/obj/structure/flora/bush/flowers_br,
/obj/structure/curtain/cloth/fancy/mechanical{
	icon_state = "bounty-open";
	icon_type = "bounty";
	id = "nt_rep_priv";
	name = "curtain"
	},
/obj/structure/curtain/cloth/fancy/mechanical{
	icon_state = "bounty-open";
	icon_type = "bounty";
	id = "nt_rep_priv";
	name = "curtain"
	},
/obj/structure/window/reinforced/fulltile,
/obj/structure/cable,
/turf/open/floor/grass,
/area/station/command/heads_quarters/nt_rep)
"N" = (
/obj/machinery/atmospherics/pipe/smart/manifold4w/supply/hidden/layer4,
/obj/effect/landmark/start/nanotrasen_consultant,
/obj/effect/mapping_helpers/turn_off_lights_with_lightswitch,
/obj/structure/chair/office/tactical,
/turf/open/floor/carpet/green,
/area/station/command/heads_quarters/nt_rep)
"O" = (
/obj/structure/cable,
/obj/machinery/holopad,
/obj/effect/turf_decal/siding/dark{
	dir = 1
	},
/turf/open/floor/wood,
/area/station/command/heads_quarters/nt_rep)
"Q" = (
/obj/machinery/atmospherics/pipe/smart/manifold4w/scrubbers/hidden/layer2,
/obj/machinery/atmospherics/pipe/smart/manifold4w/supply/hidden/layer4,
/obj/structure/cable,
/obj/effect/turf_decal/trimline/dark_green/filled/line{
	dir = 8
	},
/obj/effect/turf_decal/trimline/dark_green/filled/corner,
/turf/open/floor/iron,
/area/station/command/heads_quarters/nt_rep)
"R" = (
/obj/effect/spawner/structure/window/reinforced,
/obj/structure/cable,
/obj/structure/curtain/cloth/fancy/mechanical{
	icon_state = "bounty-open";
	icon_type = "bounty";
	id = "nt_rep_priv";
	name = "curtain"
	},
/turf/open/floor/plating,
/area/station/command/heads_quarters/nt_rep)
"S" = (
/obj/structure/flora/bush/grassy,
/obj/structure/curtain/cloth/fancy/mechanical{
	icon_state = "bounty-open";
	icon_type = "bounty";
	id = "nt_rep_priv";
	name = "curtain"
	},
/obj/structure/flora/bush/flowers_pp,
/obj/structure/curtain/cloth/fancy/mechanical{
	icon_state = "bounty-open";
	icon_type = "bounty";
	id = "nt_rep_priv";
	name = "curtain"
	},
/obj/structure/curtain/cloth/fancy/mechanical{
	icon_state = "bounty-open";
	icon_type = "bounty";
	id = "nt_rep_priv";
	name = "curtain"
	},
/obj/structure/window/reinforced/fulltile,
/obj/structure/cable,
/turf/open/floor/grass,
/area/station/command/heads_quarters/nt_rep)
"T" = (
/obj/structure/closet/secure_closet/nanotrasen_consultant,
/obj/item/clothing/accessory/medal/gold/ordom,
/obj/item/clothing/accessory/medal/silver/bureaucracy,
/obj/item/hand_labeler,
/obj/structure/sign/poster/official/no_erp/directional/north,
/obj/item/taperecorder{
	name = "Captain's Log"
	},
/obj/structure/sign/flag/galfed/directional/east,
/obj/item/stack/sheet/mineral/wood/fifty,
/obj/item/lighter/royal,
/turf/open/floor/carpet/green,
/area/station/command/heads_quarters/nt_rep)
"U" = (
/obj/structure/bed/double,
/obj/item/bedsheet/centcom/double,
/obj/machinery/light/small/directional/east,
/obj/structure/sign/flag/nanotrasen/directional/east,
/turf/open/floor/carpet/green,
/area/station/command/heads_quarters/nt_rep)
"V" = (
/obj/machinery/power/apc/auto_name/directional/east,
/obj/machinery/chem_dispenser/drinks{
	dir = 8
	},
/obj/structure/cable,
/obj/structure/table/wood/fancy/green,
/obj/effect/turf_decal/trimline/dark_green/filled/line{
	dir = 5
	},
/turf/open/floor/iron,
/area/station/command/heads_quarters/nt_rep)
"W" = (
/obj/structure/dresser,
/obj/structure/secure_safe/directional/north,
/turf/open/floor/carpet/green,
/area/station/command/heads_quarters/nt_rep)
"X" = (
/obj/machinery/atmospherics/pipe/smart/manifold4w/scrubbers/hidden/layer2,
/obj/machinery/atmospherics/pipe/smart/manifold4w/supply/hidden/layer4,
/obj/structure/cable,
/obj/effect/turf_decal/trimline/dark_green/filled/line{
	dir = 9
	},
/turf/open/floor/iron,
/area/station/command/heads_quarters/nt_rep)
"Y" = (
/obj/structure/flora/bush/grassy,
/obj/structure/curtain/cloth/fancy/mechanical{
	icon_state = "bounty-open";
	icon_type = "bounty";
	id = "nt_rep_priv";
	name = "curtain"
	},
/obj/structure/flora/bush/flowers_pp/style_2,
/obj/structure/curtain/cloth/fancy/mechanical{
	icon_state = "bounty-open";
	icon_type = "bounty";
	id = "nt_rep_priv";
	name = "curtain"
	},
/obj/structure/window/reinforced/fulltile,
/obj/structure/cable,
/turf/open/floor/grass,
/area/station/command/heads_quarters/nt_rep)
"Z" = (
/obj/effect/mapping_helpers/requests_console/assistance,
/obj/effect/mapping_helpers/requests_console/supplies,
/obj/effect/mapping_helpers/requests_console/information,
/obj/effect/mapping_helpers/requests_console/announcement,
/obj/machinery/requests_console/auto_name/directional/east,
/obj/machinery/modular_computer/preset/command{
	dir = 8
	},
/turf/open/floor/carpet/green,
/area/station/command/heads_quarters/nt_rep)

(1,1,1) = {"
a
a
a
R
R
R
a
"}
(2,1,1) = {"
a
e
p
E
H
c
a
"}
(3,1,1) = {"
a
J
h
I
O
b
t
"}
(4,1,1) = {"
a
v
k
q
j
C
S
"}
(5,1,1) = {"
a
g
N
G
x
f
M
"}
(6,1,1) = {"
a
m
Z
w
n
F
Y
"}
(7,1,1) = {"
a
i
o
l
X
Q
r
"}
(8,1,1) = {"
a
W
s
d
A
B
a
"}
(9,1,1) = {"
a
T
U
a
V
K
u
"}
(10,1,1) = {"
a
a
a
a
a
a
a
"}
