//MAP CONVERTED BY dmm2tgm.py THIS HEADER COMMENT PREVENTS RECONVERSION, DO NOT REMOVE
"a" = (
/turf/closed/wall,
/area/station/command/heads_quarters/nt_rep)
"b" = (
/obj/machinery/modular_computer/preset/command{
	dir = 1
	},
/obj/structure/cable,
/turf/open/floor/carpet/executive,
/area/station/command/heads_quarters/nt_rep)
"c" = (
/obj/structure/table/wood,
/obj/item/paper_bin/carbon{
	pixel_y = 4;
	pixel_x = -4
	},
/obj/item/pen/fountain{
	pixel_x = -4;
	pixel_y = 6
	},
/obj/item/stamp{
	pixel_x = 8;
	pixel_y = 8
	},
/obj/item/stamp/denied{
	pixel_x = 8
	},
/obj/machinery/button/door/directional/south{
	pixel_x = -12;
	id = "nt_rep_priv"
	},
/obj/item/radio/intercom/command/directional/south,
/turf/open/floor/carpet/executive,
/area/station/command/heads_quarters/nt_rep)
"d" = (
/obj/machinery/door/airlock/corporate{
	name = "NT Consultant's Office"
	},
/obj/machinery/door/firedoor,
/obj/effect/mapping_helpers/airlock/access/all/cent_com/rep_door,
/turf/open/floor/carpet/executive,
/area/station/command/heads_quarters/nt_rep)
"e" = (
/obj/structure/grandfatherclock,
/turf/open/floor/wood,
/area/station/command/heads_quarters/nt_rep)
"f" = (
/obj/effect/spawner/structure/window/reinforced,
/obj/machinery/door/poddoor/preopen{
	id = "nt_rep_priv";
	name = "Privacy Shutter"
	},
/obj/structure/cable,
/turf/open/floor/plating,
/area/station/command/heads_quarters/nt_rep)
"g" = (
/obj/machinery/firealarm/directional/north,
/obj/structure/chair/comfy/black,
/turf/open/floor/wood,
/area/station/command/heads_quarters/nt_rep)
"h" = (
/obj/effect/turf_decal/siding/wood,
/obj/machinery/atmospherics/components/unary/vent_pump/on/layer4{
	dir = 4
	},
/turf/open/floor/wood,
/area/station/command/heads_quarters/nt_rep)
"i" = (
/obj/effect/turf_decal/siding/wood/corner{
	dir = 8
	},
/turf/closed/wall,
/area/station/command/heads_quarters/nt_rep)
"j" = (
/obj/structure/cable,
/turf/open/floor/wood,
/area/station/command/heads_quarters/nt_rep)
"k" = (
/obj/effect/turf_decal/siding/wood{
	dir = 8
	},
/obj/machinery/atmospherics/pipe/smart/manifold4w/supply/hidden/layer4,
/obj/structure/chair/comfy/beige{
	dir = 8
	},
/turf/open/floor/wood,
/area/station/command/heads_quarters/nt_rep)
"l" = (
/obj/effect/turf_decal/siding/wood/corner{
	dir = 1
	},
/obj/machinery/vending/boozeomat/all_access,
/turf/closed/wall,
/area/station/command/heads_quarters/nt_rep)
"m" = (
/obj/effect/turf_decal/siding/wood,
/obj/item/kirbyplants/random,
/obj/machinery/light_switch/directional/north,
/obj/machinery/power/apc/auto_name/directional/east,
/obj/structure/cable,
/turf/open/floor/wood,
/area/station/command/heads_quarters/nt_rep)
"n" = (
/obj/machinery/atmospherics/components/unary/vent_scrubber/on/layer2{
	dir = 4
	},
/obj/structure/cable,
/turf/open/floor/wood,
/area/station/command/heads_quarters/nt_rep)
"o" = (
/obj/effect/turf_decal/siding/wood{
	dir = 8
	},
/turf/closed/wall,
/area/station/command/heads_quarters/nt_rep)
"p" = (
/obj/effect/turf_decal/siding/wood,
/obj/structure/extinguisher_cabinet/directional/west,
/turf/open/floor/wood,
/area/station/command/heads_quarters/nt_rep)
"q" = (
/obj/machinery/holopad,
/obj/effect/turf_decal/bot,
/obj/structure/cable,
/turf/open/floor/wood,
/area/station/command/heads_quarters/nt_rep)
"r" = (
/obj/structure/cable,
/obj/machinery/door/airlock/corporate{
	name = "NT Consultant's Office"
	},
/obj/machinery/atmospherics/pipe/smart/manifold4w/scrubbers/hidden/layer2,
/obj/machinery/atmospherics/pipe/smart/manifold4w/supply/hidden/layer4,
/obj/machinery/door/firedoor,
/obj/effect/mapping_helpers/airlock/access/all/cent_com/rep_door,
/turf/open/floor/wood,
/area/station/command/heads_quarters/nt_rep)
"s" = (
/turf/open/floor/carpet/executive,
/area/station/command/heads_quarters/nt_rep)
"t" = (
/obj/structure/table/wood,
/obj/item/stamp/centcom{
	pixel_y = 10
	},
/turf/open/floor/carpet/executive,
/area/station/command/heads_quarters/nt_rep)
"u" = (
/obj/machinery/time_clock,
/turf/closed/wall,
/area/station/command/heads_quarters/nt_rep)
"v" = (
/obj/machinery/airalarm/directional/north,
/obj/structure/chair/comfy/black,
/turf/open/floor/wood,
/area/station/command/heads_quarters/nt_rep)
"w" = (
/obj/effect/spawner/structure/window/reinforced,
/obj/structure/cable,
/obj/machinery/door/poddoor/preopen{
	id = "nt_rep_priv";
	name = "Privacy Shutter"
	},
/turf/open/floor/iron,
/area/station/command/heads_quarters/nt_rep)
"x" = (
/obj/effect/turf_decal/siding/wood/corner{
	dir = 4
	},
/obj/effect/turf_decal/siding/wood{
	dir = 8
	},
/obj/machinery/atmospherics/pipe/smart/manifold4w/supply/hidden/layer4,
/obj/structure/chair/comfy/beige{
	dir = 8
	},
/turf/open/floor/wood,
/area/station/command/heads_quarters/nt_rep)
"y" = (
/obj/effect/turf_decal/siding/wood,
/obj/machinery/atmospherics/pipe/smart/manifold4w/supply/hidden/layer4,
/obj/structure/table/wood,
/turf/open/floor/wood,
/area/station/command/heads_quarters/nt_rep)
"A" = (
/obj/effect/turf_decal/siding/wood{
	dir = 1
	},
/obj/machinery/atmospherics/components/unary/vent_pump/on/layer4{
	dir = 8
	},
/turf/open/floor/wood,
/area/station/command/heads_quarters/nt_rep)
"B" = (
/turf/open/floor/wood,
/area/station/command/heads_quarters/nt_rep)
"C" = (
/obj/structure/table/wood,
/obj/item/camera{
	pixel_x = 6;
	pixel_y = 3
	},
/obj/item/camera_film{
	pixel_x = -5;
	pixel_y = 3
	},
/obj/item/camera_film{
	pixel_x = -4;
	pixel_y = 7
	},
/turf/open/floor/carpet/executive,
/area/station/command/heads_quarters/nt_rep)
"E" = (
/obj/structure/table/wood,
/obj/machinery/fax{
	fax_name = "Nanotrasen Consultant's Office";
	name = "Nanotrasen Consultant's Fax Machine"
	},
/turf/open/floor/carpet/executive,
/area/station/command/heads_quarters/nt_rep)
"F" = (
/obj/machinery/atmospherics/pipe/smart/manifold4w/supply/hidden/layer4,
/turf/open/floor/wood,
/area/station/command/heads_quarters/nt_rep)
"G" = (
/obj/machinery/atmospherics/pipe/smart/manifold4w/supply/hidden/layer4,
/obj/structure/cable,
/obj/effect/landmark/navigate_destination/autoname,
/turf/open/floor/wood,
/area/station/command/heads_quarters/nt_rep)
"H" = (
/obj/effect/landmark/start/nanotrasen_consultant,
/obj/structure/cable,
/turf/open/floor/carpet/executive,
/area/station/command/heads_quarters/nt_rep)
"I" = (
/obj/structure/cable,
/turf/open/floor/carpet/executive,
/area/station/command/heads_quarters/nt_rep)
"J" = (
/obj/machinery/status_display/evac/directional/north,
/obj/machinery/light/warm/directional/north,
/turf/open/floor/wood,
/area/station/command/heads_quarters/nt_rep)
"K" = (
/obj/machinery/photocopier,
/turf/open/floor/wood,
/area/station/command/heads_quarters/nt_rep)
"M" = (
/obj/structure/cable,
/obj/machinery/atmospherics/pipe/smart/manifold4w/scrubbers/hidden/layer2,
/obj/machinery/atmospherics/pipe/smart/manifold4w/supply/hidden/layer4,
/turf/open/floor/wood,
/area/station/command/heads_quarters/nt_rep)
"N" = (
/obj/machinery/atmospherics/pipe/smart/manifold4w/supply/hidden/layer4,
/obj/structure/table/wood,
/turf/open/floor/wood,
/area/station/command/heads_quarters/nt_rep)
"O" = (
/obj/structure/chair/office/tactical{
	dir = 4
	},
/obj/structure/cable,
/turf/open/floor/carpet/executive,
/area/station/command/heads_quarters/nt_rep)
"Q" = (
/obj/structure/cable,
/obj/effect/turf_decal/siding/wood{
	dir = 1
	},
/obj/machinery/atmospherics/pipe/smart/manifold4w/scrubbers/hidden/layer2,
/obj/machinery/atmospherics/pipe/smart/manifold4w/supply/hidden/layer4,
/turf/open/floor/wood,
/area/station/command/heads_quarters/nt_rep)
"R" = (
/obj/structure/sign/flag/nanotrasen,
/turf/closed/wall,
/area/station/command/heads_quarters/nt_rep)
"T" = (
/obj/structure/closet/secure_closet/nanotrasen_consultant/station,
/turf/open/floor/carpet/executive,
/area/station/command/heads_quarters/nt_rep)
"U" = (
/obj/machinery/status_display/ai/directional/east,
/obj/structure/bed/double,
/obj/item/bedsheet/centcom/double,
/obj/machinery/light/small/blacklight/directional/east{
	desc = "A small lighting fixture. Why is this here?"
	},
/obj/structure/sign/calendar/directional/south,
/turf/open/floor/carpet/executive,
/area/station/command/heads_quarters/nt_rep)
"V" = (
/obj/structure/filingcabinet/chestdrawer,
/obj/effect/turf_decal/siding/wood{
	dir = 1
	},
/obj/machinery/light/warm/directional/east,
/turf/open/floor/wood,
/area/station/command/heads_quarters/nt_rep)
"W" = (
/obj/machinery/newscaster/directional/north,
/obj/structure/filingcabinet/chestdrawer,
/turf/open/floor/carpet/executive,
/area/station/command/heads_quarters/nt_rep)
"Z" = (
/obj/structure/chair/comfy/black{
	dir = 8
	},
/obj/machinery/light/warm/directional/east,
/obj/structure/cable,
/turf/open/floor/wood,
/area/station/command/heads_quarters/nt_rep)

(1,1,1) = {"
a
a
a
w
w
a
a
"}
(2,1,1) = {"
a
e
p
E
H
c
a
"}
(3,1,1) = {"
a
J
h
I
O
b
f
"}
(4,1,1) = {"
a
v
y
q
t
C
f
"}
(5,1,1) = {"
a
g
N
G
x
k
a
"}
(6,1,1) = {"
a
m
Z
j
n
F
R
"}
(7,1,1) = {"
a
i
o
l
Q
M
r
"}
(8,1,1) = {"
a
W
s
d
A
B
u
"}
(9,1,1) = {"
a
T
U
a
V
K
a
"}
(10,1,1) = {"
a
a
a
a
a
a
a
"}
