//MAP CONVERTED BY dmm2tgm.py THIS HEADER COMMENT PREVENTS RECONVERSION, DO NOT REMOVE
"a" = (
/obj/structure/chair,
/obj/effect/turf_decal/trimline/red/filled/line{
	dir = 1
	},
/obj/effect/turf_decal/trimline/red/corner{
	dir = 8
	},
/obj/effect/decal/cleanable/dirt,
/obj/machinery/flasher/directional/north{
	id = "crgcell"
	},
/turf/open/floor/iron,
/area/station/security/checkpoint/supply)
"b" = (
/obj/machinery/status_display/door_timer{
	name = "Cargo Cell";
	pixel_x = 32;
	id = "crgcell"
	},
/obj/effect/turf_decal/trimline/red/filled/line{
	dir = 4
	},
/obj/effect/turf_decal/trimline/red/filled/corner{
	dir = 8
	},
/turf/open/floor/iron,
/area/station/security/checkpoint/supply)
"c" = (
/obj/structure/chair,
/obj/effect/turf_decal/trimline/red/filled/line{
	dir = 1
	},
/obj/effect/turf_decal/trimline/red/corner,
/obj/effect/decal/cleanable/dirt,
/obj/machinery/atmospherics/components/unary/vent_pump/on/layer4,
/obj/item/radio/intercom/prison/directional/north,
/turf/open/floor/iron,
/area/station/security/checkpoint/supply)
"e" = (
/obj/effect/turf_decal/trimline/red/arrow_cw{
	dir = 8
	},
/obj/effect/decal/cleanable/dirt,
/obj/structure/cable,
/obj/machinery/atmospherics/pipe/smart/manifold4w/supply/hidden/layer4,
/obj/machinery/atmospherics/pipe/smart/manifold4w/scrubbers/hidden/layer2,
/turf/open/floor/iron,
/area/station/security/checkpoint/supply)
"f" = (
/obj/effect/turf_decal/trimline/red/filled/line{
	dir = 4
	},
/obj/machinery/atmospherics/components/unary/vent_scrubber/on/layer2{
	dir = 1
	},
/turf/open/floor/iron,
/area/station/security/checkpoint/supply)
"g" = (
/obj/structure/closet/secure_closet/brig{
	name = "Cargo Cell Locker";
	id = "crgcell"
	},
/obj/effect/turf_decal/trimline/red/filled/line,
/obj/effect/turf_decal/trimline/red/corner{
	dir = 1
	},
/obj/effect/decal/cleanable/dirt,
/turf/open/floor/iron,
/area/station/security/checkpoint/supply)
"h" = (
/turf/closed/wall/r_wall,
/area/station/security/checkpoint/supply)
"j" = (
/turf/open/openspace,
/area/station/security/checkpoint/supply)
"l" = (
/obj/structure/chair/office{
	dir = 8
	},
/obj/structure/railing{
	dir = 4
	},
/obj/effect/turf_decal/trimline/red/filled/line{
	dir = 5
	},
/obj/machinery/requests_console/directional/north{
	name = "Security Requests Console";
	department = "Security"
	},
/obj/effect/landmark/start/customs_agent,
/turf/open/floor/iron,
/area/station/security/checkpoint/supply)
"q" = (
/obj/machinery/door/airlock/security/glass{
	name = "Security Post - Cargo"
	},
/obj/effect/turf_decal/trimline/red/filled/line{
	dir = 4
	},
/obj/effect/turf_decal/trimline/red/filled/line{
	dir = 8
	},
/obj/effect/mapping_helpers/airlock/access/all/supply/customs,
/turf/open/floor/iron,
/area/station/security/checkpoint/supply)
"s" = (
/obj/machinery/door/airlock/security/glass{
	name = "Security Post - Cargo";
	id_tag = "crgdoor"
	},
/obj/machinery/door/firedoor,
/obj/effect/turf_decal/trimline/red/filled/corner{
	dir = 4
	},
/obj/effect/turf_decal/trimline/red/filled/corner,
/obj/structure/cable,
/obj/machinery/atmospherics/pipe/smart/manifold4w/supply/hidden/layer4,
/obj/machinery/atmospherics/pipe/smart/manifold4w/scrubbers/hidden/layer2,
/obj/effect/mapping_helpers/airlock/access/all/supply/customs,
/turf/open/floor/iron,
/area/station/security/checkpoint/supply)
"w" = (
/obj/structure/closet/firecloset,
/obj/effect/turf_decal/siding/thinplating/dark{
	dir = 9
	},
/obj/effect/landmark/start/hangover/closet,
/obj/effect/turf_decal/tile/neutral/fourcorners,
/turf/open/floor/iron/dark,
/area/station/hallway/primary/tram/right)
"z" = (
/turf/closed/wall/r_wall,
/area/station/maintenance/department/cargo)
"A" = (
/obj/structure/railing/corner{
	dir = 4
	},
/obj/effect/turf_decal/trimline/red/filled/line,
/obj/effect/turf_decal/trimline/red/corner{
	dir = 4
	},
/obj/machinery/atmospherics/components/unary/vent_pump/on/layer4{
	dir = 4
	},
/obj/machinery/light/small/directional/south,
/obj/item/radio/intercom/directional/south,
/turf/open/floor/iron,
/area/station/security/checkpoint/supply)
"B" = (
/obj/machinery/camera/directional/west{
	network = list("ss13","Security","cargo");
	c_tag = "Cargo - Security Outpost"
	},
/obj/effect/turf_decal/trimline/red/filled/line{
	dir = 8
	},
/obj/structure/cable,
/turf/open/floor/iron,
/area/station/security/checkpoint/supply)
"C" = (
/obj/machinery/power/apc/auto_name/directional/west,
/obj/effect/turf_decal/trimline/red/filled/line{
	dir = 10
	},
/obj/structure/cable,
/obj/machinery/light_switch/directional/south{
	pixel_x = 10;
	pixel_y = -24
	},
/obj/machinery/button/door/directional/south{
	id = "crgdoor";
	req_access = list("brig_entrance");
	name = "Cargo Cell Control";
	normaldoorcontrol = 1
	},
/turf/open/floor/iron,
/area/station/security/checkpoint/supply)
"D" = (
/obj/effect/turf_decal/trimline/red/filled/line,
/obj/effect/turf_decal/trimline/red/corner{
	dir = 4
	},
/obj/effect/decal/cleanable/dirt,
/obj/machinery/atmospherics/components/unary/vent_scrubber/on/layer2{
	dir = 1
	},
/obj/machinery/light/directional/south,
/turf/open/floor/iron,
/area/station/security/checkpoint/supply)
"F" = (
/turf/template_noop,
/area/template_noop)
"H" = (
/obj/machinery/door/window/brigdoor/left/directional/east{
	name = "Cargo Cell";
	id = "crgcell";
	req_access = list("security")
	},
/obj/effect/turf_decal/trimline/red/filled/corner{
	dir = 8
	},
/obj/effect/turf_decal/trimline/red/filled/corner{
	dir = 1
	},
/obj/structure/cable,
/obj/machinery/atmospherics/pipe/smart/manifold4w/supply/hidden/layer4,
/obj/machinery/atmospherics/pipe/smart/manifold4w/scrubbers/hidden/layer2,
/obj/effect/turf_decal/tile/red/half/contrasted{
	dir = 4
	},
/obj/effect/mapping_helpers/airlock/access/all/supply/customs,
/turf/open/floor/iron,
/area/station/security/checkpoint/supply)
"I" = (
/obj/effect/turf_decal/trimline/red/filled/corner{
	dir = 8
	},
/obj/effect/turf_decal/trimline/red/filled/line{
	dir = 1
	},
/obj/effect/turf_decal/trimline/neutral/filled/warning{
	dir = 1
	},
/obj/structure/cable,
/obj/machinery/atmospherics/pipe/smart/manifold4w/supply/hidden/layer4,
/turf/open/floor/iron,
/area/station/security/checkpoint/supply)
"K" = (
/obj/structure/table/reinforced,
/obj/effect/turf_decal/trimline/red/filled/line{
	dir = 9
	},
/obj/machinery/firealarm/directional/north,
/obj/machinery/computer/security/telescreen/cargo_sec/directional/west,
/turf/open/floor/iron,
/area/station/security/checkpoint/supply)
"L" = (
/obj/effect/landmark/event_spawn,
/obj/effect/turf_decal/trimline/red/filled/corner,
/obj/effect/turf_decal/trimline/red/filled/line{
	dir = 1
	},
/obj/effect/turf_decal/trimline/neutral/filled/warning{
	dir = 1
	},
/obj/structure/cable,
/obj/machinery/atmospherics/pipe/smart/manifold4w/supply/hidden/layer4,
/obj/machinery/atmospherics/pipe/smart/manifold4w/scrubbers/hidden/layer2,
/turf/open/floor/iron,
/area/station/security/checkpoint/supply)
"M" = (
/obj/effect/spawner/structure/window/reinforced,
/obj/structure/cable,
/turf/open/floor/plating,
/area/station/security/checkpoint/supply)
"N" = (
/turf/closed/wall/r_wall,
/area/station/hallway/primary/tram/right)
"O" = (
/obj/structure/sign/clock/directional/north,
/turf/open/openspace,
/area/station/security/checkpoint/supply)
"P" = (
/obj/structure/table/reinforced,
/obj/effect/turf_decal/trimline/red/filled/line{
	dir = 10
	},
/obj/machinery/newscaster/directional/south,
/obj/machinery/airalarm/directional/west,
/turf/open/floor/iron,
/area/station/security/checkpoint/supply)
"Q" = (
/turf/closed/wall,
/area/station/hallway/primary/tram/right)
"U" = (
/obj/effect/turf_decal/trimline/red/arrow_cw{
	dir = 4
	},
/obj/effect/decal/cleanable/dirt,
/obj/structure/cable,
/obj/machinery/atmospherics/pipe/smart/manifold4w/supply/hidden/layer4,
/obj/machinery/atmospherics/pipe/smart/manifold4w/scrubbers/hidden/layer2,
/turf/open/floor/iron,
/area/station/security/checkpoint/supply)
"W" = (
/obj/structure/closet/emcloset,
/obj/effect/turf_decal/siding/thinplating/dark{
	dir = 5
	},
/obj/effect/landmark/start/hangover/closet,
/obj/effect/turf_decal/tile/neutral/fourcorners,
/turf/open/floor/iron/dark,
/area/station/hallway/primary/tram/right)

(1,1,1) = {"
z
z
z
z
F
F
"}
(2,1,1) = {"
z
K
P
z
F
F
"}
(3,1,1) = {"
z
l
A
z
z
z
"}
(4,1,1) = {"
z
O
I
B
C
N
"}
(5,1,1) = {"
h
j
L
f
b
q
"}
(6,1,1) = {"
h
M
H
M
h
N
"}
(7,1,1) = {"
h
c
U
D
h
w
"}
(8,1,1) = {"
h
a
e
g
h
W
"}
(9,1,1) = {"
h
M
s
M
h
Q
"}
