//MAP CONVERTED BY dmm2tgm.py THIS HEADER COMMENT PREVENTS RECONVERSION, DO NOT REMOVE
"a" = (
/obj/effect/turf_decal/trimline/red/filled/line{
	dir = 9
	},
/obj/machinery/computer/records/security{
	dir = 4
	},
/turf/open/floor/iron,
/area/station/security/checkpoint/medical)
"f" = (
/obj/effect/turf_decal/trimline/red/filled/line{
	dir = 1
	},
/obj/structure/sign/clock/directional/north,
/obj/machinery/atmospherics/components/unary/vent_scrubber/on/layer2,
/turf/open/floor/iron,
/area/station/security/checkpoint/medical)
"i" = (
/obj/structure/table,
/obj/machinery/recharger{
	pixel_y = 4
	},
/obj/effect/turf_decal/trimline/red/filled/line{
	dir = 8
	},
/obj/machinery/light/directional/west,
/turf/open/floor/iron,
/area/station/security/checkpoint/medical)
"j" = (
/obj/effect/turf_decal/trimline/red/filled/corner,
/obj/effect/turf_decal/trimline/red/filled/corner{
	dir = 4
	},
/obj/machinery/atmospherics/pipe/smart/manifold4w/supply/hidden/layer4,
/obj/effect/landmark/event_spawn,
/turf/open/floor/iron,
/area/station/security/checkpoint/medical)
"m" = (
/obj/effect/spawner/structure/window/reinforced,
/obj/structure/cable,
/turf/open/floor/plating,
/area/station/security/checkpoint/medical)
"n" = (
/turf/closed/wall,
/area/station/medical/morgue)
"p" = (
/obj/effect/turf_decal/trimline/red/filled/corner,
/obj/effect/turf_decal/trimline/red/filled/corner{
	dir = 8
	},
/obj/structure/cable,
/obj/machinery/atmospherics/pipe/smart/manifold4w/scrubbers/hidden/layer2,
/obj/machinery/atmospherics/pipe/smart/manifold4w/supply/hidden/layer4,
/turf/open/floor/iron,
/area/station/security/checkpoint/medical)
"r" = (
/turf/closed/wall,
/area/station/asteroid)
"s" = (
/obj/machinery/door/window/brigdoor/right/directional/east{
	name = "Medical Cell";
	id = "medcell";
	req_access = list("security")
	},
/obj/effect/turf_decal/trimline/red/filled/line,
/obj/effect/turf_decal/trimline/red/filled/line{
	dir = 1
	},
/obj/machinery/atmospherics/components/unary/vent_pump/on/layer4{
	dir = 8
	},
/turf/open/floor/iron,
/area/station/security/checkpoint/medical)
"v" = (
/obj/structure/chair{
	dir = 1
	},
/obj/effect/turf_decal/trimline/red/filled/line{
	dir = 10
	},
/turf/open/floor/iron,
/area/station/security/checkpoint/medical)
"z" = (
/obj/machinery/status_display/door_timer{
	name = "Medical Cell";
	pixel_y = 32;
	id = "medcell"
	},
/obj/effect/turf_decal/trimline/red/filled/line{
	dir = 5
	},
/obj/machinery/camera/directional/north{
	network = list("ss13","medbay","Security");
	c_tag = "Medical - Security Checkpoint"
	},
/turf/open/floor/iron,
/area/station/security/checkpoint/medical)
"B" = (
/turf/closed/wall,
/area/station/hallway/primary/tram/center)
"E" = (
/obj/machinery/flasher/directional/east{
	id = "medcell"
	},
/obj/effect/turf_decal/trimline/red/filled/line{
	dir = 4
	},
/turf/open/floor/iron,
/area/station/security/checkpoint/medical)
"G" = (
/obj/effect/turf_decal/trimline/red/filled/line{
	dir = 5
	},
/obj/item/radio/intercom/prison/directional/east,
/obj/machinery/light/small/directional/north,
/turf/open/floor/iron,
/area/station/security/checkpoint/medical)
"J" = (
/obj/structure/closet/secure_closet/security/med,
/obj/item/clothing/mask/whistle,
/obj/effect/turf_decal/trimline/red/filled/line{
	dir = 6
	},
/obj/machinery/airalarm/directional/south,
/turf/open/floor/iron,
/area/station/security/checkpoint/medical)
"K" = (
/turf/closed/wall,
/area/station/security/checkpoint/medical)
"L" = (
/obj/effect/turf_decal/trimline/red/filled/corner{
	dir = 1
	},
/obj/effect/turf_decal/trimline/red/filled/corner{
	dir = 8
	},
/turf/open/floor/iron,
/area/station/security/checkpoint/medical)
"M" = (
/obj/effect/spawner/structure/window/reinforced,
/turf/open/floor/plating,
/area/station/security/checkpoint/medical)
"N" = (
/obj/structure/table,
/obj/item/radio{
	pixel_x = -6;
	pixel_y = -3
	},
/obj/item/book/manual/wiki/security_space_law{
	pixel_x = 9;
	pixel_y = 4
	},
/obj/effect/turf_decal/trimline/red/filled/line{
	dir = 10
	},
/obj/machinery/firealarm/directional/west{
	pixel_y = 5
	},
/obj/machinery/light_switch/directional/west{
	pixel_x = -22;
	pixel_y = -9
	},
/turf/open/floor/iron,
/area/station/security/checkpoint/medical)
"P" = (
/obj/structure/cable,
/obj/machinery/atmospherics/pipe/smart/manifold4w/scrubbers/hidden/layer2,
/obj/machinery/atmospherics/pipe/smart/manifold4w/supply/hidden/layer4,
/turf/open/floor/iron,
/area/station/security/checkpoint/medical)
"R" = (
/obj/machinery/atmospherics/pipe/smart/manifold4w/supply/hidden/layer4,
/obj/machinery/atmospherics/pipe/smart/manifold4w/scrubbers/hidden/layer2,
/turf/open/floor/iron,
/area/station/security/checkpoint/medical)
"S" = (
/obj/effect/turf_decal/trimline/red/filled/line{
	dir = 4
	},
/obj/effect/turf_decal/trimline/red/filled/line{
	dir = 8
	},
/obj/machinery/door/airlock/security/glass{
	name = "Security Outpost - Medical"
	},
/obj/structure/cable,
/obj/machinery/atmospherics/pipe/smart/manifold4w/scrubbers/hidden/layer2,
/obj/machinery/atmospherics/pipe/smart/manifold4w/supply/hidden/layer4,
/obj/effect/mapping_helpers/airlock/access/all/medical/orderly,
/turf/open/floor/iron,
/area/station/security/checkpoint/medical)
"T" = (
/obj/effect/turf_decal/trimline/red/filled/line{
	dir = 6
	},
/turf/open/floor/iron,
/area/station/security/checkpoint/medical)
"U" = (
/obj/effect/turf_decal/trimline/red/filled/line{
	dir = 1
	},
/obj/structure/chair/office{
	dir = 8
	},
/obj/machinery/power/apc/auto_name/directional/north,
/obj/structure/cable,
/obj/effect/landmark/start/orderly,
/turf/open/floor/iron,
/area/station/security/checkpoint/medical)
"W" = (
/obj/effect/turf_decal/trimline/red/filled/line,
/obj/effect/landmark/start/orderly,
/turf/open/floor/iron,
/area/station/security/checkpoint/medical)
"Y" = (
/obj/structure/closet/secure_closet/brig{
	name = "Medical Cell Locker";
	id = "medcell"
	},
/obj/effect/turf_decal/trimline/red/filled/line{
	dir = 9
	},
/turf/open/floor/iron,
/area/station/security/checkpoint/medical)

(1,1,1) = {"
B
K
K
K
K
"}
(2,1,1) = {"
B
a
i
N
m
"}
(3,1,1) = {"
B
U
P
p
S
"}
(4,1,1) = {"
B
f
R
W
m
"}
(5,1,1) = {"
B
z
j
J
n
"}
(6,1,1) = {"
B
M
s
M
n
"}
(7,1,1) = {"
B
Y
L
v
n
"}
(8,1,1) = {"
B
G
E
T
n
"}
(9,1,1) = {"
r
K
K
K
n
"}
