//MAP CONVERTED BY dmm2tgm.py THIS HEADER COMMENT PREVENTS RECONVERSION, DO NOT REMOVE
"a" = (
/turf/closed/wall/r_wall,
/area/station/command/heads_quarters/blueshield)
"b" = (
/obj/structure/cable,
/obj/machinery/atmospherics/pipe/smart/manifold4w/supply/hidden/layer4,
/obj/machinery/atmospherics/pipe/smart/manifold4w/scrubbers/hidden/layer2,
/turf/open/floor/carpet,
/area/station/command/heads_quarters/captain)
"c" = (
/obj/structure/chair/comfy/brown,
/obj/structure/cable,
/obj/machinery/atmospherics/pipe/smart/manifold4w/scrubbers/hidden/layer2,
/turf/open/floor/carpet,
/area/station/command/heads_quarters/captain)
"d" = (
/obj/structure/cable,
/obj/machinery/atmospherics/pipe/smart/manifold4w/supply/hidden/layer4,
/obj/machinery/atmospherics/pipe/smart/manifold4w/scrubbers/hidden/layer2,
/obj/effect/turf_decal/tile/dark_blue/opposingcorners,
/obj/machinery/photocopier/prebuilt,
/obj/machinery/camera/directional/south{
	c_tag = "Blueshield's Office"
	},
/obj/effect/turf_decal/bot,
/obj/machinery/light_switch/directional/west,
/obj/machinery/power/apc/auto_name/directional/south,
/turf/open/floor/iron/dark,
/area/station/command/heads_quarters/blueshield)
"g" = (
/obj/structure/closet/secure_closet/blueshield,
/obj/effect/turf_decal/delivery/red,
/obj/item/taperecorder{
	name = "Captain's Log"
	},
/obj/item/modular_computer/laptop/preset/security{
	pixel_y = 5
	},
/obj/item/clothing/gloves/tackler/combat/insulated/blueshield,
/obj/machinery/atmospherics/components/unary/vent_scrubber/on/layer2{
	dir = 8
	},
/obj/structure/sign/poster/official/obey/directional/east,
/obj/effect/turf_decal/siding/thinplating_new/dark{
	dir = 8
	},
/turf/open/floor/iron/dark/small,
/area/station/command/heads_quarters/blueshield)
"h" = (
/obj/effect/landmark/start/blueshield,
/turf/open/floor/wood,
/area/station/command/heads_quarters/blueshield)
"i" = (
/obj/structure/table/wood/fancy/blue,
/obj/machinery/computer/security/wooden_tv{
	pixel_y = 10
	},
/obj/item/book/manual/wiki/security_space_law{
	pixel_y = 3;
	pixel_x = 7
	},
/turf/open/floor/wood,
/area/station/command/heads_quarters/blueshield)
"j" = (
/obj/machinery/computer/records/medical{
	dir = 8
	},
/obj/machinery/requests_console/auto_name/directional/east,
/obj/effect/mapping_helpers/requests_console/assistance,
/obj/effect/mapping_helpers/requests_console/supplies,
/obj/effect/mapping_helpers/requests_console/information,
/obj/effect/mapping_helpers/requests_console/announcement,
/obj/machinery/light/directional/east,
/turf/open/floor/carpet/blue,
/area/station/command/heads_quarters/blueshield)
"k" = (
/turf/closed/wall/r_wall,
/area/station/command/heads_quarters/captain/private)
"l" = (
/obj/structure/cable,
/obj/machinery/atmospherics/pipe/smart/manifold4w/supply/hidden/layer4,
/obj/machinery/atmospherics/pipe/smart/manifold4w/scrubbers/hidden/layer2,
/turf/open/floor/wood,
/area/station/command/heads_quarters/captain)
"m" = (
/obj/machinery/atmospherics/pipe/smart/manifold4w/supply/hidden/layer4,
/obj/machinery/atmospherics/pipe/smart/manifold4w/scrubbers/hidden/layer2,
/turf/open/floor/carpet/blue,
/area/station/command/heads_quarters/blueshield)
"n" = (
/obj/machinery/atmospherics/components/unary/vent_pump/on/layer4{
	dir = 8
	},
/turf/open/floor/carpet,
/area/station/command/heads_quarters/captain)
"p" = (
/obj/machinery/computer/crew{
	dir = 8
	},
/obj/machinery/camera/directional/east,
/obj/machinery/firealarm/directional/north,
/obj/machinery/newscaster/directional/east,
/turf/open/floor/carpet/blue,
/area/station/command/heads_quarters/blueshield)
"q" = (
/obj/machinery/requests_console/directional/east{
	name = "Captain's Requests Console";
	department = "Captain's Desk"
	},
/obj/effect/mapping_helpers/requests_console/announcement,
/obj/effect/mapping_helpers/requests_console/assistance,
/obj/machinery/computer/communications{
	dir = 8
	},
/turf/open/floor/wood,
/area/station/command/heads_quarters/captain)
"r" = (
/obj/machinery/keycard_auth/wall_mounted/directional/north{
	pixel_x = 26
	},
/obj/machinery/status_display/ai/directional/north,
/obj/item/radio/intercom/command/directional/east,
/obj/structure/bed/dogbed/renault,
/mob/living/basic/pet/fox/renault,
/turf/open/floor/wood,
/area/station/command/heads_quarters/captain)
"s" = (
/obj/machinery/atmospherics/components/unary/vent_pump/on/layer4,
/obj/effect/turf_decal/tile/dark_blue/opposingcorners,
/obj/effect/turf_decal/siding/wood{
	dir = 4
	},
/obj/machinery/computer/security/telescreen/entertainment/directional/north,
/turf/open/floor/iron/dark,
/area/station/command/heads_quarters/blueshield)
"t" = (
/obj/machinery/door/airlock/corporate{
	name = "Blueshield's Office"
	},
/obj/machinery/door/firedoor,
/obj/effect/landmark/navigate_destination/autoname,
/obj/effect/mapping_helpers/airlock/access/all/command/captain,
/obj/machinery/door/firedoor,
/obj/machinery/atmospherics/pipe/smart/manifold4w/supply/hidden/layer4,
/obj/machinery/atmospherics/pipe/smart/manifold4w/scrubbers/hidden/layer2,
/obj/structure/cable,
/turf/open/space/basic,
/area/station/command/heads_quarters/blueshield)
"u" = (
/obj/machinery/suit_storage_unit/security,
/obj/machinery/vending/wallmed/directional/west,
/obj/effect/turf_decal/delivery/red,
/obj/effect/turf_decal/siding/thinplating_new/dark{
	dir = 4
	},
/turf/open/floor/iron/dark/small,
/area/station/command/heads_quarters/blueshield)
"v" = (
/obj/machinery/door/poddoor/shutters/preopen{
	id = "blueshield_priv";
	name = "Privacy Shutters"
	},
/obj/effect/spawner/structure/window/reinforced,
/obj/structure/cable,
/turf/open/floor/plating,
/area/station/command/heads_quarters/blueshield)
"w" = (
/obj/effect/turf_decal/siding/thinplating_new/dark{
	dir = 4
	},
/obj/structure/rack/shelf,
/obj/structure/reagent_dispensers/wall/peppertank/directional/west,
/obj/item/storage/medkit/fire,
/obj/item/storage/medkit/tactical/blueshield{
	pixel_y = 4
	},
/turf/open/floor/iron/dark/small,
/area/station/command/heads_quarters/blueshield)
"x" = (
/obj/machinery/atmospherics/components/unary/vent_scrubber/on/layer2{
	dir = 1
	},
/obj/machinery/modular_computer/preset/command{
	dir = 1
	},
/turf/open/floor/carpet/blue,
/area/station/command/heads_quarters/blueshield)
"y" = (
/obj/structure/table/wood,
/obj/machinery/atmospherics/pipe/smart/manifold4w/supply/hidden/layer4,
/obj/structure/cable,
/obj/machinery/atmospherics/pipe/smart/manifold4w/scrubbers/hidden/layer2,
/turf/open/floor/carpet,
/area/station/command/heads_quarters/captain)
"z" = (
/obj/machinery/door/airlock/command{
	name = "Captain's Quarters"
	},
/obj/effect/mapping_helpers/airlock/access/all/command/captain,
/obj/structure/cable,
/obj/machinery/atmospherics/pipe/smart/manifold4w/supply/hidden/layer4,
/obj/machinery/atmospherics/pipe/smart/manifold4w/scrubbers/hidden/layer2,
/turf/open/floor/wood,
/area/station/command/heads_quarters/captain/private)
"A" = (
/obj/machinery/status_display/ai/directional/north,
/obj/machinery/camera/directional/north{
	c_tag = "Blueshield's Office - Armory"
	},
/obj/effect/turf_decal/tile/dark_blue/diagonal_centre,
/obj/machinery/light/small/blacklight/directional/north,
/obj/machinery/atmospherics/pipe/smart/manifold4w/supply/hidden/layer4,
/obj/structure/safe/abovetilefloor,
/obj/item/paperwork/captain{
	pixel_x = -3;
	pixel_y = 4;
	name = "Asset Protection case records";
	desc = "A messily compiled stack of DAP records, containing incident reports, asset recovery briefings and classified paramilitary activities, with substantial portions censored and redacted. You probably shouldn't be reading this, unless you yearn for a one-way trip to Space Guantanamo."
	},
/obj/item/toy/plush/skyrat/fox/mia{
	desc = "A small stuffed silver fox with a collar tag that says “DAP” and a tiny bell in its fluffy tail.""A cute, marketable version of one of the DAP's mascots, Vigilant the fox. She has a blue collar with a shield-shaped tag that reads DAP. Holding her makes you feel protected.";
	name = "Vigilant plushie"
	},
/obj/item/reagent_containers/cup/glass/trophy{
	desc = "You did good in the worst way possible.";
	name = "Redshield 1st prize";
	pixel_y = 9;
	pixel_x = -2
	},
/obj/item/storage/fancy/cigarettes/cigars,
/obj/item/storage/box/matches,
/obj/item/reagent_containers/cup/glass/bottle/lizardwine,
/obj/item/reagent_containers/cup/glass/flask,
/turf/open/floor/iron/dark/diagonal,
/area/station/command/heads_quarters/blueshield)
"B" = (
/obj/structure/window/reinforced/spawner/directional/south,
/obj/structure/table/wood,
/obj/item/radio/intercom/directional/east,
/obj/machinery/fax{
	name = "Captain's Fax Machine";
	fax_name = "Captain's Office"
	},
/turf/open/floor/wood,
/area/station/command/heads_quarters/captain)
"C" = (
/obj/structure/cable,
/obj/machinery/atmospherics/pipe/smart/manifold4w/supply/hidden/layer4,
/obj/machinery/atmospherics/pipe/smart/manifold4w/scrubbers/hidden/layer2,
/obj/effect/turf_decal/tile/dark_blue/opposingcorners,
/turf/open/floor/iron/dark,
/area/station/command/heads_quarters/blueshield)
"D" = (
/obj/item/radio/intercom/directional/south,
/obj/structure/cable,
/obj/machinery/atmospherics/pipe/smart/manifold4w/supply/hidden/layer4,
/obj/machinery/atmospherics/pipe/smart/manifold4w/scrubbers/hidden/layer2,
/turf/open/floor/carpet,
/area/station/command/heads_quarters/captain)
"E" = (
/obj/machinery/light/warm/directional/north,
/obj/machinery/atmospherics/pipe/smart/manifold4w/supply/hidden/layer4,
/obj/machinery/atmospherics/pipe/smart/manifold4w/scrubbers/hidden/layer2,
/obj/machinery/airalarm/directional/north,
/obj/machinery/camera/directional/north{
	c_tag = "Blueshield's Office"
	},
/turf/open/floor/carpet/blue,
/area/station/command/heads_quarters/blueshield)
"F" = (
/obj/structure/sign/clock/directional/north,
/obj/structure/dresser,
/obj/item/sign/flag/nanotrasen{
	pixel_y = 11
	},
/obj/structure/secure_safe/directional/west,
/turf/open/floor/wood,
/area/station/command/heads_quarters/blueshield)
"G" = (
/obj/machinery/airalarm/directional/east,
/obj/machinery/camera/directional/east{
	c_tag = "Command - Captain's Office"
	},
/obj/structure/table/wood,
/obj/machinery/coffeemaker/impressa,
/turf/open/floor/carpet,
/area/station/command/heads_quarters/captain)
"H" = (
/obj/structure/sign/poster/official/no_erp/directional/north,
/obj/machinery/light/small/blacklight/directional/east,
/obj/structure/bed,
/obj/item/bedsheet/nanotrasen,
/turf/open/floor/wood,
/area/station/command/heads_quarters/blueshield)
"I" = (
/obj/machinery/atmospherics/pipe/smart/manifold4w/supply/hidden/layer4,
/obj/effect/turf_decal/tile/dark_blue/diagonal_centre,
/obj/machinery/atmospherics/pipe/smart/manifold4w/scrubbers/hidden/layer2,
/obj/effect/landmark/start/blueshield,
/turf/open/floor/iron/dark/diagonal,
/area/station/command/heads_quarters/blueshield)
"J" = (
/obj/effect/turf_decal/tile/dark_blue/opposingcorners,
/obj/effect/turf_decal/siding/wood{
	dir = 4
	},
/turf/open/floor/iron/dark,
/area/station/command/heads_quarters/blueshield)
"K" = (
/obj/item/radio/intercom/directional/south,
/obj/structure/table/wood,
/obj/machinery/fax{
	name = "Blueshield's Fax Machine";
	fax_name = "Blueshield's Office"
	},
/obj/machinery/button/door/directional/east{
	id = "blueshield_priv";
	req_access = list("captain");
	name = "Privacy Shutters Control"
	},
/obj/machinery/light_switch/directional/east{
	pixel_y = -1;
	pixel_x = 32
	},
/turf/open/floor/carpet/blue,
/area/station/command/heads_quarters/blueshield)
"L" = (
/obj/structure/table/wood,
/obj/item/folder/blue,
/obj/item/stamp/head/captain,
/obj/machinery/door/window/right/directional/south{
	name = "Captain's Desk";
	req_access = list("captain")
	},
/obj/structure/cable,
/obj/machinery/atmospherics/pipe/smart/manifold4w/scrubbers/hidden/layer2,
/turf/open/floor/wood,
/area/station/command/heads_quarters/captain)
"M" = (
/turf/open/floor/carpet,
/area/station/command/heads_quarters/captain)
"N" = (
/obj/machinery/atmospherics/pipe/smart/manifold4w/scrubbers/hidden/layer2,
/obj/structure/chair/office{
	dir = 8
	},
/obj/effect/landmark/start/blueshield,
/turf/open/floor/carpet/blue,
/area/station/command/heads_quarters/blueshield)
"O" = (
/obj/machinery/door/airlock/highsecurity{
	name = "Blueshield's Armory"
	},
/obj/machinery/atmospherics/pipe/smart/manifold4w/supply/hidden/layer4,
/obj/machinery/atmospherics/pipe/smart/manifold4w/scrubbers/hidden/layer2,
/obj/effect/mapping_helpers/airlock/access/all/command/captain,
/obj/machinery/door/firedoor,
/obj/effect/turf_decal/tile/dark_blue/opposingcorners,
/turf/open/floor/iron/dark,
/area/station/command/heads_quarters/blueshield)
"P" = (
/obj/structure/cable,
/obj/structure/table/wood,
/obj/item/paper_bin{
	pixel_y = 4;
	pixel_x = -5
	},
/obj/item/pen/fourcolor{
	pixel_x = -5;
	pixel_y = 5
	},
/obj/machinery/recharger{
	pixel_x = 7;
	pixel_y = 6
	},
/turf/open/floor/carpet/blue,
/area/station/command/heads_quarters/blueshield)
"Q" = (
/obj/machinery/atmospherics/pipe/smart/manifold4w/supply/hidden/layer4,
/obj/machinery/atmospherics/pipe/smart/manifold4w/scrubbers/hidden/layer2,
/obj/structure/cable,
/turf/open/floor/carpet,
/area/station/command/heads_quarters/captain)
"S" = (
/obj/machinery/atmospherics/pipe/smart/manifold4w/supply/hidden/layer4,
/obj/machinery/atmospherics/pipe/smart/manifold4w/scrubbers/hidden/layer2,
/obj/structure/cable,
/obj/effect/turf_decal/tile/dark_blue/opposingcorners,
/obj/effect/turf_decal/siding/wood{
	dir = 4
	},
/obj/structure/chair/office{
	dir = 4
	},
/obj/effect/mapping_helpers/turn_off_lights_with_lightswitch,
/obj/machinery/holopad,
/turf/open/floor/iron/dark,
/area/station/command/heads_quarters/blueshield)
"T" = (
/obj/effect/landmark/start/captain,
/obj/structure/chair/office,
/obj/structure/cable,
/obj/machinery/atmospherics/pipe/smart/manifold4w/scrubbers/hidden/layer2,
/turf/open/floor/wood,
/area/station/command/heads_quarters/captain)
"U" = (
/turf/closed/wall/r_wall,
/area/station/command/heads_quarters/captain)
"V" = (
/obj/structure/chair/comfy/brown{
	dir = 1
	},
/obj/structure/cable,
/obj/machinery/atmospherics/pipe/smart/manifold4w/supply/hidden/layer4,
/obj/machinery/atmospherics/pipe/smart/manifold4w/scrubbers/hidden/layer2,
/turf/open/floor/carpet,
/area/station/command/heads_quarters/captain)
"W" = (
/obj/structure/extinguisher_cabinet/directional/west,
/obj/effect/turf_decal/tile/dark_blue/opposingcorners,
/obj/effect/landmark/start/blueshield,
/turf/open/floor/iron/dark,
/area/station/command/heads_quarters/blueshield)
"X" = (
/obj/machinery/door/airlock/corporate{
	name = "Blueshield's Quarters"
	},
/obj/effect/mapping_helpers/airlock/access/all/command/captain,
/obj/effect/turf_decal/tile/dark_blue/opposingcorners,
/turf/open/floor/iron/dark,
/area/station/command/heads_quarters/blueshield)
"Y" = (
/obj/machinery/holopad,
/obj/machinery/atmospherics/pipe/smart/manifold4w/supply/hidden/layer4,
/obj/machinery/atmospherics/pipe/smart/manifold4w/scrubbers/hidden/layer2,
/obj/structure/cable,
/obj/structure/table/wood,
/obj/item/flashlight/lamp{
	pixel_y = 9;
	pixel_x = -4
	},
/obj/item/reagent_containers/cup/glass/mug/nanotrasen{
	pixel_x = 8;
	pixel_y = 8
	},
/obj/effect/spawner/random/entertainment/cigar,
/turf/open/floor/carpet/blue,
/area/station/command/heads_quarters/blueshield)
"Z" = (
/obj/structure/closet/secure_closet/tac{
	req_access = list("captain")
	},
/obj/item/shield/riot,
/obj/item/gun_maintenance_supplies,
/obj/item/screwdriver,
/obj/effect/turf_decal/delivery/red,
/obj/item/clothing/head/helmet/toggleable/riot{
	pixel_y = 6
	},
/obj/item/clothing/suit/armor/riot,
/obj/item/storage/toolbox/ammobox/wt550m9,
/obj/structure/sign/flag/nanotrasen/directional/east,
/obj/effect/turf_decal/siding/thinplating_new/dark{
	dir = 8
	},
/obj/machinery/atmospherics/components/unary/vent_pump/on/layer4{
	dir = 8
	},
/turf/open/floor/iron/dark/small,
/area/station/command/heads_quarters/blueshield)

(1,1,1) = {"
z
l
T
L
c
y
V
U
"}
(2,1,1) = {"
k
r
q
B
M
n
D
U
"}
(3,1,1) = {"
a
a
a
a
G
Q
b
U
"}
(4,1,1) = {"
a
F
i
a
a
t
a
a
"}
(5,1,1) = {"
a
H
h
X
W
C
d
a
"}
(6,1,1) = {"
a
a
a
a
s
S
J
v
"}
(7,1,1) = {"
a
u
w
a
E
Y
P
v
"}
(8,1,1) = {"
a
A
I
O
m
N
x
v
"}
(9,1,1) = {"
a
Z
g
a
p
j
K
a
"}
(10,1,1) = {"
a
a
a
a
a
a
a
a
"}
