//MAP CONVERTED BY dmm2tgm.py THIS HEADER COMMENT PREVENTS RECONVERSION, DO NOT REMOVE
"a" = (
/turf/template_noop,
/area/template_noop)
"d" = (
/obj/machinery/door/airlock/security/glass{
	name = "Security Office"
	},
/obj/effect/turf_decal/trimline/red/filled/line{
	dir = 4
	},
/obj/effect/turf_decal/trimline/red/filled/line{
	dir = 8
	},
/obj/machinery/door/firedoor,
/obj/machinery/atmospherics/pipe/smart/manifold4w/scrubbers/hidden/layer2,
/obj/machinery/atmospherics/pipe/smart/manifold4w/supply/hidden/layer4,
/obj/structure/cable,
/obj/effect/mapping_helpers/airlock/access/all/engineering/engie_guard,
/turf/open/floor/iron,
/area/station/security/checkpoint/engineering)
"e" = (
/obj/effect/turf_decal/trimline/red/corner{
	dir = 4
	},
/obj/effect/decal/cleanable/dirt,
/obj/structure/closet/secure_closet/brig{
	name = "Engineering Cell Locker";
	id = "engcell"
	},
/obj/effect/turf_decal/trimline/red/filled/line{
	dir = 8
	},
/obj/structure/cable,
/turf/open/floor/iron,
/area/station/security/checkpoint/engineering)
"i" = (
/turf/closed/wall/r_wall,
/area/station/security/checkpoint/engineering)
"j" = (
/obj/structure/extinguisher_cabinet/directional/north,
/obj/effect/spawner/structure/window/reinforced,
/obj/structure/cable,
/turf/open/floor/plating,
/area/station/security/checkpoint/engineering)
"k" = (
/obj/effect/spawner/structure/window/reinforced,
/obj/structure/cable,
/turf/open/floor/plating,
/area/station/security/checkpoint/engineering)
"p" = (
/obj/effect/turf_decal/trimline/red/filled/line,
/obj/structure/reagent_dispensers/wall/peppertank/directional/south,
/obj/machinery/computer/records/security{
	dir = 1
	},
/turf/open/floor/iron,
/area/station/security/checkpoint/engineering)
"r" = (
/obj/structure/closet/secure_closet/security/engine,
/obj/effect/turf_decal/trimline/red/filled/line{
	dir = 6
	},
/obj/item/clothing/mask/whistle,
/obj/structure/cable,
/turf/open/floor/iron,
/area/station/security/checkpoint/engineering)
"s" = (
/obj/effect/turf_decal/trimline/red/filled/corner{
	dir = 1
	},
/obj/effect/turf_decal/trimline/red/filled/corner{
	dir = 8
	},
/obj/machinery/atmospherics/pipe/smart/manifold4w/supply/hidden/layer4,
/obj/structure/cable,
/turf/open/floor/iron,
/area/station/security/checkpoint/engineering)
"u" = (
/obj/structure/chair/office,
/obj/machinery/atmospherics/pipe/smart/manifold4w/scrubbers/hidden/layer2,
/obj/structure/cable,
/obj/effect/landmark/start/engineering_guard,
/turf/open/floor/iron,
/area/station/security/checkpoint/engineering)
"v" = (
/obj/effect/turf_decal/trimline/red/filled/line,
/obj/structure/filingcabinet,
/obj/machinery/light/directional/south,
/turf/open/floor/iron,
/area/station/security/checkpoint/engineering)
"y" = (
/obj/effect/turf_decal/trimline/red/filled/corner{
	dir = 4
	},
/obj/effect/turf_decal/trimline/red/filled/corner{
	dir = 1
	},
/obj/machinery/atmospherics/pipe/smart/manifold4w/scrubbers/hidden/layer2,
/obj/machinery/atmospherics/pipe/smart/manifold4w/supply/hidden/layer4,
/obj/structure/cable,
/turf/open/floor/iron,
/area/station/security/checkpoint/engineering)
"z" = (
/obj/machinery/vending/wardrobe/sec_wardrobe,
/obj/effect/turf_decal/trimline/red/filled/line{
	dir = 5
	},
/obj/structure/sign/clock/directional/north,
/turf/open/floor/iron,
/area/station/security/checkpoint/engineering)
"A" = (
/obj/effect/turf_decal/trimline/red/filled/corner,
/obj/structure/cable,
/turf/open/floor/iron,
/area/station/security/checkpoint/engineering)
"B" = (
/obj/machinery/door/window/brigdoor/left/directional/west{
	name = "Engineering Cell";
	id = "engcell";
	req_access = list("security")
	},
/obj/effect/turf_decal/trimline/red/filled/corner,
/obj/effect/turf_decal/trimline/red/filled/corner{
	dir = 4
	},
/obj/structure/cable,
/obj/effect/turf_decal/tile/red/half/contrasted{
	dir = 8
	},
/obj/effect/mapping_helpers/airlock/access/all/engineering/engie_guard,
/turf/open/floor/iron,
/area/station/security/checkpoint/engineering)
"C" = (
/obj/effect/turf_decal/trimline/red/filled/line{
	dir = 4
	},
/obj/effect/turf_decal/trimline/red/corner{
	dir = 8
	},
/obj/effect/decal/cleanable/dirt,
/obj/machinery/flasher/directional/north{
	id = "engcell"
	},
/turf/open/floor/iron,
/area/station/security/checkpoint/engineering)
"G" = (
/obj/machinery/status_display/door_timer{
	name = "Engineering Cell";
	pixel_x = -32;
	id = "engcell"
	},
/obj/effect/turf_decal/trimline/red/filled/line{
	dir = 10
	},
/obj/structure/chair{
	dir = 1
	},
/obj/machinery/requests_console/directional/south{
	name = "Security Requests Console";
	department = "Security"
	},
/turf/open/floor/iron,
/area/station/security/checkpoint/engineering)
"I" = (
/obj/effect/turf_decal/trimline/red/filled/line{
	dir = 4
	},
/obj/effect/turf_decal/trimline/red/corner{
	dir = 1
	},
/obj/effect/decal/cleanable/dirt,
/obj/structure/cable,
/obj/machinery/light/small/directional/south,
/turf/open/floor/iron,
/area/station/security/checkpoint/engineering)
"N" = (
/obj/effect/landmark/event_spawn,
/obj/machinery/atmospherics/pipe/smart/manifold4w/scrubbers/hidden/layer2,
/obj/machinery/atmospherics/pipe/smart/manifold4w/supply/hidden/layer4,
/obj/structure/cable,
/turf/open/floor/iron,
/area/station/security/checkpoint/engineering)
"O" = (
/obj/machinery/camera/directional/north{
	network = list("ss13","engineering","Security");
	c_tag = "Engineering - Security Outpost"
	},
/obj/effect/turf_decal/trimline/red/filled/line{
	dir = 1
	},
/obj/structure/table,
/obj/machinery/recharger{
	pixel_y = 4
	},
/obj/machinery/newscaster/directional/north,
/turf/open/floor/iron,
/area/station/security/checkpoint/engineering)
"P" = (
/obj/effect/turf_decal/trimline/red/filled/line{
	dir = 9
	},
/obj/machinery/atmospherics/components/unary/vent_pump/on/layer4,
/turf/open/floor/iron,
/area/station/security/checkpoint/engineering)
"R" = (
/obj/effect/turf_decal/trimline/red/filled/line{
	dir = 1
	},
/obj/structure/table,
/obj/item/radio/off,
/obj/item/screwdriver{
	pixel_y = 10
	},
/obj/machinery/button/door/directional/north{
	name = "Atmospherics Lockdown";
	pixel_x = -6;
	id = "atmos";
	req_access = list("atmospherics")
	},
/obj/machinery/button/door/directional/north{
	name = "Engineering Lockdown";
	desc = "A door remote control switch for the engineering security airlocks.";
	pixel_x = 6;
	id = "Engineering";
	req_access = list("engineering")
	},
/turf/open/floor/iron,
/area/station/security/checkpoint/engineering)
"S" = (
/obj/effect/turf_decal/trimline/red/filled/line{
	dir = 6
	},
/obj/machinery/airalarm/directional/south,
/obj/structure/table,
/obj/item/paper_bin{
	pixel_x = 1;
	pixel_y = 9
	},
/obj/item/pen,
/turf/open/floor/iron,
/area/station/security/checkpoint/engineering)
"T" = (
/obj/machinery/power/apc/auto_name/directional/south,
/obj/effect/turf_decal/trimline/red/filled/line,
/obj/structure/cable,
/obj/effect/landmark/start/engineering_guard,
/turf/open/floor/iron,
/area/station/security/checkpoint/engineering)
"V" = (
/obj/structure/chair{
	dir = 4
	},
/obj/effect/turf_decal/trimline/red/filled/line{
	dir = 8
	},
/obj/effect/turf_decal/trimline/red/corner,
/obj/effect/decal/cleanable/dirt,
/obj/item/radio/intercom/directional/north,
/turf/open/floor/iron,
/area/station/security/checkpoint/engineering)
"Z" = (
/obj/effect/turf_decal/trimline/red/filled/line{
	dir = 1
	},
/obj/machinery/atmospherics/components/unary/vent_scrubber/on/layer2,
/turf/open/floor/iron,
/area/station/security/checkpoint/engineering)

(1,1,1) = {"
i
j
k
i
a
"}
(2,1,1) = {"
i
V
e
i
a
"}
(3,1,1) = {"
i
C
I
i
i
"}
(4,1,1) = {"
i
k
B
i
i
"}
(5,1,1) = {"
k
P
s
G
i
"}
(6,1,1) = {"
d
y
N
v
i
"}
(7,1,1) = {"
k
Z
u
p
i
"}
(8,1,1) = {"
i
O
A
S
i
"}
(9,1,1) = {"
i
R
T
i
i
"}
(10,1,1) = {"
i
z
r
i
a
"}
(11,1,1) = {"
i
k
k
i
a
"}
