//MAP CONVERTED BY dmm2tgm.py THIS HEADER COMMENT PREVENTS RECONVERSION, DO NOT REMOVE
"a" = (
/turf/closed/wall/r_wall,
/area/station/security/checkpoint/science)
"c" = (
/obj/effect/landmark/event_spawn,
/turf/open/floor/iron,
/area/station/security/checkpoint/science)
"d" = (
/obj/vehicle/ridden/secway,
/obj/effect/turf_decal/box,
/obj/effect/turf_decal/tile/red/fourcorners,
/turf/open/floor/iron,
/area/station/security/checkpoint/science)
"e" = (
/obj/effect/turf_decal/trimline/red/filled/line{
	dir = 1
	},
/obj/machinery/atmospherics/pipe/smart/manifold4w/supply/hidden/layer4,
/obj/machinery/atmospherics/pipe/smart/manifold4w/scrubbers/hidden/layer2,
/obj/structure/sign/clock/directional/north,
/obj/machinery/camera/directional/north{
	network = list("ss13","rd","Security");
	c_tag = "Medical - Security Checkpoint"
	},
/turf/open/floor/iron,
/area/station/security/checkpoint/science)
"f" = (
/obj/effect/turf_decal/trimline/red/filled/line{
	dir = 5
	},
/obj/machinery/atmospherics/pipe/smart/manifold4w/supply/hidden/layer4,
/obj/machinery/atmospherics/pipe/smart/manifold4w/scrubbers/hidden/layer2,
/turf/open/floor/iron,
/area/station/security/checkpoint/science)
"k" = (
/turf/open/floor/iron,
/area/station/security/checkpoint/science)
"l" = (
/obj/effect/turf_decal/trimline/red/filled/line{
	dir = 10
	},
/obj/structure/extinguisher_cabinet/directional/south,
/obj/machinery/computer/records/security{
	dir = 4
	},
/turf/open/floor/iron,
/area/station/security/checkpoint/science)
"m" = (
/obj/effect/turf_decal/trimline/red/filled/line{
	dir = 9
	},
/obj/structure/closet/secure_closet/brig{
	name = "Medical Cell Locker";
	id = "medcell"
	},
/turf/open/floor/iron,
/area/station/security/checkpoint/science)
"n" = (
/obj/effect/turf_decal/trimline/red/filled/line{
	dir = 4
	},
/obj/machinery/flasher/directional/east{
	id = "scicell"
	},
/obj/machinery/atmospherics/pipe/smart/manifold4w/scrubbers/hidden/layer2,
/obj/machinery/atmospherics/pipe/smart/manifold4w/supply/hidden/layer4,
/turf/open/floor/iron,
/area/station/security/checkpoint/science)
"q" = (
/obj/structure/cable,
/obj/machinery/atmospherics/pipe/smart/manifold4w/scrubbers/hidden/layer2,
/obj/machinery/atmospherics/pipe/smart/manifold4w/supply/hidden/layer4,
/obj/effect/turf_decal/trimline/red/filled/line{
	dir = 1
	},
/obj/effect/turf_decal/trimline/red/filled/corner{
	dir = 8
	},
/obj/machinery/firealarm/directional/north{
	pixel_x = 4
	},
/obj/machinery/light_switch/directional/north{
	pixel_x = -6;
	pixel_y = 28
	},
/turf/open/floor/iron,
/area/station/security/checkpoint/science)
"r" = (
/obj/effect/spawner/structure/window/reinforced,
/turf/open/floor/plating,
/area/station/security/checkpoint/science)
"s" = (
/obj/machinery/door/window/brigdoor/right/directional/east{
	name = "Science Cell";
	id = "scicell";
	req_access = list("security")
	},
/obj/machinery/atmospherics/pipe/smart/manifold4w/supply/hidden/layer4,
/obj/machinery/atmospherics/pipe/smart/manifold4w/scrubbers/hidden/layer2,
/obj/effect/turf_decal/tile/red/fourcorners,
/obj/effect/mapping_helpers/airlock/access/all/science/sci_guard,
/turf/open/floor/iron,
/area/station/security/checkpoint/science)
"t" = (
/obj/effect/turf_decal/trimline/red/filled/line,
/obj/structure/sign/poster/official/safety_report/directional/south,
/turf/open/floor/iron,
/area/station/security/checkpoint/science)
"u" = (
/obj/structure/table/reinforced,
/obj/effect/turf_decal/trimline/red/filled/line,
/obj/item/book/manual/wiki/security_space_law{
	pixel_x = 9;
	pixel_y = 4
	},
/obj/item/radio{
	pixel_x = -6;
	pixel_y = -3
	},
/obj/item/key/security,
/obj/machinery/light/directional/south,
/turf/open/floor/iron,
/area/station/security/checkpoint/science)
"v" = (
/obj/machinery/computer/security{
	dir = 4
	},
/obj/effect/turf_decal/trimline/red/filled/line{
	dir = 8
	},
/turf/open/floor/iron,
/area/station/security/checkpoint/science)
"C" = (
/obj/structure/closet/secure_closet/security/science,
/obj/item/clothing/mask/whistle,
/obj/effect/turf_decal/trimline/red/filled/line{
	dir = 6
	},
/turf/open/floor/iron,
/area/station/security/checkpoint/science)
"D" = (
/obj/effect/turf_decal/trimline/red/filled/line{
	dir = 8
	},
/obj/machinery/atmospherics/pipe/smart/manifold4w/supply/hidden/layer4,
/obj/machinery/atmospherics/pipe/smart/manifold4w/scrubbers/hidden/layer2,
/turf/open/floor/iron,
/area/station/security/checkpoint/science)
"E" = (
/obj/machinery/atmospherics/components/unary/vent_scrubber/on/layer2{
	dir = 4
	},
/turf/open/floor/iron,
/area/station/security/checkpoint/science)
"H" = (
/obj/structure/chair/office{
	dir = 8
	},
/obj/effect/turf_decal/trimline/red/filled/line,
/obj/item/radio/intercom/directional/south,
/obj/effect/landmark/start/science_guard,
/turf/open/floor/iron,
/area/station/security/checkpoint/science)
"I" = (
/obj/effect/turf_decal/trimline/red/filled/line{
	dir = 5
	},
/obj/machinery/atmospherics/components/unary/vent_scrubber/on/layer2,
/obj/item/radio/intercom/prison/directional/east,
/turf/open/floor/iron,
/area/station/security/checkpoint/science)
"L" = (
/obj/effect/turf_decal/trimline/red/filled/line{
	dir = 1
	},
/obj/machinery/power/apc/auto_name/directional/north,
/obj/structure/cable,
/obj/machinery/atmospherics/pipe/smart/manifold4w/supply/hidden/layer4,
/obj/machinery/atmospherics/pipe/smart/manifold4w/scrubbers/hidden/layer2,
/turf/open/floor/iron,
/area/station/security/checkpoint/science)
"M" = (
/obj/effect/turf_decal/trimline/red/filled/line{
	dir = 6
	},
/obj/machinery/atmospherics/components/unary/vent_pump/on/layer4{
	dir = 1
	},
/obj/machinery/light/small/dim/directional/south,
/turf/open/floor/iron,
/area/station/security/checkpoint/science)
"N" = (
/obj/structure/cable,
/obj/machinery/atmospherics/pipe/smart/manifold4w/scrubbers/hidden/layer2,
/obj/machinery/atmospherics/pipe/smart/manifold4w/supply/hidden/layer4,
/obj/machinery/door/airlock/security/glass{
	name = "Security Outpost - Medical"
	},
/obj/machinery/door/firedoor,
/obj/effect/turf_decal/trimline/red/filled/line{
	dir = 1
	},
/obj/effect/turf_decal/trimline/red/filled/line,
/obj/effect/mapping_helpers/airlock/access/all/science/sci_guard,
/turf/open/floor/iron,
/area/station/security/checkpoint/science)
"Q" = (
/obj/structure/cable,
/obj/machinery/atmospherics/pipe/smart/manifold4w/scrubbers/hidden/layer2,
/obj/machinery/atmospherics/pipe/smart/manifold4w/supply/hidden/layer4,
/obj/effect/turf_decal/trimline/red/filled/line{
	dir = 1
	},
/obj/structure/reagent_dispensers/wall/peppertank/directional/north,
/turf/open/floor/iron,
/area/station/security/checkpoint/science)
"R" = (
/obj/effect/turf_decal/trimline/red/filled/line{
	dir = 1
	},
/obj/machinery/atmospherics/pipe/smart/manifold4w/supply/hidden/layer4,
/obj/machinery/atmospherics/pipe/smart/manifold4w/scrubbers/hidden/layer2,
/obj/machinery/status_display/door_timer{
	name = "Science Cell";
	pixel_y = 32;
	id = "scicell"
	},
/turf/open/floor/iron,
/area/station/security/checkpoint/science)
"S" = (
/obj/effect/turf_decal/trimline/red/filled/line{
	dir = 10
	},
/obj/structure/chair{
	dir = 1
	},
/obj/effect/landmark/start/science_guard,
/turf/open/floor/iron,
/area/station/security/checkpoint/science)
"U" = (
/turf/template_noop,
/area/template_noop)
"V" = (
/obj/effect/turf_decal/trimline/red/filled/line{
	dir = 4
	},
/obj/machinery/atmospherics/pipe/smart/manifold4w/supply/hidden/layer4,
/obj/machinery/atmospherics/pipe/smart/manifold4w/scrubbers/hidden/layer2,
/turf/open/floor/iron,
/area/station/security/checkpoint/science)
"W" = (
/obj/effect/spawner/structure/window/reinforced,
/obj/structure/cable,
/turf/open/floor/plating,
/area/station/security/checkpoint/science)
"Y" = (
/obj/structure/table/reinforced,
/obj/machinery/recharger,
/obj/effect/turf_decal/trimline/red/filled/line,
/obj/machinery/airalarm/directional/south,
/turf/open/floor/iron,
/area/station/security/checkpoint/science)
"Z" = (
/obj/machinery/atmospherics/components/unary/vent_pump/on/layer4{
	dir = 1
	},
/turf/open/floor/iron,
/area/station/security/checkpoint/science)

(1,1,1) = {"
U
a
N
W
W
a
"}
(2,1,1) = {"
U
a
q
v
l
a
"}
(3,1,1) = {"
U
a
Q
Z
H
a
"}
(4,1,1) = {"
U
a
L
k
t
a
"}
(5,1,1) = {"
U
a
e
c
u
a
"}
(6,1,1) = {"
a
a
R
E
Y
a
"}
(7,1,1) = {"
a
d
f
V
C
a
"}
(8,1,1) = {"
a
a
r
s
r
a
"}
(9,1,1) = {"
U
a
m
D
S
a
"}
(10,1,1) = {"
U
a
I
n
M
a
"}
(11,1,1) = {"
U
a
a
a
a
a
"}
