//MAP CONVERTED BY dmm2tgm.py THIS HEADER COMMENT PREVENTS RECONVERSION, DO NOT REMOVE
"a" = (
/obj/effect/turf_decal/stripes/line{
	dir = 5
	},
/obj/machinery/atmospherics/pipe/smart/manifold4w/supply/hidden/layer4,
/turf/open/floor/iron,
/area/station/security/armory)
"c" = (
/obj/structure/rack,
/obj/effect/turf_decal/tile/neutral/fourcorners,
/obj/effect/spawner/random/armory/riot_armor,
/obj/effect/spawner/random/armory/riot_helmet,
/obj/effect/spawner/random/armory/riot_shield,
/turf/open/floor/iron/dark,
/area/station/security/armory)
"d" = (
/obj/effect/turf_decal/stripes/corner{
	dir = 8
	},
/obj/machinery/light/floor,
/obj/structure/closet/secure_closet/armory_kiboko,
/obj/item/ammo_box/c980grenade/riot,
/obj/item/ammo_box/c980grenade/smoke,
/turf/open/floor/iron,
/area/station/security/armory)
"e" = (
/obj/effect/turf_decal/tile/neutral/fourcorners,
/turf/open/floor/iron/dark,
/area/station/security/armory)
"f" = (
/obj/effect/turf_decal/stripes/line{
	dir = 6
	},
/turf/open/floor/iron,
/area/station/security/armory)
"g" = (
/obj/effect/turf_decal/stripes/line,
/obj/structure/cable,
/mob/living/simple_animal/bot/secbot/beepsky/armsky,
/turf/open/floor/iron,
/area/station/security/armory)
"l" = (
/obj/structure/table,
/obj/effect/turf_decal/tile/neutral/fourcorners,
/obj/effect/spawner/random/armory/rubbershot,
/turf/open/floor/iron/dark,
/area/station/security/armory)
"n" = (
/obj/structure/cable,
/obj/machinery/atmospherics/pipe/smart/manifold4w/supply/hidden/layer4,
/obj/effect/turf_decal/tile/neutral/fourcorners,
/turf/open/floor/iron/dark,
/area/station/security/armory)
"o" = (
/obj/effect/turf_decal/stripes/corner{
	dir = 1
	},
/obj/effect/turf_decal/stripes/corner{
	dir = 8
	},
/turf/open/floor/iron,
/area/station/security/armory)
"p" = (
/obj/structure/rack,
/obj/item/gun/energy/e_gun/dragnet,
/obj/item/gun/energy/e_gun/dragnet,
/obj/item/radio/intercom/directional/north,
/obj/effect/turf_decal/tile/neutral/fourcorners,
/turf/open/floor/iron/dark,
/area/station/security/armory)
"s" = (
/obj/effect/turf_decal/stripes/corner,
/obj/machinery/light/floor,
/turf/open/floor/iron,
/area/station/security/armory)
"v" = (
/obj/machinery/atmospherics/pipe/smart/manifold4w/supply/hidden/layer4,
/obj/effect/turf_decal/tile/neutral/fourcorners,
/turf/open/floor/iron/dark,
/area/station/security/armory)
"x" = (
/obj/structure/rack,
/obj/structure/window/reinforced/spawner/directional/north,
/obj/structure/window/reinforced/spawner/directional/south,
/obj/effect/spawner/armory_spawn/shotguns,
/turf/open/floor/iron,
/area/station/security/armory)
"y" = (
/obj/structure/table,
/obj/item/storage/box/teargas{
	pixel_x = -3;
	pixel_y = 3
	},
/obj/item/storage/box/handcuffs,
/obj/item/storage/box/flashbangs{
	pixel_x = 3;
	pixel_y = -3
	},
/obj/effect/turf_decal/tile/neutral/fourcorners,
/turf/open/floor/iron/dark,
/area/station/security/armory)
"B" = (
/obj/effect/turf_decal/stripes/end{
	dir = 8
	},
/obj/machinery/light/floor,
/turf/open/floor/iron,
/area/station/security/armory)
"C" = (
/obj/machinery/airalarm/directional/east,
/obj/effect/turf_decal/tile/neutral/fourcorners,
/obj/item/storage/toolbox/drone,
/turf/open/floor/iron/dark,
/area/station/security/armory)
"D" = (
/obj/effect/turf_decal/stripes/line{
	dir = 9
	},
/obj/machinery/atmospherics/pipe/smart/manifold4w/supply/hidden/layer4,
/turf/open/floor/iron,
/area/station/security/armory)
"E" = (
/obj/effect/spawner/structure/window/reinforced,
/obj/structure/cable,
/turf/open/floor/plating,
/area/station/security/armory)
"F" = (
/obj/vehicle/ridden/secway,
/obj/effect/turf_decal/tile/neutral/fourcorners,
/turf/open/floor/iron/dark,
/area/station/security/armory)
"G" = (
/obj/machinery/atmospherics/components/unary/vent_scrubber/on/layer2,
/obj/effect/turf_decal/tile/neutral/fourcorners,
/turf/open/floor/iron/dark,
/area/station/security/armory)
"H" = (
/obj/machinery/atmospherics/components/unary/vent_pump/on/layer4{
	dir = 4
	},
/obj/effect/turf_decal/tile/neutral/fourcorners,
/turf/open/floor/iron/dark,
/area/station/security/armory)
"J" = (
/obj/structure/rack,
/obj/effect/turf_decal/tile/neutral/fourcorners,
/obj/effect/spawner/random/armory/bulletproof_armor,
/obj/effect/spawner/random/armory/bulletproof_helmet,
/turf/open/floor/iron/dark,
/area/station/security/armory)
"L" = (
/obj/effect/turf_decal/stripes/corner,
/obj/effect/turf_decal/stripes/corner{
	dir = 4
	},
/obj/machinery/atmospherics/pipe/smart/manifold4w/supply/hidden/layer4,
/turf/open/floor/iron,
/area/station/security/armory)
"M" = (
/obj/structure/rack,
/obj/structure/window/reinforced/spawner/directional/north,
/obj/structure/window/reinforced/spawner/directional/south,
/obj/effect/spawner/random/armory/disablers,
/turf/open/floor/iron,
/area/station/security/armory)
"N" = (
/obj/structure/rack,
/obj/item/clothing/suit/hooded/ablative,
/obj/item/gun/energy/ionrifle,
/obj/item/gun/energy/temperature/security,
/obj/structure/reagent_dispensers/wall/peppertank/directional/north,
/obj/effect/turf_decal/tile/neutral/fourcorners,
/turf/open/floor/iron/dark,
/area/station/security/armory)
"O" = (
/obj/structure/rack,
/obj/effect/turf_decal/stripes/line{
	dir = 1
	},
/obj/structure/window/reinforced/spawner/directional/west,
/obj/structure/window/reinforced/spawner/directional/east,
/obj/structure/cable,
/obj/effect/spawner/random/armory/e_gun,
/turf/open/floor/iron,
/area/station/security/armory)
"P" = (
/obj/structure/cable,
/obj/effect/turf_decal/tile/neutral/fourcorners,
/turf/open/floor/iron/dark,
/area/station/security/armory)
"Q" = (
/obj/structure/rack,
/obj/machinery/camera/directional/north{
	c_tag = "Security - Armory";
	network = list("ss13","Security")
	},
/obj/structure/window/reinforced/spawner/directional/west,
/obj/structure/window/reinforced/spawner/directional/east,
/obj/structure/cable,
/obj/effect/spawner/armory_spawn/smg,
/turf/open/floor/iron,
/area/station/security/armory)
"R" = (
/obj/effect/turf_decal/stripes/line{
	dir = 10
	},
/turf/open/floor/iron,
/area/station/security/armory)
"S" = (
/obj/machinery/suit_storage_unit/security,
/obj/effect/turf_decal/tile/neutral/fourcorners,
/turf/open/floor/iron/dark,
/area/station/security/armory)
"U" = (
/obj/effect/turf_decal/stripes/line{
	dir = 1
	},
/obj/machinery/atmospherics/pipe/smart/manifold4w/supply/hidden/layer4,
/obj/machinery/light/floor,
/turf/open/floor/iron,
/area/station/security/armory)
"V" = (
/obj/effect/turf_decal/stripes/end{
	dir = 4
	},
/obj/machinery/atmospherics/pipe/smart/manifold4w/supply/hidden/layer4,
/obj/machinery/atmospherics/pipe/smart/manifold4w/scrubbers/hidden/layer2,
/obj/machinery/light/floor,
/turf/open/floor/iron,
/area/station/security/armory)

(1,1,1) = {"
c
H
B
e
F
l
"}
(2,1,1) = {"
J
D
o
R
e
y
"}
(3,1,1) = {"
v
U
x
d
R
e
"}
(4,1,1) = {"
n
O
E
Q
g
P
"}
(5,1,1) = {"
v
U
M
s
f
e
"}
(6,1,1) = {"
N
a
L
f
e
S
"}
(7,1,1) = {"
p
G
V
e
C
S
"}
