//MAP CONVERTED BY dmm2tgm.py THIS HEADER COMMENT PREVENTS RECONVERSION, DO NOT REMOVE
"a" = (
/turf/template_noop,
/area/template_noop)
"o" = (
/obj/machinery/incident_display/disease/directional/north,
/turf/template_noop,
/area/template_noop)
"w" = (
/obj/machinery/incident_display/disease,
/turf/template_noop,
/area/template_noop)
"C" = (
/obj/effect/turf_decal/trimline/yellow/filled/line{
	dir = 8
	},
/obj/effect/turf_decal/trimline/neutral/filled/warning{
	dir = 8
	},
/obj/structure/railing{
	dir = 4
	},
/obj/effect/spawner/random/vending/snackvend{
	pixel_x = -5
	},
/obj/machinery/incident_display/disease/directional/south,
/turf/open/floor/iron,
/area/station/hallway/primary/tram/center)
"S" = (
/obj/structure/table/glass,
/obj/item/stack/medical/gauze,
/obj/item/stack/medical/suture,
/obj/effect/turf_decal/trimline/blue/filled/line{
	dir = 9
	},
/obj/machinery/status_display/evac/directional/north,
/obj/machinery/light/directional/west,
/turf/open/floor/iron/white,
/area/station/medical/treatment_center)
"V" = (
/obj/structure/table/glass,
/obj/item/storage/box/beakers,
/obj/item/storage/box/bodybags{
	pixel_x = 5;
	pixel_y = 5
	},
/obj/effect/turf_decal/trimline/blue/filled/line{
	dir = 5
	},
/obj/item/radio/intercom/directional/east,
/obj/machinery/light/directional/east,
/turf/open/floor/iron/white,
/area/station/medical/treatment_center)

(1,1,1) = {"
C
a
o
a
a
a
a
a
"}
(2,1,1) = {"
a
a
a
a
a
a
a
a
"}
(3,1,1) = {"
a
a
a
a
a
a
a
a
"}
(4,1,1) = {"
a
a
a
a
a
a
a
S
"}
(5,1,1) = {"
a
a
a
a
a
a
a
a
"}
(6,1,1) = {"
a
a
a
a
a
a
a
a
"}
(7,1,1) = {"
a
a
a
a
a
a
a
a
"}
(8,1,1) = {"
a
a
a
a
a
a
a
a
"}
(9,1,1) = {"
a
a
a
a
a
a
a
a
"}
(10,1,1) = {"
a
a
a
a
a
a
a
a
"}
(11,1,1) = {"
a
a
a
a
a
a
a
a
"}
(12,1,1) = {"
a
a
a
a
a
a
w
V
"}
