//MAP CONVERTED BY dmm2tgm.py THIS HEADER COMMENT PREVENTS RECONVERSION, DO NOT REMOVE
"a" = (
/obj/machinery/atmospherics/pipe/smart/manifold4w/supply/hidden/layer4,
/obj/machinery/atmospherics/pipe/smart/manifold4w/supply/hidden/layer4,
/turf/open/floor/iron/dark,
/area/station/security/detectives_office)
"b" = (
/obj/machinery/atmospherics/pipe/smart/manifold4w/scrubbers/hidden/layer2,
/obj/machinery/atmospherics/pipe/smart/manifold4w/supply/hidden/layer4,
/turf/open/floor/wood,
/area/station/security/detectives_office)
"h" = (
/obj/structure/filingcabinet/security{
	pixel_x = 10
	},
/obj/structure/filingcabinet,
/obj/structure/filingcabinet/medical{
	pixel_x = -10
	},
/turf/open/floor/iron/dark,
/area/station/security/detectives_office)
"j" = (
/obj/structure/cable,
/obj/machinery/atmospherics/components/unary/vent_scrubber/on/layer2{
	dir = 1
	},
/obj/structure/chair/office/tactical,
/obj/effect/landmark/start/detective,
/turf/open/floor/wood,
/area/station/security/detectives_office)
"m" = (
/turf/closed/wall/r_wall,
/area/station/hallway/secondary/command)
"n" = (
/turf/closed/wall/r_wall,
/area/station/security/detectives_office)
"p" = (
/obj/structure/cable,
/obj/structure/chair{
	dir = 8
	},
/obj/machinery/atmospherics/components/unary/vent_scrubber/on/layer2{
	dir = 1
	},
/obj/machinery/power/apc/auto_name/directional/south,
/obj/effect/landmark/start/detective,
/turf/open/floor/iron/dark,
/area/station/security/detectives_office)
"t" = (
/obj/structure/sign/clock/directional/east,
/turf/open/floor/wood,
/area/station/security/detectives_office)
"u" = (
/obj/structure/table/wood,
/obj/effect/turf_decal/siding/dark{
	dir = 5
	},
/obj/item/paper_bin/carbon{
	pixel_x = -12;
	pixel_y = 4
	},
/obj/item/flashlight/lamp/green{
	pixel_x = 7;
	pixel_y = 13
	},
/obj/item/pen/fourcolor{
	pixel_x = -12;
	pixel_y = 5
	},
/obj/item/toy/crayon/white{
	pixel_x = 7
	},
/turf/open/floor/carpet,
/area/station/security/detectives_office)
"w" = (
/obj/structure/cable,
/obj/machinery/atmospherics/pipe/smart/manifold4w/scrubbers/hidden/layer2,
/obj/machinery/atmospherics/pipe/smart/manifold4w/supply/hidden/layer4,
/obj/effect/landmark/navigate_destination/det,
/turf/open/floor/wood,
/area/station/security/detectives_office)
"x" = (
/obj/machinery/photocopier/prebuilt,
/obj/structure/sign/clock/directional/east,
/turf/open/floor/iron/dark,
/area/station/security/detectives_office)
"y" = (
/obj/machinery/atmospherics/pipe/smart/manifold4w/scrubbers/hidden/layer2,
/obj/machinery/atmospherics/pipe/smart/manifold4w/scrubbers/hidden/layer2,
/obj/machinery/atmospherics/pipe/smart/manifold4w/supply/hidden/layer4,
/obj/structure/extinguisher_cabinet/directional/north,
/turf/open/floor/wood,
/area/station/security/detectives_office)
"A" = (
/obj/machinery/door/airlock/security{
	name = "Detective's Office"
	},
/obj/machinery/door/firedoor,
/obj/effect/mapping_helpers/airlock/access/all/security/detective,
/obj/structure/cable,
/obj/structure/disposalpipe/segment{
	dir = 4
	},
/obj/machinery/atmospherics/pipe/smart/manifold4w/supply/hidden/layer4,
/obj/machinery/atmospherics/pipe/smart/manifold4w/scrubbers/hidden/layer2,
/obj/structure/cable,
/obj/effect/landmark/navigate_destination/autoname,
/obj/machinery/door/firedoor,
/turf/open/floor/iron/grimy,
/area/station/security/detectives_office)
"B" = (
/obj/machinery/atmospherics/pipe/smart/manifold4w/supply/hidden/layer4,
/obj/machinery/airalarm/directional/west,
/turf/open/floor/iron/dark,
/area/station/security/detectives_office)
"D" = (
/obj/structure/cable,
/obj/machinery/atmospherics/pipe/smart/manifold4w/scrubbers/hidden/layer2,
/obj/machinery/atmospherics/pipe/smart/manifold4w/supply/hidden/layer4,
/obj/effect/mapping_helpers/airlock/access/all/security/detective,
/obj/machinery/door/firedoor,
/obj/machinery/door/airlock/security{
	name = "Interrogation Room"
	},
/turf/open/floor/iron/dark,
/area/station/security/detectives_office)
"E" = (
/obj/structure/table/wood,
/obj/machinery/computer/security/wooden_tv,
/obj/effect/turf_decal/siding/dark{
	dir = 1
	},
/obj/structure/detectiveboard/directional/west,
/turf/open/floor/carpet,
/area/station/security/detectives_office)
"G" = (
/obj/machinery/vending/wardrobe/det_wardrobe,
/obj/structure/sign/calendar/directional/east,
/turf/open/floor/wood,
/area/station/security/detectives_office)
"H" = (
/obj/structure/cable,
/obj/structure/cable,
/obj/machinery/atmospherics/pipe/smart/manifold4w/scrubbers/hidden/layer2,
/obj/machinery/atmospherics/pipe/smart/manifold4w/supply/hidden/layer4,
/turf/open/floor/wood,
/area/station/security/detectives_office)
"I" = (
/obj/structure/cable,
/obj/machinery/atmospherics/pipe/smart/manifold4w/scrubbers/hidden/layer2,
/obj/machinery/atmospherics/pipe/smart/manifold4w/supply/hidden/layer4,
/turf/open/floor/wood,
/area/station/security/detectives_office)
"J" = (
/turf/closed/wall/r_wall,
/area/template_noop)
"K" = (
/obj/effect/spawner/structure/window/reinforced,
/obj/structure/cable,
/obj/machinery/door/poddoor/shutters/preopen{
	id = "nt_rep_priv"
	},
/turf/open/floor/plating,
/area/station/security/detectives_office)
"L" = (
/obj/structure/cable,
/obj/structure/cable,
/obj/machinery/computer/records/medical{
	dir = 4
	},
/obj/machinery/power/apc/auto_name/directional/west,
/turf/open/floor/wood,
/area/station/security/detectives_office)
"O" = (
/obj/structure/table/wood,
/obj/machinery/fax{
	name = "Detective's Fax Machine";
	fax_name = "Detective's Office"
	},
/obj/item/radio/intercom/command/directional/east,
/obj/machinery/airalarm/directional/south,
/turf/open/floor/wood,
/area/station/security/detectives_office)
"P" = (
/obj/effect/mapping_helpers/airlock/access/all/security/detective,
/obj/machinery/door/firedoor,
/obj/machinery/door/airlock/security{
	name = "Interrogation Room"
	},
/turf/open/floor/iron/dark,
/area/station/security/detectives_office)
"R" = (
/obj/structure/chair/comfy/brown{
	dir = 1;
	color = "#c45c57";
	buildstackamount = 0
	},
/obj/machinery/atmospherics/components/unary/vent_pump/on/layer4{
	dir = 4
	},
/obj/effect/turf_decal/siding/dark{
	dir = 4
	},
/obj/machinery/requests_console/directional/south,
/obj/effect/landmark/start/detective,
/turf/open/floor/carpet,
/area/station/security/detectives_office)
"S" = (
/obj/structure/cable,
/obj/machinery/atmospherics/pipe/smart/manifold4w/scrubbers/hidden/layer2,
/obj/machinery/atmospherics/pipe/smart/manifold4w/supply/hidden/layer4,
/turf/open/floor/iron/dark,
/area/station/security/detectives_office)
"T" = (
/obj/structure/table/wood,
/obj/machinery/computer/records/security/laptop{
	dir = 4
	},
/obj/structure/secure_safe/directional/south,
/obj/machinery/button/door/directional/west,
/obj/machinery/light_switch/directional/west{
	pixel_x = -32;
	pixel_y = -3
	},
/turf/open/floor/carpet,
/area/station/security/detectives_office)
"U" = (
/obj/effect/mapping_helpers/airlock/access/all/security/detective,
/obj/machinery/door/airlock/security{
	name = "Detective's Office"
	},
/obj/effect/landmark/navigate_destination/autoname,
/obj/machinery/door/firedoor,
/turf/open/floor/iron/dark,
/area/station/security/detectives_office)
"W" = (
/obj/structure/chair{
	dir = 4
	},
/obj/machinery/atmospherics/components/unary/vent_pump/on/layer4{
	dir = 1
	},
/obj/machinery/light_switch/directional/south,
/turf/open/floor/iron/dark,
/area/station/security/detectives_office)
"Y" = (
/obj/structure/table,
/obj/item/flashlight/lamp{
	pixel_y = 9;
	pixel_x = -5
	},
/obj/effect/decal/cleanable/blood/old,
/obj/item/radio/intercom/command/directional/south,
/obj/item/book/manual/wiki/security_space_law/weighted{
	pixel_x = 6;
	pixel_y = 3
	},
/obj/machinery/light/small/directional/south,
/obj/item/taperecorder,
/turf/open/floor/iron/dark,
/area/station/security/detectives_office)
"Z" = (
/obj/structure/closet/secure_closet/detective,
/obj/item/storage/box/evidence,
/obj/item/hand_labeler{
	pixel_x = 5
	},
/obj/item/camera/detective,
/obj/item/modular_computer/laptop/preset/security,
/obj/item/newspaper{
	pixel_x = 5;
	pixel_y = 1
	},
/obj/machinery/newscaster/directional/east,
/obj/item/folder/red,
/obj/item/clothing/neck/tie/disco,
/obj/item/reagent_containers/cup/glass/bottle/whiskey,
/obj/item/taperecorder,
/obj/item/book/manual/wiki/security_space_law{
	pixel_y = 3
	},
/obj/item/clothing/glasses/hud/security/sunglasses,
/turf/open/floor/wood,
/area/station/security/detectives_office)

(1,1,1) = {"
n
A
n
n
n
n
n
P
m
"}
(2,1,1) = {"
K
H
L
E
T
n
B
W
J
"}
(3,1,1) = {"
K
b
j
u
R
n
a
Y
J
"}
(4,1,1) = {"
n
y
w
I
I
D
S
p
J
"}
(5,1,1) = {"
U
t
G
Z
O
n
h
x
J
"}
(6,1,1) = {"
n
n
n
n
n
n
n
n
J
"}
