"a" = (/turf/closed/wall,/area/station/cargo/blacksmith)
"c" = (/obj/machinery/light_switch/directional/north,/obj/effect/landmark/start/blacksmith,/obj/structure/chair{dir = 8},/obj/effect/turf_decal/siding/wood{dir = 9},/turf/open/floor/stone,/area/station/cargo/blacksmith)
"g" = (/obj/machinery/atmospherics/components/unary/vent_pump/on/layer4{dir = 4},/obj/effect/decal/cleanable/dirt,/turf/open/floor/stone,/area/station/cargo/blacksmith)
"k" = (/obj/structure/cable,/obj/machinery/atmospherics/pipe/smart/manifold4w/supply/hidden/layer4,/obj/machinery/atmospherics/pipe/smart/manifold4w/scrubbers/hidden/layer2,/obj/structure/sign/poster/random/directional/east,/obj/effect/turf_decal/siding/wood{dir = 4},/turf/open/floor/stone,/area/station/cargo/blacksmith)
"l" = (/obj/machinery/airalarm/directional/east,/obj/structure/closet/secure_closet/miner,/turf/open/floor/iron,/area/station/cargo/miningdock)
"n" = (/obj/structure/reagent_anvil,/obj/machinery/requests_console/directional/west{department = "Blacksmiths Workshop"; name = "Blacksmiths Requests console"; pixel_x = 30},/obj/effect/decal/cleanable/dirt,/obj/item/stack/sheet/iron/fifty{pixel_x = -7},/obj/item/stack/sheet/glass/fifty{pixel_x = -3},/obj/effect/turf_decal/siding/wood{dir = 6},/turf/open/floor/stone,/area/station/cargo/blacksmith)
"q" = (/obj/structure/cable,/obj/machinery/atmospherics/pipe/smart/manifold4w/supply/hidden/layer4,/obj/machinery/atmospherics/pipe/smart/manifold4w/scrubbers/hidden/layer2,/obj/effect/mapping_helpers/airlock/access/any/supply/blacksmith,/obj/machinery/door/airlock/maintenance,/turf/open/floor/plating,/area/station/cargo/blacksmith)
"t" = (/obj/structure/reagent_forge,/obj/machinery/light/directional/south,/obj/effect/decal/cleanable/dirt,/obj/effect/turf_decal/siding/wood,/turf/open/floor/stone,/area/station/cargo/blacksmith)
"v" = (/turf/closed/wall,/area/station/cargo/miningdock)
"x" = (/obj/structure/cable,/obj/machinery/atmospherics/pipe/smart/manifold4w/supply/hidden/layer4,/obj/effect/landmark/event_spawn,/turf/open/floor/stone,/area/station/cargo/blacksmith)
"y" = (/obj/machinery/atmospherics/components/unary/vent_scrubber/on/layer2{dir = 8},/obj/machinery/light/directional/south,/obj/structure/closet/secure_closet/miner,/turf/open/floor/iron,/area/station/cargo/miningdock)
"C" = (/turf/closed/wall,/area/station/maintenance/port/aft)
"E" = (/obj/machinery/power/apc/auto_name/directional/east,/obj/structure/cable,/obj/machinery/atmospherics/pipe/smart/manifold4w/supply/hidden/layer4,/obj/effect/decal/cleanable/dirt,/obj/effect/landmark/start/blacksmith,/obj/effect/turf_decal/siding/wood{dir = 4},/turf/open/floor/stone,/area/station/cargo/blacksmith)
"G" = (/obj/structure/table/reinforced,/obj/machinery/door/window{dir = 4; name = "Blacksmith Desk"; req_access = list("cargo")},/obj/structure/window/spawner/directional/north{dir = 2},/obj/machinery/door/firedoor,/turf/open/floor/stone,/area/station/cargo/blacksmith)
"H" = (/turf/open/floor/iron,/area/station/cargo/miningdock)
"N" = (/obj/machinery/door/airlock/mining{name = "Blacksmith Workshop"},/obj/effect/mapping_helpers/airlock/access/any/supply/blacksmith,/obj/machinery/door/firedoor,/turf/open/floor/stone,/area/station/cargo/blacksmith)
"O" = (/obj/structure/reagent_water_basin,/obj/effect/decal/cleanable/dirt,/obj/effect/turf_decal/siding/wood{dir = 10},/turf/open/floor/stone,/area/station/cargo/blacksmith)
"S" = (/obj/structure/closet/secure_closet/miner,/turf/open/floor/iron,/area/station/cargo/miningdock)
"Z" = (/obj/machinery/camera/autoname/directional/north,/obj/machinery/airalarm/directional/north,/obj/machinery/atmospherics/components/unary/vent_scrubber/on/layer2{dir = 4},/obj/effect/decal/cleanable/dirt,/obj/effect/turf_decal/siding/wood{dir = 1},/turf/open/floor/stone,/area/station/cargo/blacksmith)

(1,1,1) = {"
HlCCCqC
HHGcZka
HHNgxEa
ySaOtna
vvaaaaa
"}
