//MAP CONVERTED BY dmm2tgm.py THIS HEADER COMMENT PREVENTS RECONVERSION, DO NOT REMOVE
"a" = (
/turf/open/floor/carpet/executive,
/area/centcom/central_command_areas/admin/interlink)
"b" = (
/obj/machinery/holopad/secure,
/obj/effect/turf_decal/siding/wood{
	dir = 8
	},
/turf/open/floor/wood/large,
/area/centcom/central_command_areas/admin/interlink)
"d" = (
/obj/machinery/power/apc/auto_name/directional/south,
/obj/effect/mapping_helpers/apc/cell_10k,
/obj/structure/cable,
/obj/effect/turf_decal/siding/wood/corner{
	dir = 1
	},
/turf/open/floor/wood/large,
/area/centcom/central_command_areas/admin/interlink)
"e" = (
/obj/machinery/modular_computer/preset/id/centcom,
/turf/open/floor/carpet/executive,
/area/centcom/central_command_areas/admin/interlink)
"g" = (
/obj/structure/table/wood,
/obj/item/folder/red{
	pixel_x = 7;
	pixel_y = 7
	},
/obj/item/folder/blue{
	pixel_x = 5;
	pixel_y = 5
	},
/obj/item/folder/yellow{
	pixel_x = 3;
	pixel_y = 2
	},
/turf/open/floor/carpet/executive,
/area/centcom/central_command_areas/admin/interlink)
"h" = (
/obj/structure/table/wood,
/obj/machinery/chem_dispenser/drinks/fullupgrade{
	pixel_y = 24;
	density = 0
	},
/obj/machinery/light/directional/west,
/obj/effect/turf_decal/siding/wood/corner,
/turf/open/floor/wood/large,
/area/centcom/central_command_areas/admin/interlink)
"j" = (
/obj/structure/bed/double,
/obj/item/bedsheet/centcom/double,
/turf/open/floor/wood/large,
/area/centcom/central_command_areas/admin/interlink)
"k" = (
/obj/effect/turf_decal/siding/wood{
	dir = 4
	},
/obj/machinery/camera/autoname/directional/south{
	network = list("secret")
	},
/turf/open/floor/wood/large,
/area/centcom/central_command_areas/admin/interlink)
"l" = (
/obj/structure/table/wood,
/obj/effect/turf_decal/siding/wood,
/obj/machinery/chem_dispenser/drinks/beer/fullupgrade{
	density = 0;
	pixel_y = 24
	},
/turf/open/floor/wood/large,
/area/centcom/central_command_areas/admin/interlink)
"m" = (
/obj/effect/turf_decal/siding/wood,
/obj/machinery/vending/boozeomat/cafe{
	pixel_y = 32;
	density = 0
	},
/turf/open/floor/wood/large,
/area/centcom/central_command_areas/admin/interlink)
"n" = (
/turf/closed/indestructible/riveted,
/area/centcom/central_command_areas/admin/interlink)
"o" = (
/obj/machinery/light/directional/east,
/turf/open/floor/wood/large,
/area/centcom/central_command_areas/admin/interlink)
"p" = (
/obj/structure/table/wood,
/obj/item/stamp/centcom{
	pixel_x = -8;
	pixel_y = 10
	},
/obj/item/stamp/denied{
	pixel_x = 8;
	pixel_y = 10
	},
/obj/item/stamp{
	pixel_y = 10
	},
/obj/machinery/requests_console/auto_name/directional/north{
	pixel_x = 3;
	pixel_y = 31
	},
/obj/effect/mapping_helpers/requests_console/announcement,
/obj/effect/mapping_helpers/requests_console/assistance,
/obj/effect/mapping_helpers/requests_console/information,
/obj/machinery/button/door/directional/north{
	name = "Admin Shutter Control";
	id = "admin_shutters";
	pixel_x = -5;
	pixel_y = 21
	},
/obj/item/toy/crayon/white{
	pixel_x = 9
	},
/turf/open/floor/carpet/executive,
/area/centcom/central_command_areas/admin/interlink)
"q" = (
/obj/effect/turf_decal/siding/wood{
	dir = 4
	},
/obj/structure/chair/comfy/beige{
	dir = 4
	},
/turf/open/floor/wood/large,
/area/centcom/central_command_areas/admin/interlink)
"r" = (
/obj/structure/dresser,
/turf/open/floor/wood/large,
/area/centcom/central_command_areas/admin/interlink)
"s" = (
/obj/structure/filingcabinet/employment,
/obj/structure/filingcabinet/medical{
	pixel_x = 10
	},
/obj/structure/filingcabinet/security{
	pixel_x = -10
	},
/turf/open/floor/carpet/executive,
/area/centcom/central_command_areas/admin/interlink)
"t" = (
/turf/template_noop,
/area/template_noop)
"u" = (
/obj/effect/spawner/structure/window/reinforced,
/obj/machinery/door/poddoor/shutters/indestructible{
	id = "admin_shutters"
	},
/turf/open/floor/wood/large,
/area/centcom/central_command_areas/admin/interlink)
"v" = (
/obj/effect/turf_decal/siding/wood{
	dir = 1
	},
/turf/open/floor/wood/large,
/area/centcom/central_command_areas/admin/interlink)
"x" = (
/obj/machinery/light/directional/east,
/turf/open/floor/carpet/executive,
/area/centcom/central_command_areas/admin/interlink)
"z" = (
/obj/structure/closet/crate/bin,
/obj/machinery/light/directional/west,
/obj/effect/turf_decal/siding/wood/corner{
	dir = 4
	},
/turf/open/floor/wood/large,
/area/centcom/central_command_areas/admin/interlink)
"A" = (
/obj/structure/bookcase/random/reference,
/turf/open/floor/wood/large,
/area/centcom/central_command_areas/admin/interlink)
"C" = (
/obj/structure/closet/secure_closet/personal/cabinet,
/turf/open/floor/wood/large,
/area/centcom/central_command_areas/admin/interlink)
"D" = (
/obj/machinery/computer/camera_advanced,
/obj/structure/chalkboard{
	pixel_y = 32
	},
/turf/open/floor/carpet/executive,
/area/centcom/central_command_areas/admin/interlink)
"E" = (
/obj/effect/turf_decal/siding/wood{
	dir = 8
	},
/turf/open/floor/wood/large,
/area/centcom/central_command_areas/admin/interlink)
"F" = (
/obj/machinery/door/airlock/corporate{
	name = "Administrative Office"
	},
/obj/effect/mapping_helpers/airlock/access/any/cent_com/rep_or_captain,
/obj/effect/mapping_helpers/airlock/cutaiwire,
/obj/effect/turf_decal/siding/wood{
	dir = 8
	},
/turf/open/floor/wood/large,
/area/centcom/central_command_areas/admin/interlink)
"G" = (
/obj/structure/table/wood,
/obj/item/flashlight/lamp/green{
	pixel_x = -8;
	pixel_y = 2
	},
/obj/item/feather,
/obj/item/pen/fountain/captain{
	pixel_y = -1;
	pixel_x = 6
	},
/obj/item/pen/fourcolor{
	pixel_x = 8;
	pixel_y = 3
	},
/turf/open/floor/carpet/executive,
/area/centcom/central_command_areas/admin/interlink)
"I" = (
/obj/structure/chair/comfy/beige{
	dir = 8
	},
/turf/open/floor/carpet/executive,
/area/centcom/central_command_areas/admin/interlink)
"J" = (
/obj/machinery/vending/wardrobe/cent_wardrobe{
	density = 0;
	pixel_y = 31;
	pixel_x = 6
	},
/obj/machinery/vending/access/command{
	pixel_x = 28;
	density = 0
	},
/turf/open/floor/wood/large,
/area/centcom/central_command_areas/admin/interlink)
"K" = (
/obj/machinery/light_switch/directional/south,
/turf/open/floor/carpet/executive,
/area/centcom/central_command_areas/admin/interlink)
"L" = (
/obj/machinery/photocopier/gratis,
/turf/open/floor/carpet/executive,
/area/centcom/central_command_areas/admin/interlink)
"M" = (
/obj/item/banner/command/mundane,
/obj/effect/turf_decal/siding/wood{
	dir = 4
	},
/turf/open/floor/wood/large,
/area/centcom/central_command_areas/admin/interlink)
"N" = (
/obj/structure/fireplace,
/obj/item/stack/sheet/mineral/wood/fifty{
	pixel_y = -5;
	pixel_x = -10
	},
/obj/effect/turf_decal/siding/wood/corner{
	dir = 8
	},
/turf/open/floor/wood/large,
/area/centcom/central_command_areas/admin/interlink)
"O" = (
/obj/structure/table/wood,
/obj/machinery/fax{
	fax_name = "Administrative Office"
	},
/obj/effect/turf_decal/siding/wood/corner,
/turf/open/floor/wood/large,
/area/centcom/central_command_areas/admin/interlink)
"P" = (
/obj/structure/table/wood,
/obj/item/paper_bin{
	papertype = /obj/item/paper/paperslip/corporate
	},
/turf/open/floor/carpet/executive,
/area/centcom/central_command_areas/admin/interlink)
"R" = (
/obj/structure/sign/flag/nanotrasen/directional/south,
/obj/structure/bed/dogbed,
/obj/effect/turf_decal/siding/wood{
	dir = 1
	},
/mob/living/basic/pet/penguin/emperor/neuter{
	desc = "Empress of all she surveys. No wonder the room is kept so cold though!";
	name = "Pengy The Mighty"
	},
/turf/open/floor/wood/large,
/area/centcom/central_command_areas/admin/interlink)
"S" = (
/obj/effect/turf_decal/siding/wood{
	dir = 1
	},
/obj/machinery/door/airlock/corporate,
/obj/effect/mapping_helpers/airlock/cutaiwire,
/obj/effect/mapping_helpers/airlock/access/any/cent_com/rep_or_captain,
/turf/open/floor/wood/large,
/area/centcom/central_command_areas/admin/interlink)
"T" = (
/turf/open/floor/carpet/royalblack,
/area/centcom/central_command_areas/admin/interlink)
"U" = (
/obj/effect/turf_decal/siding/wood{
	dir = 4
	},
/turf/open/floor/wood/large,
/area/centcom/central_command_areas/admin/interlink)
"W" = (
/turf/open/floor/wood/large,
/area/centcom/central_command_areas/admin/interlink)
"X" = (
/obj/machinery/light_switch/directional/west,
/turf/open/floor/wood/large,
/area/centcom/central_command_areas/admin/interlink)

(1,1,1) = {"
n
n
u
F
u
n
n
t
t
t
t
t
"}
(2,1,1) = {"
n
h
U
U
M
z
u
t
t
t
t
t
"}
(3,1,1) = {"
n
l
T
T
T
v
u
t
t
t
t
t
"}
(4,1,1) = {"
n
m
T
T
T
R
n
t
t
t
t
t
"}
(5,1,1) = {"
n
N
E
b
E
d
n
t
t
t
t
t
"}
(6,1,1) = {"
n
O
q
q
U
k
n
t
t
t
t
t
"}
(7,1,1) = {"
n
n
p
g
G
a
n
n
n
n
n
n
"}
(8,1,1) = {"
t
n
D
I
P
K
n
A
X
C
r
n
"}
(9,1,1) = {"
t
n
e
a
a
a
S
W
W
W
W
n
"}
(10,1,1) = {"
t
n
n
s
x
L
n
J
o
W
j
n
"}
(11,1,1) = {"
t
t
n
n
n
n
n
n
n
n
n
n
"}
