//MAP CONVERTED BY dmm2tgm.py THIS HEADER COMMENT PREVENTS RECONVERSION, DO NOT REMOVE
"ay" = (
/obj/machinery/vending/coffee{
	shut_up = 1;
	pixel_y = -12
	},
/turf/closed/indestructible/wood,
/area/misc/hilbertshotel)
"by" = (
/obj/effect/turf_decal/siding/wood{
	dir = 8
	},
/obj/structure/table,
/turf/open/floor/iron/kitchen/small,
/area/misc/hilbertshotel)
"cm" = (
/obj/structure/closet/crate/wooden,
/obj/item/stack/sheet/mineral/wood/fifty,
/obj/machinery/light,
/turf/open/floor/wood,
/area/misc/hilbertshotel)
"cI" = (
/obj/structure/chair/sofa/corp/right{
	dir = 1
	},
/obj/effect/turf_decal/siding/wood{
	dir = 6
	},
/turf/open/floor/carpet/green,
/area/misc/hilbertshotel)
"cJ" = (
/obj/structure/spacevine,
/obj/structure/flora/tree/jungle/small,
/turf/closed/indestructible/rock,
/area/misc/hilbertshotel)
"cL" = (
/obj/structure/chair/pew/left,
/turf/open/misc/grass,
/area/misc/hilbertshotel)
"cN" = (
/turf/closed/indestructible/hoteldoor{
	icon_state = "door_closed";
	icon = 'icons/obj/doors/puzzledoor/default.dmi'
	},
/area/misc/hilbertshotel)
"dc" = (
/obj/structure/flora/rock/pile/jungle/style_random,
/turf/open/misc/dirt/station,
/area/misc/hilbertshotel)
"dw" = (
/obj/structure/flora/grass/jungle/b,
/turf/open/water/jungle,
/area/misc/hilbertshotel)
"dy" = (
/obj/machinery/light{
	dir = 4
	},
/turf/open/water/jungle,
/area/misc/hilbertshotel)
"ef" = (
/turf/open/floor/wood,
/area/misc/hilbertshotel)
"ff" = (
/obj/structure/flora/grass/jungle/b,
/turf/open/misc/grass,
/area/misc/hilbertshotel)
"fr" = (
/obj/structure/curtain/cloth/fancy,
/obj/structure/window/reinforced/spawner/directional/south,
/obj/effect/spawner/liquids_spawner,
/turf/open/floor/iron/pool/cobble/corner{
	dir = 8
	},
/area/misc/hilbertshotel)
"ga" = (
/obj/structure/flora/grass/jungle,
/turf/open/misc/dirt/dark/station,
/area/misc/hilbertshotel)
"gN" = (
/obj/machinery/light/floor{
	light_power = 20;
	light_range = 5
	},
/turf/open/floor/wood,
/area/misc/hilbertshotel)
"hc" = (
/obj/machinery/jukebox{
	req_one_access = null;
	set_obj_flags = "EMAGGED"
	},
/obj/structure/window/reinforced/spawner/directional/west,
/turf/open/floor/wood,
/area/misc/hilbertshotel)
"ht" = (
/obj/structure/flora/grass/jungle,
/turf/open/misc/dirt/station,
/area/misc/hilbertshotel)
"hC" = (
/obj/structure/flora/grass/jungle/b,
/turf/open/misc/dirt/dark/station,
/area/misc/hilbertshotel)
"hV" = (
/obj/machinery/vending/games{
	shut_up = 1;
	pixel_y = -12
	},
/turf/closed/indestructible/wood,
/area/misc/hilbertshotel)
"ih" = (
/obj/structure/flora/grass/jungle,
/turf/open/misc/grass,
/area/misc/hilbertshotel)
"iy" = (
/obj/structure/flora/grass/jungle,
/obj/structure/flora/rock/pile/jungle/style_random,
/turf/open/misc/grass,
/area/misc/hilbertshotel)
"iz" = (
/obj/structure/spacevine,
/turf/open/misc/grass,
/area/misc/hilbertshotel)
"jM" = (
/obj/structure/flora/rock/pile,
/turf/open/misc/grass,
/area/misc/hilbertshotel)
"kp" = (
/obj/structure/table/glass,
/obj/effect/turf_decal/siding/wood{
	dir = 1
	},
/turf/open/floor/carpet/green,
/area/misc/hilbertshotel)
"kB" = (
/obj/effect/turf_decal/siding/wood{
	dir = 4
	},
/obj/machinery/vending/boozeomat,
/obj/machinery/light{
	dir = 4
	},
/turf/open/floor/iron/kitchen/small,
/area/misc/hilbertshotel)
"ll" = (
/obj/effect/turf_decal/siding/wood{
	dir = 6
	},
/obj/structure/table,
/obj/machinery/microwave,
/turf/open/floor/iron/kitchen/small,
/area/misc/hilbertshotel)
"lG" = (
/obj/structure/flora/grass/jungle,
/obj/machinery/light/small{
	dir = 1
	},
/turf/open/misc/grass,
/area/misc/hilbertshotel)
"nA" = (
/obj/structure/flora/grass/jungle,
/obj/structure/spacevine,
/turf/open/misc/grass,
/area/misc/hilbertshotel)
"nP" = (
/obj/structure/chair/stool/bar/directional/east,
/turf/open/floor/wood,
/area/misc/hilbertshotel)
"oi" = (
/obj/structure/sink/directional/east,
/obj/structure/mirror/directional/west,
/turf/open/floor/iron/white/small,
/area/misc/hilbertshotel)
"oA" = (
/obj/structure/flora/grass/jungle,
/obj/structure/flora/grass/jungle/b,
/turf/open/misc/grass,
/area/misc/hilbertshotel)
"oP" = (
/obj/structure/mineral_door/wood,
/turf/open/floor/wood,
/area/misc/hilbertshotel)
"pd" = (
/obj/structure/table/wood,
/obj/structure/curtain/cloth/fancy,
/obj/structure/window/reinforced/spawner/directional/south,
/turf/open/floor/wood,
/area/misc/hilbertshotel)
"pR" = (
/obj/structure/fireplace,
/turf/open/floor/wood,
/area/misc/hilbertshotel)
"qi" = (
/obj/structure/flora/grass/jungle/b,
/obj/structure/flora/grass/jungle/b,
/obj/structure/flora/grass/jungle,
/turf/open/misc/grass,
/area/misc/hilbertshotel)
"qH" = (
/obj/machinery/shower/directional/west,
/obj/effect/spawner/liquids_spawner,
/turf/open/floor/iron/pool/cobble/corner,
/area/misc/hilbertshotel)
"rd" = (
/turf/open/space/bluespace,
/area/misc/hilbertshotel)
"rh" = (
/obj/structure/closet/cabinet,
/obj/effect/turf_decal/siding/wood{
	dir = 6
	},
/obj/item/clothing/shoes/sandal,
/obj/item/clothing/shoes/sandal,
/turf/open/floor/carpet/royalblue,
/area/misc/hilbertshotel)
"rC" = (
/obj/structure/chair/sofa/corp/corner{
	dir = 1
	},
/obj/effect/turf_decal/siding/wood{
	dir = 10
	},
/turf/open/floor/carpet/green,
/area/misc/hilbertshotel)
"sl" = (
/obj/machinery/light{
	dir = 8
	},
/turf/open/floor/wood,
/area/misc/hilbertshotel)
"sr" = (
/obj/machinery/light,
/turf/open/water/jungle,
/area/misc/hilbertshotel)
"ta" = (
/obj/structure/flora/rock/pile,
/obj/structure/flora/grass/jungle/b,
/obj/structure/flora/grass/jungle,
/turf/open/misc/grass,
/area/misc/hilbertshotel)
"uL" = (
/obj/structure/mineral_door/paperframe,
/turf/open/floor/wood,
/area/misc/hilbertshotel)
"vp" = (
/obj/structure/flora/tree/jungle,
/obj/structure/spacevine,
/turf/closed/indestructible/rock,
/area/misc/hilbertshotel)
"vx" = (
/obj/structure/flora/grass/jungle,
/obj/structure/flora/tree/jungle/small,
/turf/open/misc/grass,
/area/misc/hilbertshotel)
"wR" = (
/obj/machinery/room_controller/directional/north,
/turf/open/floor/wood,
/area/misc/hilbertshotel)
"xQ" = (
/obj/effect/turf_decal/siding/wood{
	dir = 5
	},
/obj/structure/bed/double,
/turf/open/floor/carpet/royalblue,
/area/misc/hilbertshotel)
"yc" = (
/turf/closed/indestructible/wood,
/area/misc/hilbertshotel)
"ys" = (
/obj/structure/railing,
/turf/open/floor/iron/white/small,
/area/misc/hilbertshotel)
"yL" = (
/obj/machinery/light/small{
	dir = 1
	},
/obj/machinery/light/floor{
	light_power = 20;
	light_range = 5
	},
/turf/open/misc/grass,
/area/misc/hilbertshotel)
"ze" = (
/obj/structure/bonfire,
/turf/open/misc/grass,
/area/misc/hilbertshotel)
"zI" = (
/obj/effect/turf_decal/siding/wood{
	dir = 9
	},
/obj/structure/chair/sofa/corp/left{
	dir = 4
	},
/turf/open/floor/carpet/green,
/area/misc/hilbertshotel)
"AB" = (
/obj/effect/turf_decal/siding/wood,
/obj/structure/chair/wood,
/turf/open/floor/carpet/royalblue,
/area/misc/hilbertshotel)
"BH" = (
/turf/open/misc/grass,
/area/misc/hilbertshotel)
"Cd" = (
/obj/structure/fake_stairs/wood/directional/north,
/turf/open/floor/wood,
/area/misc/hilbertshotel)
"Cj" = (
/obj/effect/turf_decal/siding/wood{
	dir = 5
	},
/obj/machinery/vending/dinnerware{
	contraband = list(/obj/item/kitchen/rollingpin=2,/obj/item/kitchen/knife/butcher=2,/obj/item/reagent_containers/food/condiment/flour=4);
	shut_up = 1
	},
/turf/open/floor/iron/kitchen/small,
/area/misc/hilbertshotel)
"Ck" = (
/obj/effect/turf_decal/siding/wood{
	dir = 10
	},
/obj/structure/table,
/turf/open/floor/iron/kitchen/small,
/area/misc/hilbertshotel)
"Co" = (
/obj/structure/railing{
	dir = 9
	},
/obj/machinery/light/floor{
	light_power = 20;
	light_range = 5
	},
/turf/open/floor/wood,
/area/misc/hilbertshotel)
"Cr" = (
/obj/structure/flora/rock/pile/jungle/style_random,
/turf/open/misc/grass,
/area/misc/hilbertshotel)
"DA" = (
/turf/open/water/jungle,
/area/misc/hilbertshotel)
"DP" = (
/turf/open/misc/dirt/dark/station,
/area/misc/hilbertshotel)
"Eq" = (
/obj/structure/spacevine,
/obj/structure/flora/grass/jungle,
/obj/structure/flora/tree/jungle,
/turf/open/misc/grass,
/area/misc/hilbertshotel)
"Fr" = (
/obj/effect/turf_decal/siding/wood,
/obj/structure/table,
/obj/machinery/reagentgrinder,
/turf/open/floor/iron/kitchen/small,
/area/misc/hilbertshotel)
"Gt" = (
/obj/effect/turf_decal/siding/wood{
	dir = 10
	},
/obj/structure/closet/crate/bin{
	pixel_x = -6
	},
/turf/open/floor/carpet/royalblue,
/area/misc/hilbertshotel)
"GA" = (
/obj/effect/turf_decal/siding/wood{
	dir = 9
	},
/obj/machinery/light_switch/directional/north,
/turf/open/floor/carpet/royalblue,
/area/misc/hilbertshotel)
"GR" = (
/obj/structure/flora/grass/jungle/b,
/obj/structure/flora/rock/pile/jungle/style_random,
/turf/open/water/jungle,
/area/misc/hilbertshotel)
"HF" = (
/obj/structure/flora/rock/pile/jungle/style_random,
/turf/open/misc/dirt/dark/station,
/area/misc/hilbertshotel)
"If" = (
/obj/effect/turf_decal/siding/wood{
	dir = 9
	},
/turf/open/floor/iron/kitchen/small,
/area/misc/hilbertshotel)
"II" = (
/obj/effect/spawner/liquids_spawner,
/turf/open/floor/iron/pool/cobble/corner{
	dir = 1
	},
/area/misc/hilbertshotel)
"JE" = (
/obj/machinery/light/floor{
	light_power = 20;
	light_range = 5
	},
/turf/open/misc/grass,
/area/misc/hilbertshotel)
"KI" = (
/obj/structure/flora/grass/jungle,
/turf/open/water/jungle,
/area/misc/hilbertshotel)
"KX" = (
/obj/structure/flora/grass/jungle/b,
/obj/structure/chair/pew/right,
/obj/item/instrument/banjo,
/turf/open/misc/grass,
/area/misc/hilbertshotel)
"Ln" = (
/obj/structure/railing{
	dir = 1
	},
/turf/open/floor/wood,
/area/misc/hilbertshotel)
"Lx" = (
/turf/open/misc/dirt/station,
/area/misc/hilbertshotel)
"LF" = (
/obj/machinery/light/floor{
	light_power = 20;
	light_range = 5
	},
/turf/open/water/jungle,
/area/misc/hilbertshotel)
"LZ" = (
/obj/structure/railing{
	dir = 8
	},
/obj/structure/fake_stairs/wood/directional/north,
/turf/open/floor/wood,
/area/misc/hilbertshotel)
"Mh" = (
/obj/machinery/light_switch/directional/north,
/turf/open/floor/wood,
/area/misc/hilbertshotel)
"Mn" = (
/obj/structure/flora/grass/jungle/a/style_random,
/turf/open/misc/dirt/station,
/area/misc/hilbertshotel)
"Np" = (
/obj/structure/railing/corner,
/obj/machinery/light/small{
	dir = 1
	},
/turf/open/floor/iron/white/small,
/area/misc/hilbertshotel)
"NB" = (
/obj/structure/chair/sofa/corp{
	dir = 1
	},
/obj/effect/turf_decal/siding/wood,
/obj/machinery/light,
/turf/open/floor/carpet/green,
/area/misc/hilbertshotel)
"NJ" = (
/obj/structure/flora/grass/jungle/a/style_random,
/turf/open/misc/dirt/dark/station,
/area/misc/hilbertshotel)
"NR" = (
/obj/machinery/vending/dorms,
/turf/open/misc/grass,
/area/misc/hilbertshotel)
"Ox" = (
/obj/structure/table/wood,
/obj/item/paper_bin,
/obj/item/pen/fountain,
/obj/structure/curtain/cloth/fancy,
/obj/structure/window/reinforced/spawner/directional/south,
/turf/open/floor/wood,
/area/misc/hilbertshotel)
"OK" = (
/obj/machinery/light{
	dir = 8
	},
/turf/open/misc/grass,
/area/misc/hilbertshotel)
"PM" = (
/obj/structure/flora/grass/jungle/b,
/obj/structure/flora/grass/jungle,
/obj/structure/flora/rock/pile/jungle/style_random,
/turf/open/misc/grass,
/area/misc/hilbertshotel)
"PR" = (
/turf/open/floor/iron/kitchen/small,
/area/misc/hilbertshotel)
"QA" = (
/turf/closed/indestructible/rock,
/area/misc/hilbertshotel)
"QJ" = (
/obj/structure/flora/tree/jungle/small,
/obj/structure/spacevine,
/turf/closed/indestructible/rock,
/area/misc/hilbertshotel)
"QQ" = (
/obj/structure/curtain/cloth/fancy,
/obj/structure/window/reinforced/spawner/directional/south,
/obj/effect/spawner/liquids_spawner,
/turf/open/floor/iron/pool/cobble/corner{
	dir = 4
	},
/area/misc/hilbertshotel)
"Rl" = (
/obj/structure/flora/grass/jungle/a/style_2,
/turf/open/misc/dirt/station,
/area/misc/hilbertshotel)
"Tl" = (
/obj/structure/toilet{
	dir = 4
	},
/obj/item/soap,
/obj/structure/window/reinforced/spawner/directional/east,
/turf/open/floor/iron/white/small,
/area/misc/hilbertshotel)
"TC" = (
/obj/structure/table/wood,
/obj/item/flashlight/lamp/green,
/obj/structure/curtain/cloth/fancy,
/obj/structure/window/reinforced/spawner/directional/south,
/turf/open/floor/wood,
/area/misc/hilbertshotel)
"Vf" = (
/obj/machinery/telecomms/relay/preset/auto,
/turf/open/floor/catwalk_floor,
/area/misc/hilbertshotel)
"Vx" = (
/obj/structure/flora/tree/jungle/small,
/turf/open/water/jungle,
/area/misc/hilbertshotel)
"VD" = (
/obj/structure/flora/rock,
/turf/open/misc/grass,
/area/misc/hilbertshotel)
"VE" = (
/obj/effect/turf_decal/siding/wood{
	dir = 5
	},
/obj/structure/table/glass,
/turf/open/floor/carpet/green,
/area/misc/hilbertshotel)
"Wk" = (
/obj/structure/spacevine,
/turf/closed/indestructible/rock,
/area/misc/hilbertshotel)
"Xw" = (
/obj/machinery/light/small{
	dir = 8
	},
/obj/structure/railing{
	dir = 8
	},
/obj/structure/railing{
	dir = 8;
	icon_state = "railing"
	},
/turf/open/floor/wood,
/area/misc/hilbertshotel)
"Yw" = (
/obj/effect/turf_decal/siding/wood{
	dir = 1
	},
/obj/structure/sink/kitchen/directional/south,
/turf/open/floor/iron/kitchen/small,
/area/misc/hilbertshotel)
"YC" = (
/obj/effect/turf_decal/siding/wood{
	dir = 1
	},
/turf/open/floor/carpet/royalblue,
/area/misc/hilbertshotel)
"Zg" = (
/obj/machinery/light{
	dir = 1
	},
/turf/open/floor/wood,
/area/misc/hilbertshotel)
"Zq" = (
/obj/structure/flora/grass/jungle/a/style_random,
/turf/open/misc/grass,
/area/misc/hilbertshotel)
"ZK" = (
/obj/structure/chair/pew,
/turf/open/misc/grass,
/area/misc/hilbertshotel)

(1,1,1) = {"
rd
rd
rd
rd
rd
rd
rd
rd
rd
rd
rd
rd
rd
rd
rd
rd
rd
rd
"}
(2,1,1) = {"
rd
QA
QA
QA
Wk
Wk
Wk
Wk
Wk
QJ
cN
Wk
Wk
QJ
Wk
Wk
cJ
rd
"}
(3,1,1) = {"
rd
QA
NR
nA
Eq
qi
oA
vx
OK
ga
NJ
DP
BH
OK
Lx
QJ
Wk
rd
"}
(4,1,1) = {"
rd
Wk
iz
iz
Wk
JE
ta
ff
NJ
hC
DP
HF
Zq
Rl
Lx
DA
vp
rd
"}
(5,1,1) = {"
rd
Wk
Co
Xw
LZ
LZ
LZ
ga
NJ
NJ
NJ
iy
JE
Lx
BH
sr
Wk
rd
"}
(6,1,1) = {"
rd
Wk
Ln
gN
Cd
Cd
Cd
DP
hC
DP
ff
BH
jM
dc
GR
DA
QJ
rd
"}
(7,1,1) = {"
rd
yc
oP
yc
hc
yc
yc
yc
yc
yL
PM
ih
VD
ht
DA
DA
Wk
rd
"}
(8,1,1) = {"
rd
yc
wR
sl
ef
yc
oi
Tl
yc
cL
BH
BH
Mn
Lx
DA
Vx
Wk
rd
"}
(9,1,1) = {"
rd
hV
ef
zI
rC
yc
Np
II
fr
ZK
Zq
ze
Lx
KI
DA
DA
vp
rd
"}
(10,1,1) = {"
rd
yc
pR
kp
NB
yc
ys
qH
QQ
ZK
ih
BH
ht
DA
DA
DA
Wk
rd
"}
(11,1,1) = {"
rd
ay
ef
VE
cI
yc
uL
yc
yc
KX
Zq
Cr
Mn
dw
DA
DA
QJ
rd
"}
(12,1,1) = {"
rd
yc
Zg
ef
ef
ef
ef
cm
yc
lG
BH
Lx
dc
DA
DA
DA
Wk
rd
"}
(13,1,1) = {"
rd
yc
Mh
nP
nP
yc
uL
yc
yc
ff
Zq
dc
DA
DA
LF
DA
vp
rd
"}
(14,1,1) = {"
rd
yc
If
by
Ck
yc
GA
Gt
TC
VD
JE
Mn
DA
DA
Vx
DA
Wk
rd
"}
(15,1,1) = {"
rd
yc
Yw
PR
Fr
yc
YC
AB
Ox
ih
Zq
ht
dw
DA
DA
DA
vp
rd
"}
(16,1,1) = {"
rd
yc
Cj
kB
ll
yc
xQ
rh
pd
BH
BH
dc
dy
DA
DA
QJ
Wk
rd
"}
(17,1,1) = {"
rd
yc
yc
yc
yc
yc
yc
yc
yc
Wk
Wk
vp
Wk
Wk
vp
Wk
Vf
rd
"}
(18,1,1) = {"
rd
rd
rd
rd
rd
rd
rd
rd
rd
rd
rd
rd
rd
rd
rd
rd
rd
rd
"}
