//MAP CONVERTED BY dmm2tgm.py THIS HEADER COMMENT PREVENTS RECONVERSION, DO NOT REMOVE
"aM" = (
/obj/structure/flora/tree/dead,
/turf/closed/indestructible/rock/snow,
/area/misc/hilbertshotel)
"by" = (
/obj/effect/turf_decal/siding/wood/corner,
/obj/effect/turf_decal/siding/wood/corner{
	dir = 4
	},
/turf/open/floor/wood,
/area/misc/hilbertshotel)
"bV" = (
/obj/structure/chair/pew,
/obj/machinery/light/floor{
	light_color = "#f27d0c";
	color = "FFB43A"
	},
/turf/open/floor/fake_snow/safe,
/area/misc/hilbertshotel)
"cc" = (
/obj/effect/turf_decal/siding/wood{
	dir = 1
	},
/obj/structure/chair/sofa/left/brown,
/turf/open/floor/carpet/royalblack,
/area/misc/hilbertshotel)
"cd" = (
/obj/effect/turf_decal/siding/wood{
	dir = 4
	},
/obj/machinery/light/small{
	dir = 4
	},
/turf/open/floor/wood,
/area/misc/hilbertshotel)
"cq" = (
/obj/effect/turf_decal/siding/wood{
	dir = 1
	},
/obj/structure/dresser,
/turf/open/floor/carpet/royalblue,
/area/misc/hilbertshotel)
"cC" = (
/obj/structure/closet/crate/bin{
	pixel_x = -6
	},
/obj/machinery/light{
	dir = 8
	},
/turf/open/floor/iron/kitchen,
/area/misc/hilbertshotel)
"dq" = (
/obj/structure/bonfire,
/turf/open/floor/fake_snow/safe,
/area/misc/hilbertshotel)
"dU" = (
/obj/structure/flora/grass/green,
/obj/machinery/light/small,
/turf/open/floor/fake_snow/safe,
/area/misc/hilbertshotel)
"et" = (
/obj/machinery/vending/games{
	shut_up = 1
	},
/turf/closed/indestructible/wood,
/area/misc/hilbertshotel)
"ex" = (
/obj/structure/chair/pew,
/obj/effect/turf_decal/siding/wood{
	dir = 1
	},
/obj/machinery/light{
	dir = 1
	},
/turf/open/floor/wood,
/area/misc/hilbertshotel)
"eB" = (
/obj/effect/turf_decal/siding/wood/corner{
	dir = 1
	},
/turf/open/floor/wood,
/area/misc/hilbertshotel)
"gK" = (
/obj/structure/sink/directional/west{
	pixel_x = 13
	},
/obj/structure/mirror/directional/east,
/turf/open/floor/iron/white/small,
/area/misc/hilbertshotel)
"hm" = (
/obj/structure/table/reinforced,
/obj/machinery/reagentgrinder{
	pixel_y = 8
	},
/turf/open/floor/iron/kitchen,
/area/misc/hilbertshotel)
"hO" = (
/obj/structure/bookcase/random/nonfiction,
/turf/closed/indestructible/wood,
/area/misc/hilbertshotel)
"if" = (
/turf/open/floor/wood,
/area/misc/hilbertshotel)
"ir" = (
/obj/structure/flora/grass/brown,
/turf/open/misc/asteroid/snow,
/area/misc/hilbertshotel)
"it" = (
/obj/structure/flora/grass/brown,
/turf/open/floor/fake_snow/safe,
/area/misc/hilbertshotel)
"iy" = (
/obj/structure/chair/pew/left,
/obj/effect/turf_decal/siding/wood{
	dir = 1
	},
/turf/open/floor/wood,
/area/misc/hilbertshotel)
"jb" = (
/obj/effect/turf_decal/siding/wood{
	dir = 8
	},
/turf/open/floor/wood,
/area/misc/hilbertshotel)
"jI" = (
/obj/effect/turf_decal/siding/wood/corner{
	dir = 8
	},
/obj/effect/turf_decal/siding/wood/corner,
/turf/open/floor/carpet/royalblue,
/area/misc/hilbertshotel)
"jL" = (
/obj/effect/turf_decal/siding/wood{
	dir = 9
	},
/turf/open/floor/wood,
/area/misc/hilbertshotel)
"kk" = (
/obj/structure/fans/tiny/invisible,
/obj/effect/turf_decal/siding/wood/end{
	dir = 4
	},
/obj/structure/mineral_door/wood,
/turf/open/floor/wood,
/area/misc/hilbertshotel)
"kw" = (
/obj/structure/chair/pew/left,
/turf/open/floor/fake_snow/safe,
/area/misc/hilbertshotel)
"lu" = (
/turf/open/floor/iron/kitchen,
/area/misc/hilbertshotel)
"lD" = (
/obj/structure/bookcase/random/fiction,
/turf/closed/indestructible/wood,
/area/misc/hilbertshotel)
"lZ" = (
/obj/effect/turf_decal/siding/wood{
	dir = 1
	},
/turf/open/floor/wood,
/area/misc/hilbertshotel)
"mM" = (
/obj/machinery/vending/coffee{
	shut_up = 1
	},
/turf/closed/indestructible/wood,
/area/misc/hilbertshotel)
"mS" = (
/obj/structure/chair/pew/left{
	dir = 4
	},
/obj/effect/turf_decal/siding/wood{
	dir = 8
	},
/turf/open/floor/wood,
/area/misc/hilbertshotel)
"ni" = (
/obj/effect/turf_decal/siding/wood{
	dir = 4
	},
/obj/machinery/light{
	dir = 4
	},
/turf/open/floor/wood,
/area/misc/hilbertshotel)
"nq" = (
/obj/structure/sink/kitchen/directional/east,
/turf/open/floor/iron/kitchen,
/area/misc/hilbertshotel)
"nE" = (
/obj/effect/turf_decal/siding/wood{
	dir = 10
	},
/obj/machinery/vending/cigarette{
	shut_up = 1
	},
/turf/open/floor/carpet,
/area/misc/hilbertshotel)
"nP" = (
/obj/machinery/vending/dinnerware{
	contraband = list(/obj/item/kitchen/rollingpin=2,/obj/item/kitchen/knife/butcher=2,/obj/item/reagent_containers/food/condiment/flour=4);
	shut_up = 1
	},
/turf/closed/indestructible/wood,
/area/misc/hilbertshotel)
"nY" = (
/obj/structure/window/reinforced/tinted,
/obj/item/soap/deluxe,
/obj/machinery/shower/directional/east,
/turf/open/floor/iron/white/small,
/area/misc/hilbertshotel)
"ol" = (
/obj/structure/window/reinforced,
/obj/structure/table/wood,
/obj/structure/curtain/cloth/fancy,
/turf/open/floor/wood,
/area/misc/hilbertshotel)
"oy" = (
/obj/effect/turf_decal/siding/wood{
	dir = 5
	},
/turf/open/floor/carpet/royalblack,
/area/misc/hilbertshotel)
"oI" = (
/obj/effect/turf_decal/siding/wood,
/obj/structure/chair/sofa/right/brown{
	dir = 1
	},
/turf/open/floor/carpet/royalblack,
/area/misc/hilbertshotel)
"oQ" = (
/obj/effect/turf_decal/siding/wood{
	dir = 6
	},
/obj/structure/bed/double,
/turf/open/floor/carpet/royalblue,
/area/misc/hilbertshotel)
"pv" = (
/obj/effect/turf_decal/siding/wood{
	dir = 10
	},
/obj/structure/closet/cabinet,
/obj/item/clothing/shoes/winterboots{
	pixel_x = 2;
	pixel_y = -2
	},
/obj/item/clothing/shoes/winterboots{
	pixel_x = 2;
	pixel_y = -2
	},
/obj/item/clothing/suit/hooded/wintercoat,
/obj/item/clothing/suit/hooded/wintercoat,
/turf/open/floor/wood,
/area/misc/hilbertshotel)
"pD" = (
/obj/structure/chair/pew/right,
/turf/open/floor/fake_snow/safe,
/area/misc/hilbertshotel)
"qe" = (
/turf/closed/indestructible/rock/snow,
/area/misc/hilbertshotel)
"qA" = (
/obj/structure/chair/wood{
	dir = 1
	},
/turf/open/floor/fake_snow/safe,
/area/misc/hilbertshotel)
"qR" = (
/obj/structure/chair/wood{
	dir = 8
	},
/turf/open/floor/fake_snow/safe,
/area/misc/hilbertshotel)
"rf" = (
/turf/open/floor/plating/snowed/smoothed{
	planetary_atmos = 0
	},
/area/misc/hilbertshotel)
"rz" = (
/obj/effect/turf_decal/siding/wood/corner{
	dir = 4
	},
/obj/effect/turf_decal/siding/wood/corner,
/turf/open/floor/wood,
/area/misc/hilbertshotel)
"rZ" = (
/obj/effect/turf_decal/siding/wood{
	dir = 5
	},
/obj/machinery/jukebox{
	req_one_access = null;
	one_area_play = 1
	},
/turf/open/floor/wood,
/area/misc/hilbertshotel)
"sp" = (
/turf/closed/indestructible/hoteldoor{
	icon_state = "door_closed";
	icon = 'icons/obj/doors/puzzledoor/default.dmi'
	},
/area/misc/hilbertshotel)
"sv" = (
/turf/closed/indestructible/wood,
/area/misc/hilbertshotel)
"sA" = (
/obj/structure/flora/grass/green,
/turf/open/floor/fake_snow/safe,
/area/misc/hilbertshotel)
"sF" = (
/obj/effect/turf_decal/siding/wood{
	dir = 6
	},
/obj/machinery/light/small{
	dir = 4
	},
/turf/open/floor/carpet,
/area/misc/hilbertshotel)
"sS" = (
/obj/effect/turf_decal/siding/wood{
	dir = 4
	},
/obj/machinery/light/small{
	dir = 4;
	pixel_y = 17
	},
/obj/machinery/light_switch/directional/east,
/turf/open/floor/wood,
/area/misc/hilbertshotel)
"ti" = (
/obj/structure/flora/grass/both,
/obj/machinery/light/small{
	brightness = 3;
	dir = 8
	},
/turf/open/floor/fake_snow/safe,
/area/misc/hilbertshotel)
"tS" = (
/obj/structure/window/reinforced,
/obj/structure/table/wood,
/obj/item/flashlight/lamp/green,
/obj/structure/curtain/cloth/fancy,
/turf/open/floor/wood,
/area/misc/hilbertshotel)
"ux" = (
/obj/effect/turf_decal/siding/wood{
	dir = 4
	},
/obj/structure/fireplace{
	dir = 8
	},
/turf/open/floor/wood,
/area/misc/hilbertshotel)
"uU" = (
/obj/effect/turf_decal/siding/wood,
/turf/open/floor/wood,
/area/misc/hilbertshotel)
"ve" = (
/obj/effect/turf_decal/siding/wood{
	dir = 10
	},
/obj/structure/closet/cabinet,
/obj/item/clothing/shoes/sandal,
/obj/item/clothing/shoes/sandal,
/obj/item/clothing/under/costume/skyrat/bathrobe,
/turf/open/floor/carpet/royalblue,
/area/misc/hilbertshotel)
"wC" = (
/obj/structure/chair/pew/right{
	dir = 4
	},
/obj/effect/turf_decal/siding/wood{
	dir = 8
	},
/turf/open/floor/wood,
/area/misc/hilbertshotel)
"yC" = (
/obj/structure/flora/grass/both,
/turf/open/floor/fake_snow/safe,
/area/misc/hilbertshotel)
"yH" = (
/turf/open/space/bluespace,
/area/misc/hilbertshotel)
"zh" = (
/obj/effect/turf_decal/siding/wood,
/obj/effect/turf_decal/siding/wood{
	dir = 1
	},
/obj/structure/mineral_door/wood,
/turf/open/floor/wood,
/area/misc/hilbertshotel)
"zp" = (
/obj/structure/fans/tiny/invisible,
/obj/effect/turf_decal/siding/wood/end{
	dir = 1
	},
/obj/structure/mineral_door/wood,
/turf/open/floor/wood,
/area/misc/hilbertshotel)
"zE" = (
/obj/structure/table/wood,
/obj/effect/turf_decal/siding/wood{
	dir = 5
	},
/turf/open/floor/wood,
/area/misc/hilbertshotel)
"zT" = (
/obj/effect/turf_decal/siding/wood{
	dir = 4
	},
/obj/effect/turf_decal/siding/wood/corner{
	dir = 1
	},
/turf/open/floor/wood,
/area/misc/hilbertshotel)
"Ab" = (
/obj/effect/turf_decal/siding/wood{
	dir = 9
	},
/obj/machinery/computer{
	dir = 4;
	pixel_x = -3
	},
/turf/open/floor/carpet/royalblue,
/area/misc/hilbertshotel)
"Ad" = (
/obj/structure/chair/wood{
	dir = 4
	},
/turf/open/floor/plating/snowed/smoothed{
	planetary_atmos = 0
	},
/area/misc/hilbertshotel)
"Aq" = (
/obj/effect/turf_decal/siding/wood/corner{
	dir = 1
	},
/obj/effect/turf_decal/siding/wood/corner{
	dir = 8
	},
/turf/open/floor/carpet,
/area/misc/hilbertshotel)
"BZ" = (
/obj/effect/turf_decal/siding/wood{
	dir = 9
	},
/obj/structure/chair/sofa/corner/brown{
	dir = 4
	},
/turf/open/floor/carpet/royalblack,
/area/misc/hilbertshotel)
"Cx" = (
/obj/effect/turf_decal/siding/wood{
	dir = 1
	},
/obj/item/kirbyplants/random,
/turf/open/floor/carpet/royalblue,
/area/misc/hilbertshotel)
"CF" = (
/obj/structure/toilet{
	dir = 4
	},
/turf/open/floor/iron/white/small,
/area/misc/hilbertshotel)
"Dx" = (
/obj/effect/turf_decal/siding/wood{
	dir = 5
	},
/obj/structure/table/wood,
/obj/item/flashlight/lamp/green{
	pixel_x = 5;
	pixel_y = 14
	},
/obj/item/choice_beacon/box/plushie,
/turf/open/floor/carpet/royalblue,
/area/misc/hilbertshotel)
"El" = (
/obj/structure/closet/crate/freezer,
/obj/effect/turf_decal/siding/wood{
	dir = 6
	},
/turf/open/floor/wood,
/area/misc/hilbertshotel)
"EJ" = (
/obj/structure/chair/wood,
/turf/open/floor/fake_snow/safe,
/area/misc/hilbertshotel)
"ET" = (
/obj/effect/turf_decal/siding/wood{
	dir = 8
	},
/obj/structure/closet/cabinet,
/turf/open/floor/wood,
/area/misc/hilbertshotel)
"FL" = (
/obj/effect/turf_decal/siding/wood{
	dir = 1
	},
/obj/machinery/light_switch/directional/north,
/turf/open/floor/wood,
/area/misc/hilbertshotel)
"FV" = (
/obj/structure/table/wood/fancy,
/obj/effect/spawner/random/entertainment/lighter,
/turf/open/floor/carpet/royalblack,
/area/misc/hilbertshotel)
"GA" = (
/obj/machinery/light/small{
	dir = 4
	},
/turf/open/floor/iron/white/small,
/area/misc/hilbertshotel)
"GE" = (
/obj/effect/turf_decal/siding/wood{
	dir = 1
	},
/obj/machinery/light{
	dir = 1
	},
/obj/structure/sign/poster/official/the_owl/directional/north,
/turf/open/floor/wood,
/area/misc/hilbertshotel)
"Hj" = (
/obj/effect/turf_decal/siding/wood/corner,
/obj/effect/turf_decal/siding/wood/corner{
	dir = 8
	},
/turf/open/floor/carpet/royalblue,
/area/misc/hilbertshotel)
"HK" = (
/obj/effect/turf_decal/siding/wood{
	dir = 5
	},
/obj/machinery/light/small{
	dir = 4
	},
/obj/machinery/room_controller/directional/north,
/turf/open/floor/carpet,
/area/misc/hilbertshotel)
"Ic" = (
/obj/structure/table/wood,
/obj/effect/turf_decal/siding/wood{
	dir = 10
	},
/obj/item/instrument/guitar,
/turf/open/floor/wood,
/area/misc/hilbertshotel)
"Ij" = (
/obj/structure/mineral_door/paperframe,
/turf/open/floor/iron/white/small,
/area/misc/hilbertshotel)
"IC" = (
/obj/structure/bookcase/random/reference,
/turf/closed/indestructible/wood,
/area/misc/hilbertshotel)
"IF" = (
/obj/effect/turf_decal/siding/wood{
	dir = 4
	},
/obj/machinery/light_switch/directional/east,
/turf/open/floor/wood,
/area/misc/hilbertshotel)
"IR" = (
/obj/structure/fans/tiny/invisible,
/obj/effect/turf_decal/siding/wood,
/obj/effect/turf_decal/siding/wood{
	dir = 1
	},
/obj/structure/mineral_door/wood,
/turf/open/floor/wood,
/area/misc/hilbertshotel)
"Jq" = (
/obj/effect/turf_decal/siding/wood{
	dir = 6
	},
/obj/structure/closet/cabinet,
/obj/item/clothing/shoes/winterboots{
	pixel_x = 2;
	pixel_y = -2
	},
/obj/item/clothing/shoes/winterboots{
	pixel_x = 2;
	pixel_y = -2
	},
/obj/item/clothing/suit/hooded/wintercoat,
/obj/item/clothing/suit/hooded/wintercoat,
/turf/open/floor/wood,
/area/misc/hilbertshotel)
"JD" = (
/obj/effect/turf_decal/siding/wood{
	dir = 8
	},
/obj/effect/turf_decal/siding/wood/corner{
	dir = 4
	},
/turf/open/floor/wood,
/area/misc/hilbertshotel)
"JS" = (
/obj/effect/turf_decal/siding/wood{
	dir = 6
	},
/turf/open/floor/carpet/royalblack,
/area/misc/hilbertshotel)
"Km" = (
/turf/open/floor/fake_snow/safe,
/area/misc/hilbertshotel)
"KF" = (
/obj/structure/table/reinforced,
/turf/open/floor/iron/kitchen,
/area/misc/hilbertshotel)
"Lf" = (
/obj/effect/turf_decal/siding/wood{
	dir = 8
	},
/obj/effect/turf_decal/siding/wood{
	dir = 4
	},
/obj/structure/mineral_door/wood,
/turf/open/floor/wood,
/area/misc/hilbertshotel)
"Lm" = (
/obj/structure/flora/grass/brown,
/obj/machinery/light/small{
	brightness = 3;
	dir = 8
	},
/obj/machinery/light/small,
/turf/open/floor/fake_snow/safe,
/area/misc/hilbertshotel)
"Lo" = (
/obj/effect/turf_decal/siding/wood,
/turf/open/floor/carpet/royalblue,
/area/misc/hilbertshotel)
"LS" = (
/obj/effect/turf_decal/siding/wood/corner{
	dir = 4
	},
/obj/effect/turf_decal/siding/wood/corner,
/turf/open/floor/carpet,
/area/misc/hilbertshotel)
"Mq" = (
/obj/structure/table/wood,
/obj/effect/turf_decal/siding/wood{
	dir = 6
	},
/obj/structure/towel_bin,
/turf/open/floor/wood,
/area/misc/hilbertshotel)
"Mr" = (
/obj/machinery/vending/boozeomat,
/turf/closed/indestructible/wood,
/area/misc/hilbertshotel)
"NQ" = (
/obj/effect/turf_decal/siding/wood{
	dir = 10
	},
/obj/structure/chair/sofa/corner/brown{
	dir = 1
	},
/turf/open/floor/carpet/royalblack,
/area/misc/hilbertshotel)
"NV" = (
/obj/structure/table/reinforced,
/obj/effect/spawner/random/food_or_drink/three_course_meal,
/turf/open/floor/iron/kitchen,
/area/misc/hilbertshotel)
"OB" = (
/obj/machinery/telecomms/relay/preset/auto,
/turf/open/floor/catwalk_floor,
/area/misc/hilbertshotel)
"OZ" = (
/obj/machinery/light/small{
	dir = 1
	},
/turf/open/floor/fake_snow/safe,
/area/misc/hilbertshotel)
"Ps" = (
/obj/effect/turf_decal/siding/wood{
	dir = 1
	},
/turf/open/floor/carpet/royalblue,
/area/misc/hilbertshotel)
"PY" = (
/obj/structure/sauna_oven,
/obj/effect/turf_decal/siding/wood{
	dir = 10
	},
/turf/open/floor/wood,
/area/misc/hilbertshotel)
"Qb" = (
/turf/open/misc/asteroid/snow,
/area/misc/hilbertshotel)
"QI" = (
/obj/effect/turf_decal/siding/wood{
	dir = 5
	},
/obj/structure/table/wood,
/obj/item/shovel,
/obj/machinery/light/floor{
	light_color = "#f27d0c";
	color = "FFB43A"
	},
/obj/item/wrench{
	pixel_x = 6
	},
/obj/item/flashlight/lantern{
	icon_state = "lantern-on";
	pixel_x = -8;
	pixel_y = 13
	},
/turf/open/floor/wood,
/area/misc/hilbertshotel)
"Rj" = (
/obj/effect/turf_decal/siding/wood/corner{
	dir = 1
	},
/obj/effect/turf_decal/siding/wood/corner{
	dir = 8
	},
/turf/open/floor/wood,
/area/misc/hilbertshotel)
"RA" = (
/obj/effect/turf_decal/siding/wood{
	dir = 9
	},
/obj/machinery/vending/dorms,
/turf/open/floor/wood,
/area/misc/hilbertshotel)
"RE" = (
/obj/effect/turf_decal/siding/wood/corner{
	dir = 8
	},
/obj/effect/turf_decal/siding/wood/corner{
	dir = 1
	},
/turf/open/floor/wood,
/area/misc/hilbertshotel)
"Sa" = (
/obj/effect/turf_decal/siding/wood{
	dir = 8
	},
/obj/structure/chair/sofa/middle/brown{
	dir = 4
	},
/turf/open/floor/carpet/royalblack,
/area/misc/hilbertshotel)
"Sc" = (
/obj/structure/reagent_dispensers/watertank,
/obj/effect/turf_decal/siding/wood{
	dir = 9
	},
/turf/open/floor/wood,
/area/misc/hilbertshotel)
"Sn" = (
/obj/effect/turf_decal/siding/wood{
	dir = 9
	},
/obj/structure/table/wood,
/obj/structure/reagent_dispensers/beerkeg,
/turf/open/floor/carpet,
/area/misc/hilbertshotel)
"SO" = (
/obj/effect/turf_decal/siding/wood{
	dir = 4
	},
/turf/open/floor/carpet/royalblack,
/area/misc/hilbertshotel)
"Ta" = (
/obj/structure/closet/crate/wooden,
/obj/item/stack/sheet/mineral/wood/fifty,
/obj/effect/turf_decal/siding/wood{
	dir = 4
	},
/obj/item/reagent_containers/cup/bucket,
/turf/open/floor/wood,
/area/misc/hilbertshotel)
"Tl" = (
/obj/structure/flora/tree/pine,
/turf/open/floor/fake_snow/safe,
/area/misc/hilbertshotel)
"TO" = (
/obj/effect/turf_decal/siding/wood{
	dir = 6
	},
/obj/structure/closet/crate/wooden,
/obj/item/stack/sheet/mineral/wood/fifty,
/turf/open/floor/wood,
/area/misc/hilbertshotel)
"Um" = (
/obj/structure/chair/pew/right,
/obj/effect/turf_decal/siding/wood{
	dir = 1
	},
/turf/open/floor/wood,
/area/misc/hilbertshotel)
"UH" = (
/obj/effect/turf_decal/siding/wood{
	dir = 8
	},
/obj/effect/turf_decal/siding/wood/corner,
/turf/open/floor/wood,
/area/misc/hilbertshotel)
"VS" = (
/obj/structure/flora/tree/pine,
/turf/closed/indestructible/rock/snow,
/area/misc/hilbertshotel)
"Wa" = (
/obj/structure/flora/grass/green,
/obj/machinery/light/small{
	dir = 1
	},
/turf/open/floor/fake_snow/safe,
/area/misc/hilbertshotel)
"Yq" = (
/obj/effect/turf_decal/siding/wood,
/obj/machinery/light,
/turf/open/floor/wood,
/area/misc/hilbertshotel)
"YG" = (
/obj/structure/table/reinforced,
/obj/machinery/microwave{
	pixel_y = 6
	},
/turf/open/floor/iron/kitchen,
/area/misc/hilbertshotel)

(1,1,1) = {"
yH
yH
yH
yH
yH
yH
yH
yH
yH
yH
yH
yH
yH
yH
yH
yH
yH
yH
"}
(2,1,1) = {"
yH
sv
sv
sv
sv
sv
sv
sv
sv
sp
sv
sv
sv
sv
sv
sv
sv
yH
"}
(3,1,1) = {"
yH
sv
Ab
ve
sv
nY
CF
sv
Sn
Aq
nE
sv
Sc
wC
mS
PY
sv
yH
"}
(4,1,1) = {"
yH
sv
Ps
jI
Ij
GA
gK
sv
HK
LS
sF
sv
iy
if
if
uU
sv
yH
"}
(5,1,1) = {"
yH
sv
Cx
Lo
sv
sv
sv
sv
sv
zh
sv
sv
ex
if
if
Yq
sv
yH
"}
(6,1,1) = {"
yH
sv
cq
Hj
Lf
JD
UH
Lf
JD
RE
pv
sv
Um
if
if
uU
sv
yH
"}
(7,1,1) = {"
yH
sv
Dx
oQ
sv
GE
uU
sv
QI
by
Jq
sv
zE
Ta
rz
El
sv
yH
"}
(8,1,1) = {"
yH
sv
sv
sv
sv
FL
uU
sv
sv
kk
sv
sv
sv
sv
IR
sv
sv
yH
"}
(9,1,1) = {"
yH
nP
nq
cC
YG
lZ
uU
sv
ti
rf
Lm
sv
RA
ET
Rj
Ic
sv
yH
"}
(10,1,1) = {"
yH
Mr
lu
lu
KF
lZ
Yq
sv
OZ
rf
rf
zp
zT
IF
ni
Mq
sv
yH
"}
(11,1,1) = {"
yH
mM
lu
hm
NV
lZ
uU
tS
kw
rf
dU
sv
sv
sv
sv
sv
sv
yH
"}
(12,1,1) = {"
yH
lD
jL
jb
jb
eB
uU
ol
bV
rf
Km
it
sA
Km
yC
Km
VS
yH
"}
(13,1,1) = {"
yH
hO
lZ
BZ
Sa
NQ
uU
ol
pD
rf
rf
rf
rf
rf
Km
Km
qe
yH
"}
(14,1,1) = {"
yH
IC
lZ
cc
FV
oI
Yq
sv
Wa
Km
sA
yC
Ad
sA
Km
Km
VS
yH
"}
(15,1,1) = {"
yH
et
lZ
oy
SO
JS
uU
sv
Km
Tl
Km
EJ
dq
qA
it
Qb
aM
yH
"}
(16,1,1) = {"
yH
sv
rZ
cd
ux
sS
TO
sv
Km
ir
yC
it
qR
Km
Km
VS
qe
yH
"}
(17,1,1) = {"
yH
sv
sv
sv
sv
sv
sv
sv
qe
VS
qe
aM
qe
qe
VS
qe
OB
yH
"}
(18,1,1) = {"
yH
yH
yH
yH
yH
yH
yH
yH
yH
yH
yH
yH
yH
yH
yH
yH
yH
yH
"}
