//MAP CONVERTED BY dmm2tgm.py THIS HEADER COMMENT PREVENTS RECONVERSION, DO NOT REMOVE
"aa" = (
/turf/open/space/bluespace,
/area/misc/hilbertshotel)
"ab" = (
/obj/machinery/telecomms/relay/preset/auto,
/turf/open/floor/catwalk_floor,
/area/misc/hilbertshotel)
"ag" = (
/obj/effect/turf_decal/siding/wood{
	dir = 8
	},
/obj/machinery/light/directional/west,
/turf/open/floor/wood/tile,
/area/misc/hilbertshotel)
"aj" = (
/turf/open/floor/catwalk_floor,
/area/misc/hilbertshotel)
"am" = (
/obj/machinery/vending/dorms,
/turf/open/indestructible/hotelwood,
/area/misc/hilbertshotel)
"an" = (
/obj/machinery/door/morgue,
/turf/open/indestructible/hotelwood,
/area/misc/hilbertshotel)
"aq" = (
/obj/structure/dresser,
/turf/open/floor/carpet,
/area/misc/hilbertshotel)
"ar" = (
/obj/structure/closet/cabinet{
	anchored = 1
	},
/obj/machinery/light/small/directional/north,
/turf/open/floor/carpet,
/area/misc/hilbertshotel)
"at" = (
/turf/closed/indestructible/hoteldoor{
	icon_state = "door_closed";
	icon = 'icons/obj/doors/puzzledoor/default.dmi'
	},
/area/misc/hilbertshotel)
"ax" = (
/turf/open/floor/carpet,
/area/misc/hilbertshotel)
"az" = (
/obj/effect/turf_decal/siding/thinplating/dark/corner{
	dir = 4
	},
/turf/open/floor/mineral/plastitanium,
/area/misc/hilbertshotel)
"aB" = (
/obj/machinery/door/window/left/directional/east,
/obj/machinery/light/small/directional/west,
/turf/open/indestructible/hoteltile,
/area/misc/hilbertshotel)
"aC" = (
/obj/structure/toilet{
	dir = 8
	},
/obj/structure/window/reinforced/tinted/spawner/directional/south,
/turf/open/indestructible/hoteltile,
/area/misc/hilbertshotel)
"aD" = (
/obj/effect/turf_decal/siding/wood,
/obj/structure/closet/crate/bin,
/turf/open/floor/wood/tile,
/area/misc/hilbertshotel)
"aF" = (
/obj/structure/bed/double,
/obj/effect/spawner/random/bedsheet/double,
/turf/open/floor/carpet,
/area/misc/hilbertshotel)
"aI" = (
/obj/structure/mirror{
	pixel_x = -32
	},
/obj/structure/sink/kitchen/directional/east,
/turf/open/indestructible/hoteltile,
/area/misc/hilbertshotel)
"aJ" = (
/turf/open/indestructible/hoteltile,
/area/misc/hilbertshotel)
"aK" = (
/obj/structure/mineral_door/paperframe,
/turf/open/indestructible/hoteltile,
/area/misc/hilbertshotel)
"aL" = (
/obj/effect/turf_decal/siding/wood{
	dir = 1
	},
/obj/structure/window/reinforced/tinted/spawner/directional/north,
/turf/open/indestructible/hotelwood,
/area/misc/hilbertshotel)
"aO" = (
/obj/effect/turf_decal/siding/wood/corner{
	dir = 8
	},
/turf/open/indestructible/hotelwood,
/area/misc/hilbertshotel)
"aP" = (
/obj/effect/turf_decal/siding/wood/corner,
/turf/open/indestructible/hotelwood,
/area/misc/hilbertshotel)
"aQ" = (
/obj/structure/table/wood/fancy,
/obj/item/toy/plush/beeplushie,
/obj/machinery/light/small/directional/south,
/turf/open/indestructible/hotelwood,
/area/misc/hilbertshotel)
"aT" = (
/obj/structure/fake_stairs/directional/north,
/obj/structure/curtain/bounty,
/turf/open/space/basic,
/area/misc/hilbertshotel)
"aU" = (
/obj/structure/fake_stairs/directional/north,
/turf/open/floor/mineral/plastitanium/red,
/area/misc/hilbertshotel)
"aV" = (
/turf/open/floor/mineral/plastitanium/red,
/area/misc/hilbertshotel)
"aW" = (
/obj/machinery/door/window/right/directional/east,
/obj/machinery/light/small/directional/west,
/turf/open/indestructible/hoteltile,
/area/misc/hilbertshotel)
"aX" = (
/obj/effect/turf_decal/siding/wood/corner{
	dir = 4
	},
/turf/open/floor/wood/tile,
/area/misc/hilbertshotel)
"aZ" = (
/obj/effect/turf_decal/siding/thinplating/dark,
/turf/open/floor/mineral/plastitanium,
/area/misc/hilbertshotel)
"bc" = (
/obj/structure/fake_stairs/directional/west,
/turf/open/space/basic,
/area/misc/hilbertshotel)
"bg" = (
/obj/structure/chair/sofa/middle/maroon,
/turf/open/floor/carpet,
/area/misc/hilbertshotel)
"bh" = (
/obj/structure/chair/sofa/left/maroon,
/turf/open/floor/carpet,
/area/misc/hilbertshotel)
"bk" = (
/obj/structure/chair/sofa/left/maroon{
	dir = 4
	},
/turf/open/floor/carpet,
/area/misc/hilbertshotel)
"bl" = (
/obj/structure/table/wood,
/obj/item/storage/fancy/heart_box,
/turf/open/floor/carpet,
/area/misc/hilbertshotel)
"bn" = (
/obj/structure/chair/sofa/right/maroon{
	dir = 8
	},
/obj/structure/railing{
	dir = 4;
	icon_state = "railing"
	},
/turf/open/floor/carpet,
/area/misc/hilbertshotel)
"bp" = (
/obj/structure/table/reinforced,
/obj/machinery/microwave,
/turf/open/floor/iron/cafeteria,
/area/misc/hilbertshotel)
"bq" = (
/obj/machinery/vending/boozeomat{
	shut_up = 1
	},
/turf/open/floor/iron/cafeteria,
/area/misc/hilbertshotel)
"bs" = (
/obj/machinery/smartfridge/food,
/turf/open/floor/iron/cafeteria,
/area/misc/hilbertshotel)
"bu" = (
/obj/structure/chair/sofa/right/maroon{
	dir = 4
	},
/turf/open/floor/carpet,
/area/misc/hilbertshotel)
"bv" = (
/obj/structure/chair/sofa/left/maroon{
	dir = 8
	},
/obj/structure/railing{
	dir = 4;
	icon_state = "railing"
	},
/turf/open/floor/carpet,
/area/misc/hilbertshotel)
"bw" = (
/obj/structure/table/reinforced,
/obj/structure/sink/kitchen/directional/east,
/turf/open/floor/iron/cafeteria,
/area/misc/hilbertshotel)
"bx" = (
/turf/open/floor/iron/cafeteria,
/area/misc/hilbertshotel)
"by" = (
/obj/structure/table/reinforced,
/obj/item/reagent_containers/cup/glass{
	pixel_y = 4;
	pixel_x = -4
	},
/obj/item/reagent_containers/cup/glass{
	pixel_y = 5;
	pixel_x = 6
	},
/obj/item/reagent_containers/cup/glass,
/turf/open/floor/iron/cafeteria,
/area/misc/hilbertshotel)
"bz" = (
/obj/structure/closet/secure_closet/freezer/fridge/all_access,
/turf/open/floor/iron/cafeteria,
/area/misc/hilbertshotel)
"bA" = (
/obj/machinery/jukebox{
	req_one_access = null;
	area_limited = 1
	},
/obj/effect/turf_decal/siding/wood,
/turf/open/floor/wood/tile,
/area/misc/hilbertshotel)
"bC" = (
/obj/item/kirbyplants/random,
/obj/effect/turf_decal/siding/wood{
	dir = 6
	},
/obj/structure/railing{
	dir = 1
	},
/turf/open/floor/wood/tile,
/area/misc/hilbertshotel)
"cA" = (
/obj/effect/turf_decal/siding/wood{
	dir = 4
	},
/obj/structure/flora/bush/jungle/c/style_random,
/turf/open/floor/grass,
/area/misc/hilbertshotel)
"dh" = (
/obj/structure/table/wood,
/obj/structure/showcase/machinery/tv,
/turf/open/floor/carpet,
/area/misc/hilbertshotel)
"dC" = (
/obj/machinery/vending/games{
	shut_up = 1
	},
/obj/effect/turf_decal/siding/wood,
/turf/open/floor/wood/tile,
/area/misc/hilbertshotel)
"dT" = (
/obj/effect/turf_decal/siding/wood{
	dir = 10
	},
/turf/open/floor/wood/tile,
/area/misc/hilbertshotel)
"dU" = (
/obj/effect/turf_decal/siding/wood{
	dir = 4
	},
/obj/structure/flora/bush/jungle/a/style_random,
/obj/machinery/light/directional/east,
/obj/structure/flora/bush/large/style_random,
/turf/open/floor/grass,
/area/misc/hilbertshotel)
"gc" = (
/obj/effect/turf_decal/siding/wood{
	dir = 4
	},
/obj/structure/flora/bush/jungle/c/style_random,
/obj/structure/flora/bush/jungle/b/style_random,
/turf/open/floor/grass,
/area/misc/hilbertshotel)
"kt" = (
/obj/structure/table/wood,
/obj/item/storage/fancy/candle_box{
	pixel_x = 4
	},
/obj/item/storage/fancy/candle_box{
	pixel_x = -8
	},
/turf/open/floor/carpet,
/area/misc/hilbertshotel)
"kR" = (
/obj/machinery/door/window/survival_pod/left/directional/east,
/turf/open/floor/iron/cafeteria,
/area/misc/hilbertshotel)
"kT" = (
/obj/effect/turf_decal/siding/wood{
	dir = 4
	},
/obj/effect/turf_decal/siding/wood{
	dir = 8
	},
/turf/open/indestructible/hotelwood,
/area/misc/hilbertshotel)
"lm" = (
/obj/machinery/light/small,
/obj/item/kirbyplants/random,
/obj/effect/turf_decal/siding/wood{
	dir = 10
	},
/turf/open/indestructible/hotelwood,
/area/misc/hilbertshotel)
"mf" = (
/obj/effect/turf_decal/siding/thinplating/dark{
	dir = 5
	},
/obj/machinery/room_controller/directional/north,
/obj/structure/sign/poster/contraband/random/directional/east,
/turf/open/floor/mineral/plastitanium,
/area/misc/hilbertshotel)
"nA" = (
/obj/structure/table/wood,
/turf/open/floor/carpet,
/area/misc/hilbertshotel)
"nE" = (
/obj/effect/turf_decal/siding/wood/corner{
	dir = 4
	},
/obj/effect/turf_decal/siding/wood/corner{
	dir = 1
	},
/obj/effect/turf_decal/siding/wood/corner{
	dir = 8
	},
/turf/open/indestructible/hotelwood,
/area/misc/hilbertshotel)
"oY" = (
/obj/effect/turf_decal/siding/thinplating/dark{
	dir = 9
	},
/turf/open/floor/mineral/plastitanium,
/area/misc/hilbertshotel)
"qh" = (
/obj/effect/turf_decal/siding/wood{
	dir = 4
	},
/obj/structure/flora/bush/jungle/a/style_random,
/obj/structure/flora/bush/jungle/b/style_random,
/obj/structure/flora/bush/large/style_random,
/turf/open/floor/grass,
/area/misc/hilbertshotel)
"wX" = (
/obj/structure/table/wood,
/obj/item/toy/cards/deck,
/obj/item/reagent_containers/cup/glass/bottle/champagne{
	pixel_y = 9;
	pixel_x = 10
	},
/turf/open/floor/carpet,
/area/misc/hilbertshotel)
"xS" = (
/obj/item/soap/deluxe,
/obj/machinery/shower/directional/west,
/obj/structure/window/reinforced/tinted/spawner/directional/north,
/turf/open/indestructible/hoteltile,
/area/misc/hilbertshotel)
"yI" = (
/obj/structure/table/reinforced,
/obj/effect/spawner/random/food_or_drink/three_course_meal,
/obj/machinery/light/directional/north,
/turf/open/floor/iron/cafeteria,
/area/misc/hilbertshotel)
"GL" = (
/obj/effect/turf_decal/siding/thinplating/dark{
	dir = 8
	},
/obj/machinery/airalarm/directional/west,
/turf/open/floor/mineral/plastitanium,
/area/misc/hilbertshotel)
"GN" = (
/obj/structure/chair/stool/bar,
/obj/effect/turf_decal/siding/wood{
	dir = 8
	},
/turf/open/floor/wood/tile,
/area/misc/hilbertshotel)
"IH" = (
/obj/structure/railing{
	dir = 4;
	icon_state = "railing"
	},
/turf/open/floor/carpet,
/area/misc/hilbertshotel)
"Ka" = (
/obj/effect/turf_decal/siding/wood{
	dir = 1
	},
/turf/open/floor/wood/tile,
/area/misc/hilbertshotel)
"KK" = (
/obj/machinery/light{
	dir = 8
	},
/obj/machinery/light_switch{
	pixel_x = -32
	},
/obj/structure/fake_stairs/directional/north,
/turf/open/floor/mineral/plastitanium,
/area/misc/hilbertshotel)
"KM" = (
/obj/effect/turf_decal/siding/thinplating/dark{
	dir = 4
	},
/turf/open/floor/mineral/plastitanium,
/area/misc/hilbertshotel)
"Lo" = (
/obj/effect/turf_decal/siding/wood{
	dir = 5
	},
/obj/structure/window/reinforced/tinted/spawner/directional/north,
/turf/open/indestructible/hotelwood,
/area/misc/hilbertshotel)
"LU" = (
/obj/structure/table/reinforced,
/obj/effect/turf_decal/siding/wood,
/obj/item/flashlight/flare/candle/jasmine,
/turf/open/floor/wood/tile,
/area/misc/hilbertshotel)
"Nv" = (
/obj/machinery/light/small/directional/north,
/obj/effect/turf_decal/siding/wood/end{
	dir = 1
	},
/turf/open/indestructible/hotelwood,
/area/misc/hilbertshotel)
"Oi" = (
/obj/machinery/light_switch/directional/east,
/turf/open/floor/carpet,
/area/misc/hilbertshotel)
"PJ" = (
/obj/effect/turf_decal/siding/thinplating/dark{
	dir = 4
	},
/obj/structure/sign/poster/contraband/random/directional/east,
/turf/open/floor/mineral/plastitanium,
/area/misc/hilbertshotel)
"Rh" = (
/obj/structure/table/wood,
/obj/item/pizzabox/margherita{
	pixel_y = 11
	},
/turf/open/floor/carpet,
/area/misc/hilbertshotel)
"SM" = (
/obj/effect/turf_decal/siding/wood{
	dir = 1
	},
/obj/structure/sign/poster/contraband/random/directional/north,
/turf/open/floor/wood/tile,
/area/misc/hilbertshotel)
"TK" = (
/obj/structure/fake_stairs/directional/north,
/obj/machinery/light/directional/east,
/turf/open/floor/mineral/plastitanium,
/area/misc/hilbertshotel)
"Vu" = (
/obj/effect/turf_decal/siding/thinplating/dark{
	dir = 8
	},
/turf/open/floor/mineral/plastitanium,
/area/misc/hilbertshotel)
"Xr" = (
/obj/effect/turf_decal/siding/thinplating/dark{
	dir = 8
	},
/obj/structure/sign/poster/contraband/random/directional/west,
/turf/open/floor/mineral/plastitanium,
/area/misc/hilbertshotel)
"XP" = (
/turf/closed/indestructible/steel,
/area/misc/hilbertshotel)
"XQ" = (
/obj/item/kirbyplants/random,
/obj/effect/turf_decal/siding/wood{
	dir = 5
	},
/obj/structure/railing,
/turf/open/floor/wood/tile,
/area/misc/hilbertshotel)
"Yf" = (
/obj/machinery/light_switch{
	pixel_x = -32
	},
/obj/effect/turf_decal/siding/wood{
	dir = 4
	},
/obj/effect/turf_decal/siding/wood{
	dir = 8
	},
/turf/open/indestructible/hotelwood,
/area/misc/hilbertshotel)
"Yw" = (
/obj/structure/chair/sofa/right/maroon,
/obj/item/choice_beacon/box/plushie,
/turf/open/floor/carpet,
/area/misc/hilbertshotel)
"YE" = (
/obj/effect/turf_decal/siding/wood/corner{
	dir = 1
	},
/turf/open/floor/wood/tile,
/area/misc/hilbertshotel)
"YK" = (
/obj/effect/turf_decal/siding/wood/corner{
	dir = 8
	},
/turf/open/floor/wood/tile,
/area/misc/hilbertshotel)
"Zq" = (
/obj/item/kirbyplants/random,
/obj/effect/turf_decal/siding/thinplating/dark{
	dir = 10
	},
/turf/open/floor/mineral/plastitanium,
/area/misc/hilbertshotel)
"ZC" = (
/turf/closed/wall,
/area/misc/hilbertshotel)

(1,1,1) = {"
aa
aa
aa
aa
aa
aa
aa
aa
aa
aa
aa
aa
aa
aa
aa
aa
"}
(2,1,1) = {"
aa
ab
aj
XP
XP
XP
XP
XP
XP
XP
XP
XP
XP
XP
XP
aa
"}
(3,1,1) = {"
aa
aj
aj
XP
oY
Xr
Vu
KK
GL
Zq
ZC
bp
bw
bz
XP
aa
"}
(4,1,1) = {"
aa
aj
aj
at
aV
aV
aV
aU
aV
aZ
ZC
yI
bx
bx
XP
aa
"}
(5,1,1) = {"
aa
aj
aj
XP
mf
KM
PJ
TK
az
aZ
ZC
bq
bx
bx
XP
aa
"}
(6,1,1) = {"
aa
aj
aj
XP
ZC
ZC
ZC
ZC
bc
bc
ZC
bs
by
kR
XP
aa
"}
(7,1,1) = {"
aa
XP
XP
XP
aB
aI
aW
ZC
Ka
YK
ag
GN
GN
dT
XP
aa
"}
(8,1,1) = {"
aa
XP
am
ZC
aC
aJ
xS
ZC
Ka
ax
bk
bu
ax
aD
XP
aa
"}
(9,1,1) = {"
aa
XP
an
ZC
ZC
aK
ZC
ZC
SM
Yw
wX
bl
ax
LU
XP
aa
"}
(10,1,1) = {"
aa
XP
Nv
Yf
kT
nE
lm
ZC
Ka
bg
Rh
dh
ax
bA
XP
aa
"}
(11,1,1) = {"
aa
XP
ax
ax
ax
aL
aO
aT
YE
bh
kt
nA
ax
LU
XP
aa
"}
(12,1,1) = {"
aa
XP
aq
ax
ax
aL
aP
aT
aX
IH
bn
bv
IH
dC
XP
aa
"}
(13,1,1) = {"
aa
XP
ar
Oi
aF
Lo
aQ
ZC
XQ
gc
dU
cA
qh
bC
XP
aa
"}
(14,1,1) = {"
aa
XP
XP
XP
XP
XP
XP
XP
XP
XP
XP
XP
XP
XP
XP
aa
"}
(15,1,1) = {"
aa
aa
aa
aa
aa
aa
aa
aa
aa
aa
aa
aa
aa
aa
aa
aa
"}
(16,1,1) = {"
aa
aa
aa
aa
aa
aa
aa
aa
aa
aa
aa
aa
aa
aa
aa
aa
"}
