//MAP CONVERTED BY dmm2tgm.py THIS HEADER COMMENT PREVENTS RECONVERSION, DO NOT REMOVE
"az" = (
/obj/effect/decal/cleanable/blood/tracks{
	dir = 8
	},
/turf/open/floor/iron,
/area/misc/hilbertshotel)
"aK" = (
/turf/open/floor/stone,
/area/misc/hilbertshotel)
"be" = (
/obj/machinery/telecomms/relay/preset/auto,
/turf/open/floor/catwalk_floor,
/area/misc/hilbertshotel)
"bz" = (
/obj/structure/fence/corner{
	dir = 9
	},
/obj/effect/decal/cleanable/dirt,
/turf/open/floor/stone,
/area/misc/hilbertshotel)
"cn" = (
/obj/effect/turf_decal/siding/wood{
	dir = 4
	},
/turf/open/floor/wood/large,
/area/misc/hilbertshotel)
"cy" = (
/obj/item/stack/sheet/mineral/wood/fifty,
/obj/structure/closet/crate/wooden,
/turf/open/floor/iron/white/small,
/area/misc/hilbertshotel)
"cP" = (
/obj/structure/toilet{
	dir = 2;
	pixel_x = 7;
	pixel_y = 1
	},
/obj/structure/sink{
	pixel_x = -4;
	pixel_y = 11
	},
/obj/structure/mirror/directional/north{
	pixel_x = -4;
	pixel_y = 31
	},
/turf/open/floor/iron/white/small,
/area/misc/hilbertshotel)
"dr" = (
/obj/effect/turf_decal/siding/wood,
/turf/open/floor/wood,
/area/misc/hilbertshotel)
"dZ" = (
/obj/structure/chair/sofa/bench/right{
	dir = 1
	},
/turf/open/floor/carpet/stellar,
/area/misc/hilbertshotel)
"ee" = (
/obj/structure/table/reinforced,
/obj/item/knife/butcher,
/turf/open/floor/iron/kitchen/small,
/area/misc/hilbertshotel)
"eI" = (
/obj/structure/chair/sofa/corp/right{
	dir = 1
	},
/obj/structure/railing/corner,
/obj/effect/turf_decal/siding/wood,
/obj/machinery/light/directional/south,
/turf/open/floor/wood/large,
/area/misc/hilbertshotel)
"fF" = (
/obj/effect/decal/cleanable/dirt,
/obj/structure/fluff/paper/stack{
	dir = 5
	},
/turf/open/floor/stone,
/area/misc/hilbertshotel)
"fK" = (
/obj/structure/table/reinforced,
/obj/item/reagent_containers/cup/bottle/hexacrocin{
	pixel_x = 5;
	pixel_y = 10
	},
/obj/item/reagent_containers/hypospray/medipen/crocin/plus,
/turf/open/floor/iron,
/area/misc/hilbertshotel)
"fU" = (
/obj/structure/table/reinforced,
/obj/item/kitchen/spoon/soup_ladle{
	pixel_x = 2;
	pixel_y = 11
	},
/turf/open/floor/iron/kitchen/small,
/area/misc/hilbertshotel)
"gd" = (
/turf/open/floor/wood,
/area/misc/hilbertshotel)
"gx" = (
/obj/effect/turf_decal/siding/wood/corner{
	dir = 1
	},
/turf/open/floor/iron/dark/corner{
	dir = 4
	},
/area/misc/hilbertshotel)
"gE" = (
/obj/machinery/griddle,
/obj/machinery/light/directional/south,
/turf/open/floor/iron/kitchen/small,
/area/misc/hilbertshotel)
"gG" = (
/obj/structure/table/reinforced,
/obj/machinery/microwave{
	pixel_y = 11
	},
/turf/open/floor/iron/kitchen/small,
/area/misc/hilbertshotel)
"gS" = (
/obj/structure/table/wood,
/obj/item/choice_beacon/box/plushie{
	pixel_y = 5
	},
/obj/structure/sign/poster/contraband/lusty_xenomorph/directional/north,
/turf/open/floor/carpet/royalblack,
/area/misc/hilbertshotel)
"hB" = (
/obj/item/kirbyplants/random{
	pixel_y = 10
	},
/turf/open/floor/carpet/red,
/area/misc/hilbertshotel)
"hX" = (
/obj/structure/chair/pew/right{
	dir = 8
	},
/obj/effect/turf_decal/siding/wood{
	dir = 6
	},
/obj/machinery/light/small/directional/east,
/turf/open/floor/wood,
/area/misc/hilbertshotel)
"ib" = (
/obj/effect/decal/cleanable/dirt,
/obj/structure/broken_flooring/pile/directional/south,
/obj/structure/sign/poster/ripped/directional/east,
/turf/open/floor/stone,
/area/misc/hilbertshotel)
"jv" = (
/obj/structure/trash_pile,
/turf/open/floor/stone,
/area/misc/hilbertshotel)
"km" = (
/obj/structure/falsewall,
/obj/effect/decal/cleanable/blood/splatter,
/turf/open/floor/iron,
/area/misc/hilbertshotel)
"lb" = (
/obj/item/newspaper{
	pixel_x = -6;
	pixel_y = 8
	},
/obj/structure/table/wood/fancy/blue,
/turf/open/floor/carpet/royalblue,
/area/misc/hilbertshotel)
"lG" = (
/obj/structure/chair/sofa/corp{
	dir = 1
	},
/obj/effect/turf_decal/siding/wood,
/obj/machinery/light/directional/south,
/turf/open/floor/wood/large,
/area/misc/hilbertshotel)
"lM" = (
/obj/effect/turf_decal/siding/wood{
	dir = 1
	},
/obj/structure/curtain/cloth/fancy,
/turf/open/floor/wood/large,
/area/misc/hilbertshotel)
"lO" = (
/obj/structure/fence/cut/large{
	dir = 4
	},
/obj/effect/decal/cleanable/dirt,
/turf/open/floor/stone,
/area/misc/hilbertshotel)
"mo" = (
/obj/effect/decal/cleanable/dirt,
/obj/structure/sign/poster/abductor/ayy_cops/directional/west,
/turf/open/floor/stone,
/area/misc/hilbertshotel)
"nk" = (
/obj/effect/turf_decal/siding/wood,
/obj/structure/curtain/cloth/fancy,
/turf/open/floor/wood/large,
/area/misc/hilbertshotel)
"nZ" = (
/obj/structure/table/wood,
/obj/item/toy/plush/lizard_plushie,
/turf/open/floor/wood/large,
/area/misc/hilbertshotel)
"ok" = (
/turf/closed/wall,
/area/misc/hilbertshotel)
"ot" = (
/turf/closed/indestructible/steel,
/area/misc/hilbertshotel)
"ox" = (
/turf/open/floor/carpet/red,
/area/misc/hilbertshotel)
"pv" = (
/obj/structure/chair/pew,
/obj/effect/turf_decal/siding/wood{
	dir = 1
	},
/obj/machinery/light/small/directional/north,
/turf/open/floor/wood,
/area/misc/hilbertshotel)
"pD" = (
/turf/open/floor/carpet/royalblue,
/area/misc/hilbertshotel)
"pG" = (
/turf/open/floor/carpet/green,
/area/misc/hilbertshotel)
"qd" = (
/turf/open/floor/carpet/royalblack,
/area/misc/hilbertshotel)
"qn" = (
/obj/effect/decal/cleanable/dirt,
/turf/open/floor/stone,
/area/misc/hilbertshotel)
"qq" = (
/obj/structure/table/wood,
/obj/item/flashlight/lamp/green{
	pixel_x = 5;
	pixel_y = 13
	},
/obj/item/paper_bin{
	pixel_x = -5;
	pixel_y = 3
	},
/obj/item/pen/red,
/turf/open/floor/wood/large,
/area/misc/hilbertshotel)
"qz" = (
/obj/structure/closet/crate/bin{
	pixel_y = 5
	},
/obj/item/toy/plush/lizard_plushie/space,
/turf/open/floor/iron,
/area/misc/hilbertshotel)
"qE" = (
/obj/effect/turf_decal/siding/wood{
	dir = 9
	},
/obj/structure/railing{
	dir = 1
	},
/obj/machinery/light_switch/directional/west,
/turf/open/floor/wood/large,
/area/misc/hilbertshotel)
"rB" = (
/obj/machinery/oven/range,
/turf/open/floor/iron/kitchen/small,
/area/misc/hilbertshotel)
"rT" = (
/obj/effect/decal/cleanable/dirt,
/obj/structure/trash_pile,
/turf/open/floor/stone,
/area/misc/hilbertshotel)
"sb" = (
/obj/effect/turf_decal/siding/wood{
	dir = 1
	},
/obj/machinery/light_switch/directional/north,
/turf/open/floor/wood/large,
/area/misc/hilbertshotel)
"sN" = (
/obj/structure/fake_stairs/wood/directional/north,
/obj/structure/railing{
	dir = 4
	},
/turf/open/floor/wood/large,
/area/misc/hilbertshotel)
"sZ" = (
/turf/open/space/bluespace,
/area/misc/hilbertshotel)
"tb" = (
/obj/structure/chair/pew/left{
	dir = 8
	},
/obj/effect/turf_decal/siding/wood{
	dir = 4
	},
/turf/open/floor/wood,
/area/misc/hilbertshotel)
"tr" = (
/obj/structure/sign/poster/abductor/ayy_no/directional/east,
/turf/open/floor/stone,
/area/misc/hilbertshotel)
"tW" = (
/obj/effect/decal/cleanable/vomit/old,
/turf/open/floor/stone,
/area/misc/hilbertshotel)
"uv" = (
/turf/open/floor/iron/white/small,
/area/misc/hilbertshotel)
"uw" = (
/obj/structure/curtain/cloth,
/obj/machinery/shower/directional/north,
/obj/item/soap/nanotrasen,
/turf/open/floor/iron/white/small,
/area/misc/hilbertshotel)
"uL" = (
/obj/structure/fireplace,
/obj/effect/turf_decal/siding/wood{
	dir = 1
	},
/turf/open/floor/iron/dark/side{
	dir = 1
	},
/area/misc/hilbertshotel)
"uN" = (
/obj/effect/decal/cleanable/dirt,
/obj/structure/fluff/paper/stack{
	dir = 1
	},
/obj/structure/sign/poster/ripped/directional/east,
/turf/open/floor/stone,
/area/misc/hilbertshotel)
"uQ" = (
/obj/structure/closet/crate/wooden,
/obj/item/stack/sheet/mineral/wood/fifty,
/obj/machinery/light/warm/directional/north,
/turf/open/floor/carpet/stellar,
/area/misc/hilbertshotel)
"uX" = (
/turf/open/floor/wood/large,
/area/misc/hilbertshotel)
"vt" = (
/obj/machinery/light/small/directional/south,
/turf/open/floor/iron/white/small,
/area/misc/hilbertshotel)
"vJ" = (
/turf/closed/indestructible/hoteldoor{
	icon_state = "door_closed";
	icon = 'icons/obj/doors/puzzledoor/default.dmi'
	},
/area/misc/hilbertshotel)
"vW" = (
/obj/effect/turf_decal/siding/wood{
	dir = 10
	},
/turf/open/floor/wood,
/area/misc/hilbertshotel)
"vZ" = (
/obj/structure/railing{
	dir = 8;
	icon_state = "railing"
	},
/obj/structure/fake_stairs/wood/directional/north,
/turf/open/floor/grass,
/area/misc/hilbertshotel)
"wn" = (
/obj/machinery/vending/dinnerware,
/turf/open/floor/iron/kitchen/small,
/area/misc/hilbertshotel)
"wr" = (
/obj/structure/barricade/wooden/crude,
/turf/closed/wall,
/area/misc/hilbertshotel)
"xh" = (
/obj/structure/railing/corner{
	dir = 1
	},
/obj/effect/turf_decal/siding/wood/corner{
	dir = 1
	},
/turf/open/floor/wood/large,
/area/misc/hilbertshotel)
"xA" = (
/obj/effect/decal/cleanable/blood/tracks{
	dir = 10
	},
/obj/effect/decal/cleanable/blood/tracks{
	dir = 8
	},
/turf/open/floor/iron,
/area/misc/hilbertshotel)
"xM" = (
/turf/open/floor/iron,
/area/misc/hilbertshotel)
"zb" = (
/obj/effect/decal/cleanable/dirt,
/obj/structure/broken_flooring/pile/always_floorplane/directional/west,
/turf/open/floor/stone,
/area/misc/hilbertshotel)
"zO" = (
/obj/structure/table/wood/fancy/blue,
/turf/open/floor/carpet/royalblue,
/area/misc/hilbertshotel)
"AO" = (
/obj/structure/sign/poster/contraband/babel_device/directional/east,
/turf/open/floor/iron/kitchen/small,
/area/misc/hilbertshotel)
"AX" = (
/obj/structure/chair/sofa/corp{
	dir = 1
	},
/obj/effect/turf_decal/siding/wood,
/turf/open/floor/wood/large,
/area/misc/hilbertshotel)
"BF" = (
/obj/item/kirbyplants/random{
	pixel_y = 10
	},
/turf/open/floor/wood/large,
/area/misc/hilbertshotel)
"BP" = (
/obj/effect/turf_decal/siding/wood{
	dir = 6
	},
/turf/open/floor/wood/large,
/area/misc/hilbertshotel)
"BT" = (
/obj/structure/chair/comfy/black{
	dir = 1
	},
/turf/open/floor/carpet/royalblack,
/area/misc/hilbertshotel)
"Cp" = (
/obj/structure/rack/shelf{
	pixel_x = 0;
	pixel_y = 0
	},
/obj/machinery/light_switch/directional/north,
/obj/item/clothing/shoes/sandal{
	pixel_x = 2;
	pixel_y = -4
	},
/obj/item/clothing/shoes/sandal{
	pixel_x = 0;
	pixel_y = 0
	},
/obj/item/clothing/shoes/sandal{
	pixel_x = -2;
	pixel_y = 5
	},
/turf/open/floor/iron,
/area/misc/hilbertshotel)
"CP" = (
/obj/structure/table/reinforced,
/obj/item/clothing/glasses/blindfold/kinky,
/obj/item/restraints/handcuffs/lewd{
	pixel_x = -13;
	pixel_y = 6
	},
/turf/open/floor/iron,
/area/misc/hilbertshotel)
"CQ" = (
/obj/effect/turf_decal/siding/wood,
/obj/structure/railing/corner{
	dir = 8
	},
/turf/open/floor/wood/large,
/area/misc/hilbertshotel)
"CX" = (
/obj/structure/mineral_door/wood,
/turf/open/floor/iron,
/area/misc/hilbertshotel)
"DV" = (
/obj/effect/turf_decal/siding/wood/corner{
	dir = 1
	},
/obj/effect/turf_decal/siding/wood/corner{
	dir = 8
	},
/turf/open/floor/wood/large,
/area/misc/hilbertshotel)
"DZ" = (
/obj/machinery/light/blacklight/directional/west,
/obj/structure/fluff/broken_canister_frame,
/turf/open/floor/stone,
/area/misc/hilbertshotel)
"Eg" = (
/obj/structure/fence/corner{
	dir = 6
	},
/turf/open/floor/stone,
/area/misc/hilbertshotel)
"Eh" = (
/obj/structure/flora/bush/jungle,
/obj/structure/flora/bush/large/style_3{
	pixel_y = -1
	},
/turf/open/floor/grass,
/area/misc/hilbertshotel)
"Ey" = (
/obj/effect/turf_decal/siding/wood{
	dir = 10
	},
/obj/structure/railing,
/turf/open/floor/wood/large,
/area/misc/hilbertshotel)
"EV" = (
/obj/structure/bed/double{
	dir = 1
	},
/obj/effect/spawner/random/bedsheet/double{
	dir = 4
	},
/turf/open/floor/wood/large,
/area/misc/hilbertshotel)
"Fa" = (
/obj/structure/railing/corner{
	dir = 8
	},
/obj/effect/turf_decal/siding/wood/corner{
	dir = 8
	},
/turf/open/floor/wood/large,
/area/misc/hilbertshotel)
"Fb" = (
/obj/effect/decal/cleanable/blood/trails{
	dir = 4
	},
/turf/open/floor/iron,
/area/misc/hilbertshotel)
"FK" = (
/obj/structure/chair/pew/right,
/obj/effect/turf_decal/siding/wood{
	dir = 1
	},
/turf/open/floor/wood,
/area/misc/hilbertshotel)
"Ga" = (
/obj/structure/fluff/paper/stack{
	dir = 1
	},
/turf/open/floor/stone,
/area/misc/hilbertshotel)
"Gs" = (
/obj/effect/turf_decal/siding/wood/corner{
	dir = 4
	},
/obj/effect/turf_decal/siding/wood/corner{
	dir = 1
	},
/turf/open/floor/wood/large,
/area/misc/hilbertshotel)
"GS" = (
/obj/structure/sauna_oven{
	pixel_y = 6
	},
/obj/item/reagent_containers/cup/bucket{
	pixel_x = 14;
	pixel_y = -5
	},
/turf/open/floor/iron/white/small,
/area/misc/hilbertshotel)
"Hq" = (
/obj/machinery/light/directional/north,
/turf/open/floor/carpet/royalblack,
/area/misc/hilbertshotel)
"HE" = (
/obj/structure/mineral_door/wood,
/turf/open/floor/iron/white/small,
/area/misc/hilbertshotel)
"HL" = (
/obj/effect/turf_decal/siding/wood{
	dir = 5
	},
/obj/item/kirbyplants/random{
	pixel_y = 10
	},
/turf/open/floor/wood/large,
/area/misc/hilbertshotel)
"HT" = (
/obj/structure/mineral_door/wood,
/obj/structure/fans/tiny/invisible,
/turf/open/floor/iron/white/small,
/area/misc/hilbertshotel)
"HZ" = (
/turf/open/floor/iron/kitchen/small,
/area/misc/hilbertshotel)
"Jc" = (
/obj/structure/table/reinforced,
/obj/item/clothing/under/costume/lewdmaid,
/obj/machinery/light/red/dim/directional/south,
/turf/open/floor/iron,
/area/misc/hilbertshotel)
"Jh" = (
/obj/structure/railing,
/obj/effect/turf_decal/siding/wood,
/turf/open/floor/wood/large,
/area/misc/hilbertshotel)
"Jv" = (
/obj/structure/fence{
	dir = 4
	},
/turf/open/floor/stone,
/area/misc/hilbertshotel)
"JH" = (
/obj/effect/turf_decal/siding/wood{
	dir = 10
	},
/obj/structure/sink/directional/east,
/turf/open/floor/wood,
/area/misc/hilbertshotel)
"Ka" = (
/obj/structure/barricade/wooden/crude,
/turf/closed/indestructible/steel,
/area/misc/hilbertshotel)
"Ke" = (
/obj/effect/turf_decal/siding/wood/corner{
	dir = 4
	},
/turf/open/floor/iron/dark/corner{
	dir = 1
	},
/area/misc/hilbertshotel)
"Mq" = (
/obj/structure/mineral_door/wood,
/turf/open/floor/wood/large,
/area/misc/hilbertshotel)
"MN" = (
/obj/structure/chair/sofa/corp/left{
	dir = 4
	},
/obj/effect/turf_decal/siding/wood{
	dir = 8
	},
/obj/machinery/light/directional/west,
/turf/open/floor/wood/large,
/area/misc/hilbertshotel)
"MT" = (
/obj/structure/closet/secure_closet/freezer/fridge/all_access,
/obj/item/storage/cans/sixbeer,
/turf/open/floor/iron/kitchen/small,
/area/misc/hilbertshotel)
"Na" = (
/obj/structure/table/wood,
/obj/structure/towel_bin,
/turf/open/floor/carpet/red,
/area/misc/hilbertshotel)
"NW" = (
/obj/effect/turf_decal/siding/wood{
	dir = 5
	},
/obj/structure/sink/kitchen/directional/south,
/turf/open/floor/wood/large,
/area/misc/hilbertshotel)
"Od" = (
/obj/effect/decal/cleanable/dirt,
/obj/structure/fluff/paper/stack,
/obj/structure/fence/corner{
	dir = 8
	},
/turf/open/floor/stone,
/area/misc/hilbertshotel)
"Ou" = (
/obj/structure/chair/sofa/bench/left{
	dir = 1
	},
/turf/open/floor/carpet/stellar,
/area/misc/hilbertshotel)
"OX" = (
/obj/structure/chair/sofa/corp{
	dir = 4
	},
/obj/effect/turf_decal/siding/wood{
	dir = 8
	},
/turf/open/floor/wood/large,
/area/misc/hilbertshotel)
"Pe" = (
/obj/effect/turf_decal/siding/wood/corner,
/turf/open/floor/wood/large,
/area/misc/hilbertshotel)
"Pm" = (
/obj/structure/table/wood,
/obj/effect/turf_decal/siding/wood{
	dir = 5
	},
/turf/open/floor/wood,
/area/misc/hilbertshotel)
"PG" = (
/obj/structure/fence/corner,
/turf/open/floor/stone,
/area/misc/hilbertshotel)
"Qh" = (
/obj/effect/decal/cleanable/dirt,
/obj/structure/broken_flooring/pile/always_floorplane/directional/north,
/obj/structure/sign/poster/contraband/gorlex_recruitment/directional/west,
/turf/open/floor/stone,
/area/misc/hilbertshotel)
"QB" = (
/obj/structure/flora/bush/jungle,
/obj/structure/flora/bush/large/style_2{
	pixel_y = -2
	},
/turf/open/floor/grass,
/area/misc/hilbertshotel)
"QF" = (
/obj/machinery/room_controller/directional/north,
/turf/open/floor/carpet/stellar,
/area/misc/hilbertshotel)
"RP" = (
/obj/structure/rack/shelf,
/obj/item/towel,
/obj/item/towel,
/obj/item/clothing/under/costume/skyrat/bathrobe,
/obj/item/clothing/under/costume/skyrat/bathrobe,
/turf/open/floor/iron/white/small,
/area/misc/hilbertshotel)
"RY" = (
/obj/effect/decal/cleanable/dirt,
/obj/effect/decal/cleanable/dirt,
/turf/open/floor/stone,
/area/misc/hilbertshotel)
"Sj" = (
/obj/machinery/computer,
/obj/machinery/light/directional/north,
/turf/open/floor/carpet/royalblack,
/area/misc/hilbertshotel)
"Sw" = (
/obj/structure/chair/pew/left,
/obj/effect/turf_decal/siding/wood{
	dir = 9
	},
/turf/open/floor/wood,
/area/misc/hilbertshotel)
"SA" = (
/obj/machinery/vending/dorms,
/turf/open/floor/iron,
/area/misc/hilbertshotel)
"SJ" = (
/obj/structure/table/reinforced,
/obj/machinery/reagentgrinder{
	pixel_y = 11;
	pixel_x = -4
	},
/obj/item/kitchen/rollingpin{
	pixel_x = 8;
	pixel_y = 2
	},
/turf/open/floor/iron/kitchen/small,
/area/misc/hilbertshotel)
"Th" = (
/obj/machinery/light/broken/directional/east,
/turf/open/floor/stone,
/area/misc/hilbertshotel)
"TR" = (
/obj/effect/turf_decal/siding/wood/corner{
	dir = 4
	},
/turf/open/floor/wood/large,
/area/misc/hilbertshotel)
"Ut" = (
/obj/effect/turf_decal/siding/wood,
/turf/open/floor/wood/large,
/area/misc/hilbertshotel)
"Wv" = (
/obj/structure/railing{
	dir = 8;
	icon_state = "railing"
	},
/obj/structure/closet/crate/freezer/food,
/obj/machinery/light/directional/south,
/obj/item/food/grown/tomato,
/obj/item/food/grown/tomato,
/obj/item/food/grown/tomato,
/obj/item/food/grown/tomato,
/obj/item/food/grown/tomato,
/obj/item/food/grown/corn,
/obj/item/food/grown/corn,
/obj/item/food/grown/corn,
/obj/item/food/grown/banana,
/obj/item/food/grown/banana,
/obj/item/food/grown/carrot,
/obj/item/food/grown/carrot,
/obj/item/food/grown/carrot,
/turf/open/floor/iron/kitchen/small,
/area/misc/hilbertshotel)
"Wz" = (
/obj/structure/chair,
/obj/item/clothing/sextoy/dildo,
/obj/effect/decal/cleanable/blood/splatter,
/obj/machinery/light/red/dim/directional/north,
/turf/open/floor/iron,
/area/misc/hilbertshotel)
"WA" = (
/obj/effect/turf_decal/siding/wood{
	dir = 9
	},
/obj/structure/aquarium/prefilled,
/turf/open/floor/wood/large,
/area/misc/hilbertshotel)
"WI" = (
/obj/item/lighter,
/obj/structure/table/wood/fancy/blue,
/turf/open/floor/carpet/royalblue,
/area/misc/hilbertshotel)
"Xr" = (
/obj/structure/dresser,
/turf/open/floor/wood/large,
/area/misc/hilbertshotel)
"Xw" = (
/obj/effect/spawner/random/food_or_drink/three_course_meal{
	pixel_x = -7;
	pixel_y = 6
	},
/obj/structure/table/wood/fancy/blue,
/turf/open/floor/carpet/royalblue,
/area/misc/hilbertshotel)
"XR" = (
/obj/structure/fluff/paper/stack{
	dir = 8
	},
/turf/open/floor/stone,
/area/misc/hilbertshotel)
"XZ" = (
/obj/effect/turf_decal/siding/wood/corner{
	dir = 8
	},
/turf/open/floor/wood,
/area/misc/hilbertshotel)
"Yf" = (
/obj/structure/table/reinforced,
/obj/item/electropack/shockcollar{
	pixel_x = -2;
	pixel_y = 6
	},
/obj/item/assembly/signaler{
	pixel_x = 5;
	pixel_y = 3
	},
/obj/structure/sign/poster/contraband/crocin_pool/directional/north,
/turf/open/floor/iron,
/area/misc/hilbertshotel)
"Yh" = (
/obj/machinery/vending/boozeomat/cafe,
/turf/open/floor/wood/large,
/area/misc/hilbertshotel)
"YT" = (
/obj/effect/turf_decal/siding/wood{
	dir = 8
	},
/turf/open/floor/wood/large,
/area/misc/hilbertshotel)
"Zp" = (
/obj/structure/closet/crate/trashcart/filled,
/turf/open/floor/stone,
/area/misc/hilbertshotel)
"Zu" = (
/turf/open/floor/catwalk_floor,
/area/misc/hilbertshotel)
"ZE" = (
/obj/machinery/jukebox/no_access,
/turf/open/floor/carpet/royalblue,
/area/misc/hilbertshotel)
"ZK" = (
/obj/structure/chair/sofa/corp/corner{
	dir = 1
	},
/obj/effect/turf_decal/siding/wood{
	dir = 10
	},
/turf/open/floor/wood/large,
/area/misc/hilbertshotel)
"ZX" = (
/turf/open/floor/carpet/stellar,
/area/misc/hilbertshotel)

(1,1,1) = {"
sZ
sZ
sZ
sZ
sZ
sZ
sZ
sZ
sZ
sZ
sZ
sZ
sZ
sZ
sZ
sZ
sZ
sZ
"}
(2,1,1) = {"
sZ
Zu
Zu
Zu
Zu
ot
Ka
ot
ot
vJ
ot
ot
ot
ot
ot
ot
ot
sZ
"}
(3,1,1) = {"
sZ
ot
ot
ot
ot
wr
fF
rT
Jv
tW
mo
Zp
DZ
Qh
bz
Eg
ot
sZ
"}
(4,1,1) = {"
sZ
ot
Yf
Fb
SA
wr
rT
Od
PG
qn
Ga
RY
aK
XR
Jv
jv
Ka
sZ
"}
(5,1,1) = {"
sZ
ot
Wz
xA
Jc
ok
zb
lO
Zp
ib
Th
tr
uN
pG
Jv
rT
Ka
sZ
"}
(6,1,1) = {"
sZ
ot
fK
az
CP
ok
ok
ok
ok
ok
ok
ok
ot
CX
ok
ok
ot
sZ
"}
(7,1,1) = {"
sZ
ot
ok
km
ok
ok
WA
YT
MN
OX
ZK
ok
Cp
xM
qz
ot
be
sZ
"}
(8,1,1) = {"
sZ
ot
Xr
EV
BF
ok
gx
pD
WI
zO
lG
ok
uQ
ZX
Ou
ot
Zu
sZ
"}
(9,1,1) = {"
sZ
ot
Hq
qd
qd
ok
uL
pD
zO
Xw
AX
ok
QF
ZX
dZ
ot
Zu
sZ
"}
(10,1,1) = {"
sZ
ot
gS
qd
qd
ok
Ke
pD
ZE
lb
eI
ok
ok
Mq
ok
ok
ot
sZ
"}
(11,1,1) = {"
sZ
ot
Sj
BT
qd
Mq
Gs
pD
pD
pD
Jh
QB
qE
DV
Ey
Eh
ot
sZ
"}
(12,1,1) = {"
sZ
ot
qq
nZ
BF
ok
sb
pD
pD
pD
Fa
vZ
xh
uX
CQ
Wv
ot
sZ
"}
(13,1,1) = {"
sZ
ot
ok
ok
ok
ok
HL
TR
Pe
cn
cn
sN
TR
uX
Ut
wn
ot
sZ
"}
(14,1,1) = {"
sZ
ot
Sw
JH
GS
ok
ok
lM
nk
Yh
ok
ok
NW
cn
BP
SJ
ot
sZ
"}
(15,1,1) = {"
sZ
ot
pv
XZ
vW
cy
ok
ox
ox
ok
uw
ok
fU
HZ
HZ
ee
ot
sZ
"}
(16,1,1) = {"
sZ
ot
FK
gd
dr
uv
HT
ox
ox
HE
vt
ok
rB
HZ
HZ
gE
ot
sZ
"}
(17,1,1) = {"
sZ
ot
Pm
tb
hX
RP
ok
Na
hB
ok
cP
ok
gG
AO
HZ
MT
ot
sZ
"}
(18,1,1) = {"
sZ
ot
ot
ot
ot
ot
ot
ot
ot
ot
ot
ot
ot
ot
ot
ot
ot
sZ
"}
(19,1,1) = {"
sZ
sZ
sZ
sZ
sZ
sZ
sZ
sZ
sZ
sZ
sZ
sZ
sZ
sZ
sZ
sZ
sZ
sZ
"}
