//MAP CONVERTED BY dmm2tgm.py THIS HEADER COMMENT PREVENTS RECONVERSION, DO NOT REMOVE
"ag" = (
/obj/structure/flora/grass/jungle/a/style_random,
/turf/open/floor/grass,
/area/misc/hilbertshotel)
"aO" = (
/obj/effect/turf_decal/siding/thinplating{
	dir = 1
	},
/obj/structure/flora/grass/jungle/a/style_random,
/turf/open/floor/grass,
/area/misc/hilbertshotel)
"aP" = (
/obj/structure/bed/double{
	dir = 1
	},
/turf/open/misc/beach/sand,
/area/misc/hilbertshotel)
"br" = (
/obj/effect/turf_decal/weather/sand{
	dir = 1
	},
/turf/open/floor/grass,
/area/misc/hilbertshotel)
"bH" = (
/obj/structure/flora/rock/pile,
/turf/open/floor/grass,
/area/misc/hilbertshotel)
"cC" = (
/obj/structure/flora/bush/flowers_br/style_random,
/obj/structure/flora/grass/jungle/a/style_random,
/turf/open/floor/grass,
/area/misc/hilbertshotel)
"cI" = (
/obj/structure/flora/tree/palm/style_random,
/turf/open/misc/beach/sand,
/area/misc/hilbertshotel)
"dl" = (
/obj/machinery/light/floor{
	light_power = 20;
	light_range = 5;
	invisibility = 1
	},
/turf/open/misc/beach/coast{
	dir = 8
	},
/area/misc/hilbertshotel)
"eS" = (
/obj/effect/turf_decal/siding/thinplating,
/turf/open/floor/grass,
/area/misc/hilbertshotel)
"gX" = (
/obj/machinery/light/floor{
	light_power = 20;
	light_range = 5
	},
/obj/structure/flora/bush/grassy/style_random,
/obj/effect/turf_decal/siding/thinplating/corner{
	dir = 4
	},
/obj/structure/flora/grass/jungle/a/style_random,
/turf/open/floor/grass,
/area/misc/hilbertshotel)
"hA" = (
/turf/open/misc/beach/coast/corner{
	dir = 8
	},
/area/misc/hilbertshotel)
"hD" = (
/turf/open/indestructible/cobble/side{
	dir = 8
	},
/area/misc/hilbertshotel)
"iB" = (
/obj/structure/flora/bush/flowers_br/style_random,
/turf/open/floor/grass,
/area/misc/hilbertshotel)
"iJ" = (
/turf/open/water/beach,
/area/misc/hilbertshotel)
"jw" = (
/obj/machinery/telecomms/relay/preset/auto,
/turf/open/floor/catwalk_floor,
/area/misc/hilbertshotel)
"kf" = (
/obj/structure/spacevine,
/turf/closed/indestructible/rock,
/area/misc/hilbertshotel)
"kS" = (
/obj/structure/flora/tree/jungle{
	pixel_x = -72;
	pixel_y = -29
	},
/obj/structure/flora/grass/jungle/a/style_random,
/turf/open/floor/grass,
/area/misc/hilbertshotel)
"lh" = (
/turf/open/misc/beach/coast{
	dir = 8
	},
/area/misc/hilbertshotel)
"lC" = (
/obj/structure/flora/biolumi/mine,
/obj/effect/turf_decal/weather/sand{
	dir = 1
	},
/turf/open/floor/grass,
/area/misc/hilbertshotel)
"lJ" = (
/obj/item/storage/fancy/heart_box,
/turf/open/floor/carpet/cyan,
/area/misc/hilbertshotel)
"lT" = (
/obj/structure/flora/tree/palm/style_random,
/turf/open/misc/beach/coast/corner{
	dir = 4
	},
/area/misc/hilbertshotel)
"mz" = (
/obj/structure/flora/rock,
/obj/structure/flora/rock,
/turf/open/misc/beach/sand,
/area/misc/hilbertshotel)
"nb" = (
/obj/structure/chair/pew/right,
/turf/open/floor/grass,
/area/misc/hilbertshotel)
"od" = (
/obj/machinery/vending/dorms,
/turf/open/misc/beach/sand,
/area/misc/hilbertshotel)
"oF" = (
/obj/structure/flora/bush/generic/style_random,
/turf/open/floor/grass,
/area/misc/hilbertshotel)
"pd" = (
/turf/open/indestructible/cobble/side{
	dir = 1
	},
/area/misc/hilbertshotel)
"pM" = (
/obj/structure/chair/pew,
/turf/open/floor/grass,
/area/misc/hilbertshotel)
"rE" = (
/obj/machinery/light/floor{
	light_power = 20;
	light_range = 5
	},
/obj/structure/flora/bush/grassy/style_random,
/turf/open/misc/beach/sand,
/area/misc/hilbertshotel)
"sx" = (
/obj/structure/flora/bush/flowers_pp/style_random,
/turf/open/floor/grass,
/area/misc/hilbertshotel)
"sS" = (
/obj/effect/turf_decal/siding/thinplating/corner{
	dir = 1
	},
/obj/machinery/room_controller/directional/south,
/turf/open/floor/grass,
/area/misc/hilbertshotel)
"tg" = (
/obj/structure/flora/tree/palm,
/turf/open/misc/beach/sand,
/area/misc/hilbertshotel)
"tX" = (
/turf/open/indestructible/cobble/corner,
/area/misc/hilbertshotel)
"uz" = (
/obj/item/toy/cards/deck,
/turf/open/floor/carpet/cyan,
/area/misc/hilbertshotel)
"uD" = (
/obj/structure/chair/pew{
	dir = 8
	},
/turf/open/floor/grass,
/area/misc/hilbertshotel)
"we" = (
/turf/open/indestructible/cobble/side{
	dir = 4
	},
/area/misc/hilbertshotel)
"xv" = (
/obj/structure/flora/bush/flowers_pp/style_random,
/obj/structure/flora/bush/flowers_br/style_random,
/turf/open/floor/grass,
/area/misc/hilbertshotel)
"xJ" = (
/obj/effect/turf_decal/weather/sand{
	dir = 8
	},
/obj/structure/flora/bush/flowers_br/style_random,
/turf/open/floor/grass,
/area/misc/hilbertshotel)
"xQ" = (
/obj/structure/flora/bush/fullgrass/style_random,
/turf/open/misc/beach/sand,
/area/misc/hilbertshotel)
"yf" = (
/obj/effect/turf_decal/weather/sand{
	dir = 8
	},
/turf/open/floor/grass,
/area/misc/hilbertshotel)
"yr" = (
/turf/closed/indestructible/rock,
/area/misc/hilbertshotel)
"yD" = (
/obj/effect/turf_decal/weather/sand{
	dir = 9
	},
/turf/open/floor/grass,
/area/misc/hilbertshotel)
"yU" = (
/turf/open/indestructible/cobble/corner{
	dir = 1
	},
/area/misc/hilbertshotel)
"Ah" = (
/turf/open/misc/beach/coast{
	dir = 4
	},
/area/misc/hilbertshotel)
"Ar" = (
/turf/open/misc/beach/coast{
	dir = 5
	},
/area/misc/hilbertshotel)
"BZ" = (
/turf/open/misc/beach/coast{
	dir = 1
	},
/area/misc/hilbertshotel)
"Cu" = (
/obj/machinery/light/floor{
	light_power = 20;
	light_range = 5
	},
/obj/effect/turf_decal/weather/sand{
	dir = 5
	},
/obj/structure/flora/bush/grassy/style_random,
/turf/open/floor/grass,
/area/misc/hilbertshotel)
"CC" = (
/obj/effect/turf_decal/weather/sand{
	dir = 1
	},
/obj/structure/flora/bush/flowers_br/style_random,
/turf/open/floor/grass,
/area/misc/hilbertshotel)
"CR" = (
/obj/effect/turf_decal/weather/sand{
	dir = 5
	},
/turf/open/floor/grass,
/area/misc/hilbertshotel)
"Dc" = (
/obj/structure/chair/pew/left,
/obj/effect/turf_decal/weather/sand{
	dir = 1
	},
/turf/open/floor/grass,
/area/misc/hilbertshotel)
"De" = (
/turf/open/misc/beach/coast/corner{
	dir = 1
	},
/area/misc/hilbertshotel)
"Dl" = (
/turf/closed/indestructible/hoteldoor{
	icon_state = "door_closed";
	icon = 'icons/obj/doors/puzzledoor/default.dmi'
	},
/area/misc/hilbertshotel)
"Dx" = (
/obj/structure/fluff/beach_umbrella/science{
	pixel_x = 7;
	pixel_y = 11
	},
/obj/item/towel,
/turf/open/misc/beach/sand,
/area/misc/hilbertshotel)
"DA" = (
/turf/open/indestructible/cobble/corner{
	dir = 4
	},
/area/misc/hilbertshotel)
"Ew" = (
/obj/structure/flora/biolumi/mine,
/turf/open/misc/beach/sand,
/area/misc/hilbertshotel)
"Ex" = (
/obj/effect/turf_decal/siding/thinplating{
	dir = 4
	},
/obj/structure/flora/grass/jungle/a/style_random,
/turf/open/floor/grass,
/area/misc/hilbertshotel)
"EE" = (
/obj/effect/turf_decal/siding/thinplating{
	dir = 8
	},
/turf/open/floor/grass,
/area/misc/hilbertshotel)
"Fs" = (
/obj/machinery/light/floor{
	light_power = 20;
	light_range = 5
	},
/obj/structure/flora/rock,
/turf/open/misc/beach/coast/corner{
	dir = 8
	},
/area/misc/hilbertshotel)
"Fu" = (
/obj/effect/turf_decal/weather/sand{
	dir = 1
	},
/obj/structure/flora/grass/jungle/b/style_random,
/obj/structure/flora/grass/jungle/a/style_random,
/turf/open/floor/grass,
/area/misc/hilbertshotel)
"GU" = (
/obj/machinery/light/floor{
	light_power = 20;
	light_range = 5
	},
/obj/effect/turf_decal/weather/sand{
	dir = 8
	},
/obj/structure/flora/bush/grassy/style_random,
/obj/structure/flora/bush/flowers_br/style_random,
/turf/open/floor/grass,
/area/misc/hilbertshotel)
"Hw" = (
/obj/machinery/light/floor{
	light_power = 20;
	light_range = 5
	},
/obj/structure/flora/bush/grassy/style_random,
/turf/open/floor/grass,
/area/misc/hilbertshotel)
"HM" = (
/obj/structure/flora/tree/jungle,
/obj/effect/turf_decal/weather/sand{
	dir = 8
	},
/turf/open/floor/grass,
/area/misc/hilbertshotel)
"Iy" = (
/obj/item/toy/beach_ball,
/turf/open/misc/beach/coast{
	dir = 5
	},
/area/misc/hilbertshotel)
"JC" = (
/obj/structure/flora/bush/sunny/style_random,
/obj/effect/turf_decal/siding/thinplating{
	dir = 8
	},
/turf/open/floor/grass,
/area/misc/hilbertshotel)
"Ld" = (
/obj/structure/flora/biolumi/flower,
/obj/structure/flora/grass/jungle/b/style_random,
/turf/open/floor/grass,
/area/misc/hilbertshotel)
"LH" = (
/turf/open/misc/beach/coast/corner{
	dir = 4
	},
/area/misc/hilbertshotel)
"MC" = (
/obj/structure/bonfire,
/obj/effect/spawner/random/entertainment/lighter,
/turf/open/indestructible/cobble,
/area/misc/hilbertshotel)
"Ng" = (
/obj/structure/flora/biolumi/mine,
/turf/open/floor/grass,
/area/misc/hilbertshotel)
"Nl" = (
/obj/machinery/light/floor{
	light_power = 20;
	light_range = 5;
	invisibility = 1
	},
/obj/structure/flora/bush/grassy/style_random,
/turf/open/floor/grass,
/area/misc/hilbertshotel)
"NZ" = (
/obj/structure/flora/biolumi/flower,
/obj/effect/turf_decal/siding/thinplating,
/turf/open/floor/grass,
/area/misc/hilbertshotel)
"Og" = (
/obj/structure/flora/rock/pile,
/obj/structure/flora/bush/flowers_br/style_random,
/turf/open/floor/grass,
/area/misc/hilbertshotel)
"Oh" = (
/obj/structure/spacevine,
/obj/structure/flora/bush/flowers_br/style_random,
/obj/structure/flora/bush/flowers_pp/style_random,
/obj/structure/flora/bush/flowers_yw/style_random,
/obj/structure/curtain/bounty,
/turf/open/misc/beach/coast,
/area/misc/hilbertshotel)
"Po" = (
/turf/open/floor/grass,
/area/misc/hilbertshotel)
"Px" = (
/turf/open/indestructible/cobble/side,
/area/misc/hilbertshotel)
"PZ" = (
/obj/item/flashlight/flare/candle/jasmine,
/turf/open/misc/beach/sand,
/area/misc/hilbertshotel)
"Qp" = (
/obj/item/storage/basket,
/obj/item/reagent_containers/cup/glass/bottle/wine{
	pixel_y = 9;
	pixel_x = 9
	},
/obj/effect/spawner/random/food_or_drink/three_course_meal,
/turf/open/floor/carpet/cyan,
/area/misc/hilbertshotel)
"Qv" = (
/obj/structure/flora/bush/flowers_pp/style_random,
/obj/structure/flora/grass/jungle/a/style_random,
/obj/structure/flora/bush/flowers_pp/style_random,
/obj/structure/flora/bush/flowers_br/style_random,
/turf/open/floor/grass,
/area/misc/hilbertshotel)
"QO" = (
/obj/structure/chair/pew/left{
	dir = 8
	},
/turf/open/floor/grass,
/area/misc/hilbertshotel)
"RQ" = (
/obj/structure/flora/tree/jungle/small,
/turf/open/floor/grass,
/area/misc/hilbertshotel)
"Su" = (
/obj/structure/chair/pew/right{
	dir = 8
	},
/turf/open/floor/grass,
/area/misc/hilbertshotel)
"Sy" = (
/obj/structure/flora/bush/sunny/style_random,
/turf/open/floor/grass,
/area/misc/hilbertshotel)
"Uq" = (
/obj/structure/flora/bush/flowers_br/style_random,
/obj/effect/turf_decal/siding/thinplating/corner{
	dir = 8
	},
/turf/open/floor/grass,
/area/misc/hilbertshotel)
"Vt" = (
/obj/structure/fluff/beach_umbrella/science{
	pixel_x = 1;
	pixel_y = 10
	},
/turf/open/floor/carpet/cyan,
/area/misc/hilbertshotel)
"We" = (
/turf/open/misc/beach/coast{
	dir = 9
	},
/area/misc/hilbertshotel)
"Wx" = (
/obj/effect/turf_decal/weather/sand{
	dir = 1
	},
/obj/structure/flora/grass/jungle/b/style_random,
/turf/open/floor/grass,
/area/misc/hilbertshotel)
"WD" = (
/turf/open/misc/beach/sand,
/area/misc/hilbertshotel)
"Xa" = (
/obj/structure/flora/bush/stalky/style_random,
/turf/open/water/beach,
/area/misc/hilbertshotel)
"Yd" = (
/obj/structure/flora/grass/jungle/b/style_random,
/turf/open/floor/grass,
/area/misc/hilbertshotel)
"YF" = (
/turf/open/indestructible/cobble/corner{
	dir = 8
	},
/area/misc/hilbertshotel)
"YH" = (
/obj/effect/turf_decal/weather/sand{
	dir = 1
	},
/obj/structure/flora/bush/sunny/style_random,
/obj/structure/flora/bush/flowers_br/style_random,
/turf/open/floor/grass,
/area/misc/hilbertshotel)
"Ze" = (
/obj/effect/turf_decal/weather/sand{
	dir = 1
	},
/obj/structure/flora/grass/jungle/a/style_random,
/turf/open/floor/grass,
/area/misc/hilbertshotel)
"Zm" = (
/obj/structure/flora/tree/jungle,
/obj/effect/turf_decal/siding/thinplating/corner,
/turf/open/floor/grass,
/area/misc/hilbertshotel)
"Zs" = (
/obj/structure/flora/biolumi/lamp,
/turf/open/floor/grass,
/area/misc/hilbertshotel)

(1,1,1) = {"
yr
yr
yr
yr
yr
yr
yr
yr
yr
yr
yr
yr
yr
yr
yr
yr
"}
(2,1,1) = {"
yr
WD
rE
WD
WD
WD
Cu
Sy
Po
Ld
Po
Nl
Po
Po
yr
yr
"}
(3,1,1) = {"
yr
yr
mz
WD
WD
tg
WD
CR
Po
Yd
Po
Zm
Ex
Ex
gX
yr
"}
(4,1,1) = {"
yr
yr
yr
Ah
hA
WD
Dx
xQ
br
Yd
Yd
NZ
Qp
lJ
aO
yr
"}
(5,1,1) = {"
yr
yr
yr
iJ
Ar
hA
WD
cI
YH
sx
iB
eS
Vt
uz
aO
yr
"}
(6,1,1) = {"
yr
aP
WD
kf
Xa
Iy
Fs
WD
CC
oF
iB
Uq
JC
EE
sS
yr
"}
(7,1,1) = {"
yr
WD
PZ
kf
Xa
iJ
BZ
WD
Wx
Po
ag
ag
Po
Po
Po
Dl
"}
(8,1,1) = {"
yr
WD
WD
Oh
iJ
iJ
BZ
WD
Fu
ag
ag
ag
kS
ag
Zs
yr
"}
(9,1,1) = {"
yr
WD
WD
Oh
iJ
iJ
BZ
WD
lC
Hw
Hw
Po
Po
Hw
ag
yr
"}
(10,1,1) = {"
yr
od
yr
kf
Xa
iJ
BZ
WD
br
Sy
Po
xv
Qv
ag
ag
yr
"}
(11,1,1) = {"
yr
yr
yr
iJ
We
dl
lT
WD
Ze
Po
Og
iB
sx
Po
Po
yr
"}
(12,1,1) = {"
yr
yr
De
lh
LH
WD
WD
WD
Dc
yU
hD
YF
Po
Po
RQ
yr
"}
(13,1,1) = {"
yr
WD
Ew
WD
WD
yD
yf
HM
pM
pd
MC
Px
Sy
Hw
ag
yr
"}
(14,1,1) = {"
yr
yf
GU
xJ
xJ
Po
Yd
Hw
nb
tX
we
DA
Po
Ng
ag
yr
"}
(15,1,1) = {"
yr
Po
ag
cC
ag
bH
Hw
Yd
ag
QO
uD
Su
Po
Po
yr
yr
"}
(16,1,1) = {"
yr
yr
yr
yr
yr
yr
yr
yr
yr
yr
yr
yr
yr
yr
yr
jw
"}
