//MAP CONVERTED BY dmm2tgm.py THIS HEADER COMMENT PREVENTS RECONVERSION, DO NOT REMOVE
"aN" = (
/obj/machinery/light_switch/directional/east,
/obj/structure/dresser,
/turf/open/floor/carpet/red,
/area/misc/hilbertshotel)
"bd" = (
/obj/effect/turf_decal/siding/wood{
	dir = 8
	},
/obj/structure/sign/painting/library{
	pixel_x = -32
	},
/turf/open/floor/carpet/royalblue,
/area/misc/hilbertshotel)
"dm" = (
/obj/effect/turf_decal/trimline/white/filled/end{
	dir = 4
	},
/obj/effect/spawner/liquids_spawner/shoulders,
/turf/open/floor/iron/pool,
/area/misc/hilbertshotel)
"fb" = (
/obj/structure/table/wood,
/obj/item/pizzabox/margherita{
	pixel_y = 11
	},
/obj/effect/turf_decal/siding/wood{
	dir = 4
	},
/turf/open/floor/wood,
/area/misc/hilbertshotel)
"fo" = (
/obj/effect/turf_decal/siding/wood{
	dir = 6
	},
/obj/item/reagent_containers/cup/bottle/hexacrocin,
/obj/structure/table,
/turf/open/floor/carpet/royalblue,
/area/misc/hilbertshotel)
"fy" = (
/obj/effect/turf_decal/siding/wood/corner{
	dir = 4
	},
/turf/open/floor/carpet/royalblue,
/area/misc/hilbertshotel)
"fG" = (
/obj/machinery/light/warm/directional/north,
/turf/open/floor/iron,
/area/misc/hilbertshotel)
"fH" = (
/obj/effect/turf_decal/siding/wood/corner{
	dir = 8
	},
/turf/open/floor/carpet/royalblue,
/area/misc/hilbertshotel)
"fW" = (
/obj/structure/bed,
/turf/open/floor/iron,
/area/misc/hilbertshotel)
"gP" = (
/obj/structure/table/glass,
/turf/open/floor/iron,
/area/misc/hilbertshotel)
"gS" = (
/obj/machinery/vending/games{
	shut_up = 1;
	onstation = 0
	},
/obj/effect/turf_decal/siding/wood{
	dir = 1
	},
/turf/open/floor/carpet/royalblue,
/area/misc/hilbertshotel)
"gV" = (
/obj/effect/turf_decal/siding/wood{
	dir = 1
	},
/obj/machinery/light_switch/directional/north,
/turf/open/floor/carpet/royalblue,
/area/misc/hilbertshotel)
"hJ" = (
/turf/open/floor/wood,
/area/misc/hilbertshotel)
"ix" = (
/obj/effect/turf_decal/siding/wood{
	dir = 8
	},
/obj/machinery/light/warm/directional/west,
/turf/open/floor/carpet/royalblue,
/area/misc/hilbertshotel)
"iJ" = (
/obj/effect/turf_decal/siding/wood{
	dir = 10
	},
/obj/structure/rack,
/turf/open/floor/carpet/royalblue,
/area/misc/hilbertshotel)
"jP" = (
/obj/structure/chair/pew/right{
	dir = 4
	},
/turf/open/floor/wood/tile,
/area/misc/hilbertshotel)
"jX" = (
/obj/structure/mineral_door/paperframe{
	name = "Changing Room";
	dir = 4
	},
/turf/open/floor/iron,
/area/misc/hilbertshotel)
"ki" = (
/obj/structure/lattice,
/turf/open/space/bluespace,
/area/misc/hilbertshotel)
"ly" = (
/obj/structure/closet/crate/wooden,
/obj/item/stack/sheet/mineral/wood/fifty,
/obj/item/wrench,
/obj/effect/spawner/random/entertainment/lighter,
/obj/machinery/light/warm/directional/south,
/turf/open/floor/carpet/red,
/area/misc/hilbertshotel)
"mc" = (
/obj/structure/railing{
	dir = 8
	},
/obj/machinery/light/warm/directional/east,
/turf/open/floor/iron,
/area/misc/hilbertshotel)
"ml" = (
/obj/effect/turf_decal/siding/wood{
	dir = 1
	},
/obj/machinery/room_controller/directional/north,
/turf/open/floor/carpet/royalblue,
/area/misc/hilbertshotel)
"ne" = (
/obj/effect/turf_decal/siding/wood{
	dir = 9
	},
/turf/open/floor/carpet/royalblue,
/area/misc/hilbertshotel)
"nJ" = (
/turf/open/floor/wood/tile,
/area/misc/hilbertshotel)
"oz" = (
/obj/structure/railing{
	dir = 8
	},
/obj/structure/railing,
/turf/open/floor/iron,
/area/misc/hilbertshotel)
"oR" = (
/obj/structure/closet/secure_closet/personal,
/turf/open/floor/wood,
/area/misc/hilbertshotel)
"pw" = (
/obj/structure/mineral_door/paperframe{
	name = "Changing Room";
	dir = 8
	},
/turf/open/floor/wood,
/area/misc/hilbertshotel)
"pE" = (
/obj/effect/turf_decal/siding/wood{
	dir = 4
	},
/obj/structure/sign/painting/library{
	pixel_x = 32
	},
/turf/open/floor/carpet/royalblue,
/area/misc/hilbertshotel)
"qi" = (
/obj/machinery/light/floor{
	bulb_colour = "F27D0C"
	},
/turf/open/floor/wood/tile,
/area/misc/hilbertshotel)
"qm" = (
/obj/structure/table/wood,
/obj/item/storage/fancy/heart_box,
/turf/open/floor/wood,
/area/misc/hilbertshotel)
"qv" = (
/obj/structure/chair/pew/right{
	dir = 8
	},
/turf/open/floor/wood/tile,
/area/misc/hilbertshotel)
"rb" = (
/obj/effect/turf_decal/trimline/white/filled/line{
	dir = 8
	},
/obj/effect/spawner/liquids_spawner/shoulders,
/turf/open/floor/iron/pool,
/area/misc/hilbertshotel)
"rX" = (
/obj/structure/mineral_door/paperframe{
	name = "Changing Room";
	dir = 8
	},
/turf/open/floor/iron,
/area/misc/hilbertshotel)
"tB" = (
/obj/machinery/light/warm/directional/south,
/turf/open/floor/wood,
/area/misc/hilbertshotel)
"tF" = (
/obj/machinery/vending/boozeomat{
	onstation = 0;
	shut_up = 1
	},
/obj/effect/turf_decal/siding/wood{
	dir = 1
	},
/turf/open/floor/carpet/royalblue,
/area/misc/hilbertshotel)
"tS" = (
/obj/structure/closet/athletic_mixed,
/turf/open/floor/wood,
/area/misc/hilbertshotel)
"tX" = (
/obj/structure/closet/crate/wooden,
/obj/effect/turf_decal/siding/wood,
/obj/item/clothing/shoes/sandal,
/obj/item/clothing/shoes/sandal,
/obj/item/clothing/shoes/sandal,
/obj/item/clothing/shoes/sandal,
/obj/item/clothing/shoes/sandal,
/obj/item/clothing/shoes/sandal,
/obj/item/clothing/shoes/sandal,
/obj/machinery/light/warm/directional/south,
/turf/open/floor/carpet/royalblue,
/area/misc/hilbertshotel)
"ut" = (
/obj/effect/turf_decal/siding/wood{
	dir = 4
	},
/obj/machinery/light_switch/directional/east,
/turf/open/floor/carpet/royalblue,
/area/misc/hilbertshotel)
"uG" = (
/obj/effect/turf_decal/siding/wood{
	dir = 4
	},
/turf/open/floor/wood,
/area/misc/hilbertshotel)
"vL" = (
/obj/effect/turf_decal/siding/wood{
	dir = 1
	},
/turf/open/floor/carpet/royalblue,
/area/misc/hilbertshotel)
"wy" = (
/obj/effect/turf_decal/siding/wood{
	dir = 4
	},
/obj/machinery/light/warm/directional/east,
/turf/open/floor/carpet/royalblue,
/area/misc/hilbertshotel)
"wD" = (
/obj/structure/closet/cabinet,
/obj/effect/turf_decal/siding/wood{
	dir = 4
	},
/turf/open/floor/wood,
/area/misc/hilbertshotel)
"xp" = (
/obj/effect/turf_decal/trimline/white/filled/line{
	dir = 9
	},
/obj/effect/spawner/liquids_spawner/shoulders,
/turf/open/floor/iron/pool,
/area/misc/hilbertshotel)
"xC" = (
/obj/effect/turf_decal/siding/wood{
	dir = 8
	},
/turf/open/floor/carpet/royalblue,
/area/misc/hilbertshotel)
"xD" = (
/obj/effect/turf_decal/siding/wood,
/obj/structure/sign/painting/library{
	pixel_y = -32
	},
/turf/open/floor/carpet/royalblue,
/area/misc/hilbertshotel)
"xU" = (
/obj/effect/turf_decal/siding/wood{
	dir = 8
	},
/obj/machinery/light_switch/directional/west,
/turf/open/floor/carpet/royalblue,
/area/misc/hilbertshotel)
"zw" = (
/obj/effect/turf_decal/siding/wood{
	dir = 9
	},
/obj/item/kirbyplants/random,
/turf/open/floor/carpet/royalblue,
/area/misc/hilbertshotel)
"zJ" = (
/turf/open/floor/iron,
/area/misc/hilbertshotel)
"Aq" = (
/obj/structure/chair/pew/left{
	dir = 4
	},
/turf/open/floor/wood/tile,
/area/misc/hilbertshotel)
"Au" = (
/obj/effect/turf_decal/siding/wood{
	dir = 6
	},
/turf/open/floor/carpet/royalblue,
/area/misc/hilbertshotel)
"BQ" = (
/obj/effect/turf_decal/siding/wood{
	dir = 10
	},
/obj/machinery/vending/dorms,
/turf/open/floor/carpet/royalblue,
/area/misc/hilbertshotel)
"CU" = (
/obj/effect/turf_decal/trimline/white/filled/line{
	dir = 8
	},
/obj/machinery/light{
	dir = 8;
	light_color = "#e8eaff"
	},
/obj/effect/spawner/liquids_spawner/shoulders,
/turf/open/floor/iron/pool,
/area/misc/hilbertshotel)
"CY" = (
/obj/machinery/light_switch/directional/east,
/obj/machinery/vending/dorms,
/turf/open/floor/wood,
/area/misc/hilbertshotel)
"CZ" = (
/obj/structure/fireplace{
	pixel_x = 0
	},
/turf/open/floor/carpet/red,
/area/misc/hilbertshotel)
"Dt" = (
/obj/structure/chair/pew{
	dir = 4
	},
/turf/open/floor/wood/tile,
/area/misc/hilbertshotel)
"DO" = (
/obj/structure/table,
/obj/machinery/light/warm/directional/east,
/obj/structure/towel_bin,
/turf/open/floor/iron,
/area/misc/hilbertshotel)
"EW" = (
/obj/structure/chair/pew/left{
	dir = 8
	},
/turf/open/floor/wood/tile,
/area/misc/hilbertshotel)
"FQ" = (
/turf/closed/wall/mineral/wood,
/area/misc/hilbertshotel)
"Gf" = (
/obj/effect/spawner/liquids_spawner/shoulders,
/turf/open/floor/iron/pool,
/area/misc/hilbertshotel)
"Gm" = (
/obj/machinery/shower{
	pixel_y = 16
	},
/turf/open/floor/iron,
/area/misc/hilbertshotel)
"Gs" = (
/obj/effect/turf_decal/trimline/white/filled/line{
	dir = 10
	},
/obj/effect/spawner/liquids_spawner/shoulders,
/turf/open/floor/iron/pool,
/area/misc/hilbertshotel)
"Gw" = (
/obj/effect/turf_decal/trimline/white/filled/line{
	dir = 4
	},
/obj/effect/spawner/liquids_spawner/shoulders,
/turf/open/floor/iron/pool,
/area/misc/hilbertshotel)
"GJ" = (
/turf/closed/indestructible/hoteldoor{
	icon_state = "door_closed";
	icon = 'icons/obj/doors/puzzledoor/default.dmi'
	},
/area/misc/hilbertshotel)
"HN" = (
/obj/structure/table/glass,
/obj/machinery/light/warm/directional/east,
/turf/open/floor/iron,
/area/misc/hilbertshotel)
"Kq" = (
/obj/effect/turf_decal/trimline/white/filled/line,
/obj/effect/turf_decal/trimline/white/filled/corner{
	dir = 4
	},
/obj/effect/spawner/liquids_spawner/shoulders,
/turf/open/floor/iron/pool,
/area/misc/hilbertshotel)
"Kz" = (
/obj/structure/rack,
/turf/open/floor/wood,
/area/misc/hilbertshotel)
"LP" = (
/obj/machinery/vending/cigarette{
	shut_up = 1;
	onstation = 0
	},
/obj/effect/turf_decal/siding/wood{
	dir = 1
	},
/turf/open/floor/carpet/royalblue,
/area/misc/hilbertshotel)
"Ml" = (
/obj/structure/bed/double,
/obj/effect/spawner/random/bedsheet/double,
/turf/open/floor/carpet/red,
/area/misc/hilbertshotel)
"MT" = (
/obj/machinery/jukebox{
	req_one_access = null;
	area_limited = 1
	},
/turf/open/floor/carpet/red,
/area/misc/hilbertshotel)
"NC" = (
/obj/structure/table/wood,
/obj/item/flashlight/lamp/green{
	pixel_x = 5;
	pixel_y = 3
	},
/obj/item/choice_beacon/box/plushie,
/turf/open/floor/carpet/red,
/area/misc/hilbertshotel)
"ND" = (
/obj/effect/turf_decal/siding/wood/corner{
	dir = 1
	},
/turf/open/floor/carpet/royalblue,
/area/misc/hilbertshotel)
"NG" = (
/obj/structure/window/reinforced/tinted/spawner/directional/south,
/turf/open/floor/iron,
/area/misc/hilbertshotel)
"Op" = (
/obj/structure/closet/crate/bin{
	pixel_x = 9
	},
/obj/effect/turf_decal/siding/wood{
	dir = 1
	},
/turf/open/floor/carpet/royalblue,
/area/misc/hilbertshotel)
"OE" = (
/turf/closed/indestructible/wood,
/area/misc/hilbertshotel)
"OQ" = (
/obj/effect/turf_decal/trimline/white/filled/line{
	dir = 8
	},
/obj/effect/spawner/liquids_spawner/shoulders,
/obj/machinery/shower/directional/east,
/turf/open/floor/iron/pool,
/area/misc/hilbertshotel)
"OW" = (
/obj/effect/turf_decal/siding/wood{
	dir = 5
	},
/obj/structure/closet/crate/bin{
	pixel_x = -2
	},
/turf/open/floor/carpet/royalblue,
/area/misc/hilbertshotel)
"Ph" = (
/obj/machinery/vending/dinnerware{
	contraband = list(/obj/item/kitchen/rollingpin=2,/obj/item/kitchen/knife/butcher=2,/obj/item/reagent_containers/food/condiment/flour=4);
	shut_up = 1;
	onstation = 0
	},
/obj/effect/turf_decal/siding/wood{
	dir = 5
	},
/turf/open/floor/carpet/royalblue,
/area/misc/hilbertshotel)
"Pn" = (
/obj/effect/turf_decal/siding/wood{
	dir = 4
	},
/turf/open/floor/carpet/royalblue,
/area/misc/hilbertshotel)
"PD" = (
/turf/open/floor/carpet/red,
/area/misc/hilbertshotel)
"QM" = (
/obj/effect/turf_decal/siding/wood/corner,
/turf/open/floor/carpet/royalblue,
/area/misc/hilbertshotel)
"QS" = (
/obj/structure/railing{
	dir = 8
	},
/obj/machinery/smartfridge/drinks,
/turf/open/floor/iron,
/area/misc/hilbertshotel)
"Rt" = (
/obj/structure/bookcase/random,
/turf/open/floor/wood,
/area/misc/hilbertshotel)
"Rz" = (
/obj/effect/turf_decal/trimline/white/filled/line,
/obj/effect/spawner/liquids_spawner/shoulders,
/turf/open/floor/iron/pool,
/area/misc/hilbertshotel)
"RY" = (
/obj/structure/railing{
	dir = 8
	},
/turf/open/floor/iron,
/area/misc/hilbertshotel)
"Si" = (
/obj/machinery/telecomms/relay/preset/auto,
/turf/open/floor/catwalk_floor,
/area/misc/hilbertshotel)
"Sv" = (
/obj/effect/turf_decal/trimline/white/filled/line{
	dir = 1
	},
/obj/effect/spawner/liquids_spawner/shoulders,
/turf/open/floor/iron/pool,
/area/misc/hilbertshotel)
"Sx" = (
/obj/structure/sauna_oven,
/turf/open/floor/wood/tile,
/area/misc/hilbertshotel)
"Tp" = (
/obj/structure/reagent_dispensers/watertank,
/obj/structure/window/reinforced/tinted/spawner/directional/south,
/turf/open/floor/iron,
/area/misc/hilbertshotel)
"TH" = (
/obj/structure/mineral_door/paperframe{
	name = "Changing Room";
	dir = 4
	},
/turf/open/floor/wood,
/area/misc/hilbertshotel)
"Ur" = (
/obj/structure/fans/tiny/invisible,
/turf/open/floor/iron,
/area/misc/hilbertshotel)
"UJ" = (
/obj/structure/closet/crate/wooden,
/obj/item/stack/sheet/mineral/wood/fifty,
/obj/item/reagent_containers/cup/bucket/wooden,
/turf/open/floor/iron,
/area/misc/hilbertshotel)
"UR" = (
/obj/effect/turf_decal/siding/wood{
	dir = 1
	},
/obj/item/kirbyplants/random,
/turf/open/floor/carpet/royalblue,
/area/misc/hilbertshotel)
"Vk" = (
/obj/structure/table/bronze,
/turf/open/floor/wood/tile,
/area/misc/hilbertshotel)
"Wj" = (
/obj/structure/chair/pew{
	dir = 8
	},
/turf/open/floor/wood/tile,
/area/misc/hilbertshotel)
"WQ" = (
/obj/structure/drain/big,
/turf/open/floor/iron,
/area/misc/hilbertshotel)
"XH" = (
/obj/effect/turf_decal/siding/wood,
/obj/machinery/light/warm/directional/south,
/turf/open/floor/carpet/royalblue,
/area/misc/hilbertshotel)
"Ym" = (
/obj/effect/turf_decal/trimline/white/filled/line{
	dir = 5
	},
/obj/effect/spawner/liquids_spawner/shoulders,
/turf/open/floor/iron/pool,
/area/misc/hilbertshotel)
"Zm" = (
/obj/effect/turf_decal/siding/wood,
/turf/open/floor/carpet/royalblue,
/area/misc/hilbertshotel)

(1,1,1) = {"
OE
OE
OE
OE
OE
GJ
OE
OE
OE
OE
OE
OE
OE
OE
OE
OE
"}
(2,1,1) = {"
OE
tS
hJ
Kz
FQ
ne
iJ
FQ
xp
CU
OQ
rb
OQ
CU
Gs
OE
"}
(3,1,1) = {"
OE
tS
hJ
hJ
FQ
gV
Zm
FQ
Sv
Gf
Gf
Gf
Gf
Gf
Rz
OE
"}
(4,1,1) = {"
OE
oR
hJ
tB
FQ
ml
tX
FQ
Ym
Gw
Gw
Gw
Gw
Gw
Kq
OE
"}
(5,1,1) = {"
OE
oR
hJ
hJ
FQ
vL
Zm
FQ
QS
zJ
zJ
RY
RY
oz
dm
OE
"}
(6,1,1) = {"
OE
oR
hJ
CY
FQ
vL
Zm
FQ
DO
zJ
fW
HN
fW
zJ
mc
OE
"}
(7,1,1) = {"
OE
FQ
pw
FQ
FQ
vL
xD
FQ
FQ
rX
FQ
FQ
FQ
FQ
FQ
OE
"}
(8,1,1) = {"
OE
zw
xC
xC
ix
ND
fH
xC
xU
xC
xC
xC
bd
xC
BQ
OE
"}
(9,1,1) = {"
OE
OW
Pn
pE
Pn
fy
QM
wy
ut
Pn
Pn
Pn
wy
Pn
fo
OE
"}
(10,1,1) = {"
OE
FQ
TH
FQ
FQ
UR
Zm
FQ
FQ
jX
FQ
FQ
FQ
FQ
OE
OE
"}
(11,1,1) = {"
OE
Rt
hJ
qm
FQ
Op
Zm
FQ
zJ
zJ
NG
jP
Dt
Aq
OE
Si
"}
(12,1,1) = {"
OE
wD
uG
fb
FQ
LP
Zm
FQ
Gm
zJ
NG
nJ
nJ
Vk
OE
ki
"}
(13,1,1) = {"
OE
CZ
PD
ly
FQ
gS
XH
FQ
fG
WQ
Ur
nJ
qi
Sx
OE
ki
"}
(14,1,1) = {"
OE
PD
PD
MT
FQ
tF
Zm
FQ
Gm
zJ
NG
nJ
nJ
Vk
OE
ki
"}
(15,1,1) = {"
OE
aN
Ml
NC
FQ
Ph
Au
FQ
gP
UJ
Tp
EW
Wj
qv
OE
ki
"}
(16,1,1) = {"
OE
OE
OE
OE
OE
OE
OE
OE
OE
OE
OE
OE
OE
OE
OE
OE
"}
