//MAP CONVERTED BY dmm2tgm.py THIS HEADER COMMENT PREVENTS RECONVERSION, DO NOT REMOVE
"ax" = (
/obj/effect/turf_decal/trimline/dark_red/filled/warning{
	dir = 6
	},
/turf/open/floor/iron/white,
/area/misc/hilbertshotel)
"bn" = (
/obj/effect/turf_decal/siding/wood{
	dir = 9
	},
/obj/machinery/vending/dorms,
/obj/machinery/camera/directional/north{
	network = list("prison-dorm");
	c_tag = "Cell Access"
	},
/turf/open/floor/iron/dark,
/area/misc/hilbertshotel)
"bE" = (
/obj/machinery/jukebox,
/obj/machinery/light/small/directional/south,
/obj/effect/turf_decal/trimline/white/filled/line,
/turf/open/floor/iron,
/area/misc/hilbertshotel)
"bG" = (
/obj/structure/toilet{
	dir = 4
	},
/obj/structure/window/reinforced/tinted/spawner/directional/south,
/turf/open/floor/iron/freezer,
/area/misc/hilbertshotel)
"cd" = (
/obj/structure/lattice/catwalk,
/obj/structure/railing{
	dir = 1;
	icon_state = "railing"
	},
/obj/structure/railing,
/turf/open/misc/grass/jungle/station,
/area/misc/hilbertshotel)
"ds" = (
/obj/structure/chair/office{
	dir = 4;
	pixel_x = 9
	},
/turf/open/floor/iron/cafeteria,
/area/misc/hilbertshotel)
"eO" = (
/obj/effect/spawner/random/entertainment/arcade{
	dir = 8
	},
/obj/effect/turf_decal/trimline/white/filled/line{
	dir = 4
	},
/turf/open/floor/iron,
/area/misc/hilbertshotel)
"go" = (
/obj/structure/closet/secure_closet/freezer/kitchen{
	req_access = null
	},
/obj/effect/turf_decal/bot_white,
/obj/item/storage/box/ingredients/carnivore,
/obj/item/storage/box/ingredients/wildcard,
/obj/item/storage/fancy/egg_box,
/turf/open/floor/iron/cafeteria,
/area/misc/hilbertshotel)
"gr" = (
/obj/structure/table,
/obj/item/camera{
	pixel_y = 11
	},
/obj/item/camera_film{
	pixel_x = 9;
	pixel_y = 7
	},
/obj/effect/turf_decal/siding/wood{
	dir = 10
	},
/obj/item/restraints/handcuffs/lewd{
	pixel_y = 4;
	pixel_x = -3
	},
/obj/item/restraints/handcuffs/lewd,
/turf/open/floor/iron/dark,
/area/misc/hilbertshotel)
"gE" = (
/obj/effect/turf_decal/trimline/white/filled/line{
	dir = 1
	},
/turf/open/floor/iron,
/area/misc/hilbertshotel)
"hw" = (
/obj/effect/turf_decal/tile/red/half/contrasted{
	dir = 4
	},
/turf/open/floor/iron/dark,
/area/misc/hilbertshotel)
"hx" = (
/obj/item/clothing/shoes/jackboots,
/obj/structure/closet/secure_closet/personal,
/obj/effect/turf_decal/bot,
/obj/item/clothing/under/rank/security/officer{
	armor = null
	},
/obj/effect/turf_decal/tile/red/anticorner/contrasted{
	dir = 1
	},
/turf/open/floor/iron/dark,
/area/misc/hilbertshotel)
"ig" = (
/obj/effect/turf_decal/trimline/white/filled/warning{
	dir = 1
	},
/turf/open/floor/iron,
/area/misc/hilbertshotel)
"iV" = (
/obj/effect/turf_decal/tile/yellow/anticorner/contrasted,
/turf/open/floor/iron,
/area/misc/hilbertshotel)
"iW" = (
/turf/open/floor/iron,
/area/misc/hilbertshotel)
"kx" = (
/obj/structure/table,
/obj/item/storage/fancy/heart_box,
/turf/open/floor/iron/cafeteria,
/area/misc/hilbertshotel)
"lA" = (
/obj/structure/table,
/obj/item/restraints/handcuffs,
/obj/effect/turf_decal/tile/red/anticorner/contrasted{
	dir = 4
	},
/turf/open/floor/iron/dark,
/area/misc/hilbertshotel)
"lE" = (
/obj/machinery/light/directional/west,
/obj/effect/turf_decal/tile/red/anticorner/contrasted{
	dir = 8
	},
/turf/open/floor/iron,
/area/misc/hilbertshotel)
"lL" = (
/obj/structure/chair/office{
	dir = 8;
	pixel_x = -9
	},
/turf/open/floor/iron/cafeteria,
/area/misc/hilbertshotel)
"lN" = (
/obj/structure/bed{
	dir = 1;
	pixel_y = 3
	},
/obj/structure/bed{
	dir = 1;
	pixel_y = 15
	},
/obj/structure/railing{
	dir = 4;
	icon_state = "railing";
	pixel_x = -28
	},
/obj/structure/railing{
	dir = 8;
	pixel_x = 30
	},
/turf/open/floor/iron/dark,
/area/misc/hilbertshotel)
"lU" = (
/obj/structure/table,
/obj/item/assembly/signaler{
	pixel_x = 7;
	pixel_y = 9
	},
/obj/effect/turf_decal/siding/wood{
	dir = 6
	},
/obj/item/clothing/sextoy/dildo/custom_dildo,
/obj/item/clothing/sextoy/dildo/double_dildo,
/turf/open/floor/iron/dark,
/area/misc/hilbertshotel)
"mk" = (
/turf/closed/indestructible/steel,
/area/misc/hilbertshotel)
"mC" = (
/obj/structure/flora/rock/pile,
/obj/structure/flora/bush/jungle/a/style_random,
/turf/open/misc/grass/jungle/station,
/area/misc/hilbertshotel)
"nC" = (
/obj/machinery/light/floor,
/obj/structure/flora/bush/large/style_random,
/turf/open/misc/grass/jungle/station,
/area/misc/hilbertshotel)
"ot" = (
/obj/structure/closet/secure_closet/personal{
	name = "prisoner closet"
	},
/obj/effect/turf_decal/bot_white,
/obj/item/clothing/under/rank/prisoner/skirt,
/obj/item/clothing/under/rank/prisoner,
/obj/item/clothing/shoes/sneakers/orange,
/obj/effect/turf_decal/tile/red/anticorner/contrasted{
	dir = 8
	},
/turf/open/floor/iron,
/area/misc/hilbertshotel)
"oL" = (
/turf/closed/wall,
/area/misc/hilbertshotel)
"oY" = (
/obj/machinery/light/small/directional/north,
/turf/open/floor/iron/white,
/area/misc/hilbertshotel)
"qI" = (
/obj/structure/bed{
	pixel_y = 3
	},
/obj/effect/decal/cleanable/cobweb/cobweb2,
/obj/machinery/light/directional/north,
/turf/open/floor/iron/dark,
/area/misc/hilbertshotel)
"rw" = (
/obj/structure/flora/tree/jungle/small/style_random,
/turf/open/misc/grass/jungle/station,
/area/misc/hilbertshotel)
"ry" = (
/obj/structure/railing{
	dir = 5;
	icon_state = "railing"
	},
/obj/structure/lattice/catwalk,
/turf/open/misc/grass/jungle/station,
/area/misc/hilbertshotel)
"st" = (
/obj/structure/flora/bush/jungle/c/style_random,
/turf/open/misc/grass/jungle/station,
/area/misc/hilbertshotel)
"sQ" = (
/obj/structure/flora/bush/large/style_random,
/turf/open/misc/grass/jungle/station,
/area/misc/hilbertshotel)
"tm" = (
/obj/machinery/door/airlock/centcom,
/turf/open/floor/iron,
/area/misc/hilbertshotel)
"tz" = (
/obj/structure/table,
/obj/item/storage/fancy/donut_box{
	pixel_x = -3
	},
/obj/effect/turf_decal/tile/red/anticorner/contrasted,
/turf/open/floor/iron/dark,
/area/misc/hilbertshotel)
"ue" = (
/obj/machinery/hydroponics/soil{
	pixel_y = 5
	},
/obj/effect/turf_decal/siding/wood,
/obj/effect/turf_decal/siding/wood{
	dir = 8
	},
/turf/open/misc/grass,
/area/misc/hilbertshotel)
"uy" = (
/obj/structure/table,
/obj/machinery/camera/directional/south{
	network = list("prison-dorm");
	c_tag = "Security Equipment"
	},
/obj/effect/turf_decal/tile/red/half/contrasted,
/turf/open/floor/iron/dark,
/area/misc/hilbertshotel)
"wd" = (
/turf/open/misc/grass/jungle/station,
/area/misc/hilbertshotel)
"wR" = (
/obj/structure/sink/directional/south,
/obj/effect/turf_decal/trimline/white/filled/line{
	dir = 1
	},
/turf/open/floor/iron,
/area/misc/hilbertshotel)
"wT" = (
/turf/open/floor/iron/freezer,
/area/misc/hilbertshotel)
"xv" = (
/obj/structure/table,
/obj/machinery/button/door{
	id = "prison-window_dorm";
	name = "Prison windows";
	pixel_y = -2;
	pixel_x = -7
	},
/obj/effect/turf_decal/tile/red/anticorner/contrasted{
	dir = 8
	},
/turf/open/floor/iron/dark,
/area/misc/hilbertshotel)
"xU" = (
/obj/structure/rack,
/obj/effect/turf_decal/tile/red/anticorner/contrasted{
	dir = 4
	},
/turf/open/floor/iron/dark,
/area/misc/hilbertshotel)
"yn" = (
/obj/effect/turf_decal/siding/wood{
	dir = 5
	},
/turf/open/floor/wood,
/area/misc/hilbertshotel)
"yM" = (
/obj/structure/table,
/obj/item/book/manual/chef_recipes,
/turf/open/floor/iron/cafeteria,
/area/misc/hilbertshotel)
"ze" = (
/obj/effect/turf_decal/siding/wood{
	dir = 5
	},
/obj/machinery/vending/games{
	onstation = 0
	},
/turf/open/floor/wood,
/area/misc/hilbertshotel)
"zr" = (
/obj/structure/closet/secure_closet/personal{
	name = "prisoner closet"
	},
/obj/effect/turf_decal/bot_white,
/obj/item/clothing/under/rank/prisoner/skirt,
/obj/item/clothing/under/rank/prisoner,
/obj/item/clothing/shoes/sneakers/orange,
/obj/effect/turf_decal/tile/red/anticorner/contrasted,
/turf/open/floor/iron,
/area/misc/hilbertshotel)
"zz" = (
/obj/structure/chair/comfy/black,
/obj/effect/turf_decal/siding/wood{
	dir = 5
	},
/turf/open/floor/iron/dark,
/area/misc/hilbertshotel)
"zB" = (
/obj/effect/turf_decal/trimline/dark_red/filled/warning{
	dir = 4
	},
/turf/open/floor/iron/white,
/area/misc/hilbertshotel)
"zM" = (
/obj/machinery/light/floor,
/obj/structure/flora/rock/pile/jungle/style_random,
/turf/open/misc/grass/jungle/station,
/area/misc/hilbertshotel)
"zQ" = (
/obj/structure/curtain,
/turf/open/floor/iron/freezer,
/area/misc/hilbertshotel)
"zS" = (
/obj/machinery/door/airlock/centcom{
	name = "Cells Access";
	pixel_x = 0;
	pixel_y = 0;
	id_tag = "main-prison-door"
	},
/turf/open/floor/iron,
/area/misc/hilbertshotel)
"Az" = (
/obj/structure/railing{
	dir = 8
	},
/obj/structure/railing{
	dir = 10;
	icon_state = "railing"
	},
/obj/structure/lattice/catwalk,
/turf/open/misc/grass/jungle/station,
/area/misc/hilbertshotel)
"Bi" = (
/obj/structure/bookcase/random/adult,
/turf/open/floor/wood,
/area/misc/hilbertshotel)
"Bo" = (
/obj/structure/table,
/obj/machinery/light/directional/north,
/obj/effect/turf_decal/tile/red/half/contrasted{
	dir = 1
	},
/turf/open/floor/iron,
/area/misc/hilbertshotel)
"Bq" = (
/obj/effect/turf_decal/siding/wood{
	dir = 5
	},
/obj/structure/closet/crate/bin,
/obj/item/mop,
/obj/item/storage/bag/trash,
/turf/open/floor/wood,
/area/misc/hilbertshotel)
"BN" = (
/obj/effect/turf_decal/siding/wood{
	dir = 8
	},
/turf/open/floor/iron/dark,
/area/misc/hilbertshotel)
"Ch" = (
/obj/effect/turf_decal/tile/yellow/anticorner/contrasted{
	dir = 1
	},
/turf/open/floor/iron,
/area/misc/hilbertshotel)
"CB" = (
/obj/structure/table,
/obj/effect/turf_decal/siding/wood{
	dir = 1
	},
/obj/item/clothing/mask/leatherwhip,
/obj/item/clothing/head/domina_cap,
/obj/machinery/light/directional/north,
/turf/open/floor/iron/dark,
/area/misc/hilbertshotel)
"CS" = (
/turf/open/floor/iron/dark,
/area/misc/hilbertshotel)
"Da" = (
/obj/effect/turf_decal/siding/wood{
	dir = 4
	},
/turf/open/floor/iron/dark,
/area/misc/hilbertshotel)
"DV" = (
/obj/item/kitchen/fork,
/obj/structure/table,
/turf/open/floor/iron/cafeteria,
/area/misc/hilbertshotel)
"Et" = (
/obj/structure/flora/tree/jungle/style_random,
/obj/structure/flora/bush/jungle/a/style_random,
/turf/open/misc/grass/jungle/station,
/area/misc/hilbertshotel)
"EP" = (
/obj/structure/flora/tree/jungle/style_random,
/turf/open/misc/grass/jungle/station,
/area/misc/hilbertshotel)
"FG" = (
/obj/effect/decal/cleanable/cobweb,
/obj/structure/bed/maint,
/turf/open/floor/iron/white,
/area/misc/hilbertshotel)
"Gr" = (
/obj/effect/turf_decal/tile/red/half/contrasted,
/turf/open/floor/iron/dark,
/area/misc/hilbertshotel)
"GF" = (
/obj/machinery/seed_extractor,
/turf/open/floor/iron/cafeteria,
/area/misc/hilbertshotel)
"HY" = (
/obj/machinery/hydroponics/soil,
/obj/item/cultivator,
/obj/item/shovel/spade,
/obj/item/plant_analyzer,
/obj/effect/turf_decal/siding/wood{
	dir = 1
	},
/obj/effect/turf_decal/siding/wood{
	dir = 8
	},
/turf/open/misc/grass,
/area/misc/hilbertshotel)
"HZ" = (
/obj/machinery/microwave,
/obj/structure/table,
/turf/open/floor/iron/cafeteria,
/area/misc/hilbertshotel)
"Ik" = (
/obj/effect/turf_decal/tile/red/half/contrasted{
	dir = 4
	},
/turf/open/floor/iron,
/area/misc/hilbertshotel)
"IY" = (
/obj/structure/chair/stool,
/turf/open/floor/iron,
/area/misc/hilbertshotel)
"Kh" = (
/obj/structure/closet/secure_closet/personal{
	name = "prisoner closet"
	},
/obj/effect/turf_decal/bot_white,
/obj/item/clothing/under/rank/prisoner/skirt,
/obj/item/clothing/under/rank/prisoner,
/obj/item/clothing/shoes/sneakers/orange,
/obj/machinery/camera/directional/south{
	network = list("prison-dorm");
	c_tag = "Evidence Room"
	},
/obj/effect/turf_decal/tile/red/half/contrasted,
/turf/open/floor/iron,
/area/misc/hilbertshotel)
"Ko" = (
/obj/machinery/light/directional/north,
/obj/effect/turf_decal/tile/red/half/contrasted{
	dir = 1
	},
/turf/open/floor/iron/dark,
/area/misc/hilbertshotel)
"Kw" = (
/obj/structure/chair/stool,
/obj/effect/turf_decal/trimline/white/filled/line,
/turf/open/floor/iron,
/area/misc/hilbertshotel)
"Kx" = (
/obj/effect/turf_decal/tile/red/half/contrasted{
	dir = 8
	},
/turf/open/floor/iron,
/area/misc/hilbertshotel)
"KG" = (
/obj/effect/turf_decal/trimline/dark_red/filled/warning{
	dir = 5
	},
/turf/open/floor/iron/white,
/area/misc/hilbertshotel)
"KO" = (
/obj/item/soap/syndie,
/obj/machinery/shower/directional/east,
/turf/open/floor/iron/freezer,
/area/misc/hilbertshotel)
"Lj" = (
/obj/structure/mirror{
	pixel_y = 32
	},
/obj/machinery/light/small/directional/east,
/obj/structure/sink/directional/south,
/turf/open/floor/iron/freezer,
/area/misc/hilbertshotel)
"Ms" = (
/obj/machinery/light/floor,
/obj/structure/flora/rock/pile/jungle/style_random,
/obj/structure/flora/bush/jungle/b,
/turf/open/misc/grass/jungle/station,
/area/misc/hilbertshotel)
"MC" = (
/obj/item/flashlight/lamp/green{
	pixel_x = -2;
	pixel_y = 15
	},
/obj/machinery/camera/directional/north{
	dir = 9;
	network = list("prison-dorm");
	c_tag = "Barracks"
	},
/obj/structure/dresser,
/turf/open/floor/iron/dark,
/area/misc/hilbertshotel)
"MP" = (
/obj/structure/table/wood,
/obj/item/flashlight/lamp/green{
	pixel_x = -10
	},
/obj/effect/turf_decal/siding/wood/corner{
	dir = 4
	},
/turf/open/floor/wood,
/area/misc/hilbertshotel)
"Na" = (
/obj/structure/closet/crate/hydroponics,
/obj/item/paper/guides/jobs/hydroponics,
/obj/item/seeds/onion,
/obj/item/seeds/garlic,
/obj/item/seeds/potato,
/obj/item/seeds/tomato,
/obj/item/seeds/carrot,
/obj/item/seeds/grass,
/obj/item/seeds/ambrosia,
/obj/item/seeds/wheat,
/obj/item/seeds/pumpkin,
/obj/item/seeds/wheat,
/obj/item/seeds/wheat,
/obj/structure/window/reinforced/tinted/spawner/directional/south,
/obj/effect/turf_decal/trimline/white/filled/line{
	dir = 5
	},
/turf/open/floor/iron,
/area/misc/hilbertshotel)
"NI" = (
/turf/open/floor/iron/white,
/area/misc/hilbertshotel)
"Pf" = (
/obj/item/kirbyplants/random,
/obj/effect/turf_decal/trimline/white/filled/line,
/obj/effect/turf_decal/stripes/corner{
	dir = 8
	},
/turf/open/floor/iron,
/area/misc/hilbertshotel)
"Pg" = (
/obj/structure/table,
/obj/item/wrench,
/obj/item/screwdriver,
/obj/machinery/camera/directional/north{
	dir = 9;
	network = list("prison-dorm");
	c_tag = "Aux Storage"
	},
/obj/effect/turf_decal/tile/red/anticorner/contrasted{
	dir = 1
	},
/turf/open/floor/iron/dark,
/area/misc/hilbertshotel)
"PG" = (
/turf/closed/indestructible/hoteldoor{
	icon_state = "door_closed";
	icon = 'icons/obj/doors/puzzledoor/default.dmi'
	},
/area/misc/hilbertshotel)
"Rn" = (
/obj/structure/spacevine,
/turf/closed/indestructible/rock,
/area/misc/hilbertshotel)
"Rw" = (
/obj/machinery/camera/directional/east{
	network = list("prison-dorm");
	c_tag = "Holding Cell"
	},
/turf/open/floor/iron/white,
/area/misc/hilbertshotel)
"RH" = (
/obj/machinery/biogenerator,
/turf/open/floor/iron/cafeteria,
/area/misc/hilbertshotel)
"RP" = (
/obj/structure/table,
/obj/effect/decal/cleanable/cobweb/cobweb2,
/obj/item/clothing/glasses/blindfold/kinky,
/obj/item/clothing/glasses/blindfold/kinky,
/obj/item/clothing/glasses/blindfold/kinky,
/obj/effect/turf_decal/tile/red/anticorner/contrasted{
	dir = 4
	},
/obj/item/clothing/mask/ballgag,
/obj/item/clothing/mask/ballgag,
/obj/item/clothing/mask/ballgag,
/turf/open/floor/iron,
/area/misc/hilbertshotel)
"RS" = (
/obj/structure/table,
/obj/effect/turf_decal/tile/red/half/contrasted{
	dir = 4
	},
/turf/open/floor/iron/dark,
/area/misc/hilbertshotel)
"Si" = (
/obj/structure/table,
/obj/item/storage/box/prisoner{
	pixel_y = 4
	},
/obj/machinery/room_controller/directional/west,
/obj/effect/turf_decal/tile/red/anticorner/contrasted{
	dir = 1
	},
/turf/open/floor/iron,
/area/misc/hilbertshotel)
"Sr" = (
/obj/effect/spawner/structure/window/reinforced,
/turf/open/floor/plating,
/area/misc/hilbertshotel)
"St" = (
/obj/effect/turf_decal/tile/yellow/anticorner/contrasted{
	dir = 4
	},
/turf/open/floor/iron,
/area/misc/hilbertshotel)
"SW" = (
/obj/structure/railing{
	dir = 8
	},
/obj/structure/lattice/catwalk,
/turf/open/misc/grass/jungle/station,
/area/misc/hilbertshotel)
"Tx" = (
/obj/structure/railing,
/obj/structure/lattice/catwalk,
/turf/open/misc/grass/jungle/station,
/area/misc/hilbertshotel)
"TF" = (
/obj/effect/turf_decal/trimline/white/filled/line,
/obj/effect/turf_decal/stripes/line,
/turf/open/floor/iron,
/area/misc/hilbertshotel)
"TH" = (
/obj/structure/table,
/obj/item/storage/bag/tray/cafeteria,
/obj/item/storage/bag/tray/cafeteria,
/obj/item/storage/bag/tray/cafeteria,
/obj/item/storage/bag/tray/cafeteria,
/obj/machinery/light/directional/north,
/turf/open/floor/iron/cafeteria,
/area/misc/hilbertshotel)
"UC" = (
/obj/machinery/door/airlock/centcom{
	name = "Cells Access";
	pixel_x = 0;
	pixel_y = 0;
	id_tag = "main-prison-door"
	},
/turf/open/floor/iron/white,
/area/misc/hilbertshotel)
"UQ" = (
/obj/machinery/door/airlock/centcom{
	name = "Equipment Room"
	},
/turf/open/floor/iron,
/area/misc/hilbertshotel)
"Vd" = (
/obj/structure/railing{
	dir = 8
	},
/obj/structure/railing{
	dir = 4;
	icon_state = "railing"
	},
/obj/structure/lattice/catwalk,
/turf/open/misc/grass/jungle/station,
/area/misc/hilbertshotel)
"Vu" = (
/obj/structure/rack,
/obj/effect/turf_decal/tile/red/anticorner/contrasted{
	dir = 8
	},
/turf/open/floor/iron/dark,
/area/misc/hilbertshotel)
"Vz" = (
/obj/effect/turf_decal/siding/wood,
/obj/item/clothing/erp_leash,
/obj/structure/table,
/turf/open/floor/iron/dark,
/area/misc/hilbertshotel)
"VZ" = (
/obj/effect/turf_decal/tile/yellow/anticorner/contrasted{
	dir = 8
	},
/turf/open/floor/iron,
/area/misc/hilbertshotel)
"Wc" = (
/obj/machinery/telecomms/relay/preset/auto,
/turf/open/floor/catwalk_floor,
/area/misc/hilbertshotel)
"WI" = (
/obj/machinery/door/poddoor/preopen{
	id = "prison-window_dorm"
	},
/obj/effect/spawner/structure/window/reinforced,
/turf/open/floor/plating,
/area/misc/hilbertshotel)
"WX" = (
/obj/structure/lattice/catwalk,
/obj/structure/railing{
	dir = 1;
	icon_state = "railing"
	},
/obj/structure/rack,
/turf/open/misc/grass/jungle/station,
/area/misc/hilbertshotel)
"Xj" = (
/obj/item/storage/box/drinkingglasses,
/obj/item/kitchen/rollingpin,
/obj/structure/table,
/obj/machinery/camera/directional/north{
	dir = 9;
	network = list("prison-dorm");
	c_tag = "Cafeteria"
	},
/turf/open/floor/iron/cafeteria,
/area/misc/hilbertshotel)
"Xr" = (
/obj/structure/rack,
/obj/effect/turf_decal/tile/red/anticorner/contrasted,
/turf/open/floor/iron/dark,
/area/misc/hilbertshotel)
"Yn" = (
/obj/machinery/light/directional/east,
/obj/effect/turf_decal/tile/red/anticorner/contrasted,
/turf/open/floor/iron,
/area/misc/hilbertshotel)
"YK" = (
/obj/machinery/camera/directional/south{
	network = list("prison-dorm");
	c_tag = "Holding Room"
	},
/obj/structure/table/wood,
/obj/item/paper_bin,
/obj/machinery/light/small/directional/south,
/obj/effect/turf_decal/siding/wood/corner{
	dir = 4
	},
/turf/open/floor/wood,
/area/misc/hilbertshotel)
"Zr" = (
/obj/machinery/light/directional/north,
/obj/effect/turf_decal/tile/red/half/contrasted{
	dir = 1
	},
/obj/machinery/computer/camera_advanced{
	networks = list("prison-dorm")
	},
/turf/open/floor/iron/dark,
/area/misc/hilbertshotel)
"ZC" = (
/obj/structure/flora/bush/jungle/a/style_random,
/turf/open/misc/grass/jungle/station,
/area/misc/hilbertshotel)
"ZL" = (
/obj/effect/spawner/random/entertainment/arcade{
	dir = 8
	},
/obj/effect/turf_decal/trimline/white/filled/line{
	dir = 6
	},
/turf/open/floor/iron,
/area/misc/hilbertshotel)

(1,1,1) = {"
Wc
Rn
Rn
Rn
Rn
PG
Rn
Rn
Rn
Rn
Rn
Rn
mk
mk
mk
mk
"}
(2,1,1) = {"
Rn
Rn
zM
sQ
st
cd
nC
wd
wd
Et
zM
Rn
oL
FG
NI
mk
"}
(3,1,1) = {"
mk
oL
oL
oL
rw
ry
Vd
Vd
SW
Az
ZC
Rn
oL
oY
Rw
mk
"}
(4,1,1) = {"
mk
bG
KO
oL
ZC
EP
Ms
st
WX
Tx
Rn
oL
oL
UC
oL
mk
"}
(5,1,1) = {"
mk
Lj
wT
oL
Rn
mC
sQ
oL
oL
tm
oL
oL
KG
zB
ax
mk
"}
(6,1,1) = {"
mk
oL
zQ
oL
oL
WI
WI
oL
Si
Kx
ot
oL
bn
BN
gr
mk
"}
(7,1,1) = {"
mk
lN
iW
Sr
Bq
MP
Bi
oL
Bo
iW
Kh
oL
CB
CS
Vz
mk
"}
(8,1,1) = {"
mk
MC
iW
zS
ig
yn
YK
oL
RP
iW
zr
oL
zz
Da
lU
mk
"}
(9,1,1) = {"
mk
qI
iW
Sr
gE
iW
ze
oL
oL
tm
oL
oL
oL
zS
oL
mk
"}
(10,1,1) = {"
mk
oL
oL
oL
wR
iW
TF
zS
Kx
iW
Kx
lE
Ch
iW
VZ
mk
"}
(11,1,1) = {"
mk
HZ
DV
go
ig
iW
TF
zS
Ik
iW
Ik
Yn
St
iW
iV
mk
"}
(12,1,1) = {"
mk
Xj
ds
ds
ig
iW
Pf
oL
oL
UQ
oL
oL
oL
UQ
oL
mk
"}
(13,1,1) = {"
mk
TH
kx
yM
ig
iW
bE
oL
hx
CS
xv
oL
Pg
CS
Vu
mk
"}
(14,1,1) = {"
mk
GF
lL
lL
ig
IY
Kw
oL
Zr
CS
uy
oL
Ko
CS
Gr
mk
"}
(15,1,1) = {"
mk
RH
HY
ue
Na
eO
ZL
oL
xU
RS
tz
oL
lA
hw
Xr
mk
"}
(16,1,1) = {"
mk
mk
mk
mk
mk
mk
mk
mk
mk
mk
mk
mk
mk
mk
mk
mk
"}
