"a" = (/turf/closed/wall/r_wall,/area/station/science/auxlab/firing_range)
"b" = (/obj/machinery/light/warm/directional/south,/turf/open/floor/stone,/area/station/science/auxlab/firing_range)
"c" = (/obj/effect/turf_decal/trimline/dark_red/filled/line,/obj/machinery/door/window/right/directional/north{name = "Deliveries"; req_access = list("mineral_storeroom")},/obj/structure/window/reinforced/spawner/east,/obj/structure/window/reinforced/spawner/west,/obj/structure/table/wood,/turf/open/floor/iron/dark/smooth_large,/area/station/science/auxlab/firing_range)
"d" = (/obj/structure/reagent_forge,/turf/open/floor/stone,/area/station/science/auxlab/firing_range)
"e" = (/obj/effect/turf_decal/trimline/dark_red/filled/line{dir = 10},/obj/machinery/door/window/right/directional/north{name = "Deliveries"; req_access = list("mineral_storeroom")},/obj/structure/window/reinforced/spawner/east,/obj/structure/window/reinforced/spawner/west,/obj/structure/table/wood,/turf/open/floor/iron/dark/smooth_large,/area/station/science/auxlab/firing_range)
"f" = (/obj/effect/turf_decal/trimline/dark_red/filled/line{dir = 6},/obj/machinery/door/window/right/directional/north{name = "Deliveries"; req_access = list("mineral_storeroom")},/obj/structure/window/reinforced/spawner/west,/obj/structure/window/reinforced/spawner/east,/obj/structure/table/wood,/turf/open/floor/iron/dark/smooth_large,/area/station/science/auxlab/firing_range)
"g" = (/obj/machinery/airalarm/directional/north,/obj/effect/turf_decal/trimline/dark_red/filled/line{dir = 5},/obj/machinery/light_switch/directional/east,/obj/effect/turf_decal/bot,/obj/machinery/door/window/right/directional/south{req_access = list("mineral_storeroom")},/obj/structure/window/reinforced/spawner/west,/obj/structure/window/reinforced/spawner/east,/obj/structure/table/wood,/turf/open/floor/iron/dark/smooth_large,/area/station/science/auxlab/firing_range)
"h" = (/obj/effect/turf_decal/stripes/line{dir = 8},/turf/open/floor/stone,/area/station/science/auxlab/firing_range)
"i" = (/obj/effect/turf_decal/stripes/line{dir = 8},/obj/machinery/atmospherics/pipe/smart/manifold4w/scrubbers/hidden/layer2,/obj/effect/turf_decal/caution/stand_clear/red{dir = 4},/turf/open/floor/stone,/area/station/science/auxlab/firing_range)
"j" = (/obj/machinery/light/warm/directional/south,/obj/structure/window/reinforced/fulltile,/turf/open/floor/engine,/area/station/science/auxlab/firing_range)
"l" = (/obj/machinery/atmospherics/pipe/smart/manifold4w/scrubbers/hidden/layer2,/obj/machinery/atmospherics/pipe/smart/manifold4w/supply/hidden/layer4,/obj/effect/turf_decal/loading_area/red{dir = 8},/turf/open/floor/stone,/area/station/science/auxlab/firing_range)
"n" = (/obj/machinery/atmospherics/pipe/smart/manifold4w/supply/hidden/layer4,/turf/open/floor/stone,/area/station/science/auxlab/firing_range)
"o" = (/obj/machinery/atmospherics/components/unary/vent_pump/on/layer4{dir = 1},/obj/effect/turf_decal/trimline/dark_red/filled/warning{dir = 4},/turf/open/floor/iron/dark/smooth_large,/area/station/science/auxlab/firing_range)
"p" = (/obj/effect/turf_decal/trimline/dark_red/filled/line{dir = 1},/obj/structure/extinguisher_cabinet/directional/north{pixel_x = 6},/obj/machinery/firealarm/directional/north{pixel_x = -7},/obj/machinery/door/window/right/directional/south{req_access = list("mineral_storeroom")},/obj/structure/window/reinforced/spawner/east,/obj/structure/window/reinforced/spawner/west,/obj/structure/table/wood,/turf/open/floor/iron/dark/smooth_large,/area/station/science/auxlab/firing_range)
"q" = (/obj/machinery/atmospherics/pipe/smart/manifold4w/scrubbers/hidden/layer2,/obj/machinery/atmospherics/pipe/smart/manifold4w/supply/hidden/layer4,/obj/structure/cable,/turf/open/floor/iron/dark/smooth_large,/area/station/science/auxlab/firing_range)
"r" = (/obj/effect/turf_decal/stripes/line{dir = 8},/obj/machinery/requests_console/auto_name/directional/south,/obj/machinery/camera/directional/south{c_tag = "Firing Range"; name = "dormitories camera"},/turf/open/floor/stone,/area/station/science/auxlab/firing_range)
"s" = (/obj/machinery/atmospherics/pipe/smart/manifold4w/scrubbers/hidden/layer2,/obj/structure/table/wood,/obj/machinery/reagentgrinder,/turf/open/floor/stone,/area/station/science/auxlab/firing_range)
"u" = (/obj/machinery/light/warm/directional/north,/obj/structure/reagent_water_basin,/turf/open/floor/stone,/area/station/science/auxlab/firing_range)
"x" = (/obj/machinery/power/apc/auto_name/directional/north,/obj/structure/cable,/obj/effect/turf_decal/trimline/dark_red/filled/line{dir = 9},/obj/machinery/door/window/right/directional/south{req_access = list("mineral_storeroom")},/obj/structure/window/reinforced/spawner/east,/obj/structure/window/reinforced/spawner/west,/obj/structure/table/wood,/turf/open/floor/iron/dark/smooth_large,/area/station/science/auxlab/firing_range)
"z" = (/obj/structure/flora/grass/jungle,/obj/structure/window/fulltile,/turf/open/floor/grass,/area/station/science/auxlab/firing_range)
"A" = (/obj/machinery/atmospherics/components/unary/vent_scrubber/on/layer2{dir = 1},/obj/effect/turf_decal/trimline/dark_red/filled/warning{dir = 8},/turf/open/floor/iron/dark/smooth_large,/area/station/science/auxlab/firing_range)
"B" = (/turf/open/floor/stone,/area/station/science/auxlab/firing_range)
"D" = (/obj/machinery/atmospherics/components/unary/vent_scrubber/on/layer2{dir = 4},/obj/structure/reagent_crafting_bench,/turf/open/floor/stone,/area/station/science/auxlab/firing_range)
"F" = (/obj/machinery/atmospherics/pipe/smart/manifold4w/scrubbers/hidden/layer2,/obj/effect/turf_decal/stripes/red/line{dir = 4},/obj/item/reagent_containers/cup/beaker/large,/obj/item/reagent_containers/cup/beaker/large,/obj/item/reagent_containers/cup/primitive_centrifuge,/obj/structure/closet/crate/wooden,/obj/item/wrench/makeshift,/turf/open/floor/stone,/area/station/science/auxlab/firing_range)
"H" = (/obj/machinery/door/firedoor,/obj/effect/turf_decal/stripes/line{dir = 4},/obj/effect/turf_decal/stripes/line{dir = 8},/turf/open/floor/iron/dark/smooth_large,/area/station/science/auxlab/firing_range)
"I" = (/obj/machinery/atmospherics/components/unary/vent_pump/on/layer4{dir = 4},/turf/open/floor/stone,/area/station/science/auxlab/firing_range)
"J" = (/obj/structure/reagent_anvil,/turf/open/floor/stone,/area/station/science/auxlab/firing_range)
"K" = (/obj/machinery/atmospherics/pipe/smart/manifold4w/scrubbers/hidden/layer2,/obj/effect/turf_decal/stripes/red/line{dir = 4},/turf/open/floor/stone,/area/station/science/auxlab/firing_range)
"L" = (/turf/closed/wall/mineral/plastitanium/nodiagonal,/area/station/science/auxlab/firing_range)
"M" = (/obj/machinery/atmospherics/pipe/smart/manifold4w/scrubbers/hidden/layer2,/obj/machinery/atmospherics/pipe/smart/manifold4w/supply/hidden/layer4,/obj/structure/cable,/obj/effect/turf_decal/trimline/dark_red/filled/warning{dir = 4},/turf/open/floor/iron/dark/smooth_large,/area/station/science/auxlab/firing_range)
"N" = (/obj/effect/landmark/start/blacksmith,/turf/open/floor/stone,/area/station/science/auxlab/firing_range)
"P" = (/obj/structure/closet/crate/miningcar,/obj/item/stack/rods/fifty{pixel_x = -1; pixel_y = 3},/obj/item/stack/sheet/glass/fifty{pixel_x = -13; pixel_y = 3},/obj/item/stack/sheet/iron/fifty{pixel_x = 9; pixel_y = 3},/obj/item/stack/sheet/mineral/coal/ten,/obj/item/stack/sheet/mineral/coal/ten,/obj/item/stack/sheet/mineral/coal/ten,/obj/item/stack/sheet/mineral/coal/ten,/obj/item/stack/sheet/mineral/coal/ten,/obj/item/stack/sheet/mineral/wood/fifty,/obj/structure/railroad,/obj/item/weaponcrafting/silkstring,/obj/item/weaponcrafting/silkstring,/obj/item/weaponcrafting/silkstring,/obj/item/weaponcrafting/silkstring,/obj/item/weaponcrafting/silkstring,/obj/item/stack/sheet/sinew,/obj/item/stack/sheet/sinew,/obj/item/stack/sheet/sinew,/obj/item/stack/sheet/sinew,/obj/item/stack/sheet/leather,/obj/item/stack/sheet/leather,/obj/item/stack/sheet/leather,/obj/item/stack/sheet/leather,/obj/item/stack/sheet/leather,/obj/item/stack/sheet/leather,/obj/item/stack/sheet/leather,/obj/item/stack/sheet/leather,/obj/item/stack/sheet/leather,/obj/item/stack/sheet/leather,/obj/item/stack/sheet/leather,/obj/item/stack/sheet/leather,/obj/item/stack/sheet/leather,/obj/item/stack/sheet/leather,/obj/item/stack/sheet/leather,/obj/item/stack/sheet/leather,/obj/item/stack/sheet/leather,/obj/item/stack/sheet/leather,/obj/item/stack/sheet/leather,/obj/item/stack/sheet/leather,/obj/item/stack/sheet/leather,/obj/item/stack/sheet/leather,/obj/item/stack/sheet/leather,/obj/item/stack/sheet/leather,/obj/item/stack/sheet/leather,/obj/item/stack/sheet/leather,/obj/item/stack/sheet/leather,/obj/item/stack/sheet/leather,/obj/item/stack/sheet/leather,/obj/item/stack/sheet/leather,/obj/item/stack/sheet/leather,/obj/item/stack/sheet/leather,/obj/item/stack/sheet/leather,/obj/item/stack/sheet/leather,/obj/item/stack/sheet/leather,/turf/open/floor/stone,/area/station/science/auxlab/firing_range)
"Q" = (/obj/machinery/atmospherics/pipe/smart/manifold4w/supply/hidden/layer4,/obj/effect/turf_decal/stripes/red/line{dir = 4},/turf/open/floor/stone,/area/station/science/auxlab/firing_range)
"S" = (/obj/machinery/holopad,/obj/effect/turf_decal/bot,/turf/open/floor/iron/dark/smooth_large,/area/station/science/auxlab/firing_range)
"T" = (/obj/machinery/atmospherics/pipe/smart/manifold4w/scrubbers/hidden/layer2,/obj/machinery/atmospherics/pipe/smart/manifold4w/supply/hidden/layer4,/obj/structure/cable,/obj/effect/turf_decal/trimline/dark_red/filled/warning{dir = 8},/turf/open/floor/iron/dark/smooth_large,/area/station/science/auxlab/firing_range)
"U" = (/obj/machinery/light/warm/directional/north,/obj/structure/window/reinforced/fulltile,/turf/open/floor/engine,/area/station/science/auxlab/firing_range)
"W" = (/obj/effect/turf_decal/stripes/line{dir = 8},/obj/machinery/atmospherics/pipe/smart/manifold4w/supply/hidden/layer4,/obj/effect/turf_decal/caution/stand_clear/red{dir = 4},/turf/open/floor/stone,/area/station/science/auxlab/firing_range)
"X" = (/obj/machinery/atmospherics/pipe/smart/manifold4w/supply/hidden/layer4,/obj/effect/turf_decal/loading_area/red{dir = 8},/obj/machinery/door/airlock/multi_tile/glass{dir = 4; name = "Cargo Lobby"; req_access = list("mineral_storeroom")},/turf/open/floor/stone,/area/station/science/auxlab/firing_range)
"Z" = (/obj/machinery/door/firedoor,/obj/machinery/atmospherics/pipe/smart/manifold4w/scrubbers/hidden/layer2,/obj/machinery/atmospherics/pipe/smart/manifold4w/supply/hidden/layer4,/obj/structure/cable,/obj/effect/turf_decal/stripes/line{dir = 4},/obj/effect/turf_decal/stripes/line{dir = 8},/turf/open/floor/iron/dark/smooth_large,/area/station/science/auxlab/firing_range)

(1,1,1) = {"
LduDsFhUxpga
LBBBBKilTqMZ
LNJBBQWXASoH
LPbInQrjecfa
aaaaaaaazzza
"}
