//MAP CONVERTED BY dmm2tgm.py THIS HEADER COMMENT PREVENTS RECONVERSION, DO NOT REMOVE
"a" = (
/obj/structure/closet/secure_closet/personal/cabinet,
/obj/item/clothing/under/rank/centcom/officer,
/obj/item/clothing/under/rank/centcom/officer_skirt,
/obj/item/clothing/under/rank/centcom/intern,
/obj/item/clothing/under/rank/centcom/commander,
/obj/item/clothing/under/rank/centcom/centcom_skirt,
/obj/item/clothing/head/hats/centcom_cap,
/obj/item/clothing/suit/hooded/wintercoat/centcom/nt_consultant,
/obj/item/clothing/head/hats/centhat,
/obj/item/radio/headset/heads/nanotrasen_consultant/alt,
/obj/item/clothing/glasses/sunglasses,
/obj/item/clothing/suit/armor/centcom_formal/nt_consultant,
/obj/item/clothing/suit/armor/centcom_formal,
/obj/machinery/newscaster/directional/east,
/turf/open/floor/wood,
/area/station/command/heads_quarters/nt_rep)
"b" = (
/obj/machinery/light/warm/directional/south,
/obj/machinery/requests_console/directional/south{
	name = "Nanotrasen Consultant's Requests Console";
	department = "Nanotrasen Consultant"
	},
/turf/open/floor/carpet/green,
/area/station/command/heads_quarters/nt_rep)
"c" = (
/obj/effect/mapping_helpers/airlock/access/all/cent_com/rep_door,
/obj/machinery/atmospherics/pipe/smart/manifold4w/scrubbers/hidden/layer2,
/obj/structure/cable,
/obj/machinery/atmospherics/pipe/smart/manifold4w/supply/hidden/layer4,
/obj/machinery/door/firedoor,
/obj/effect/turf_decal/siding/wood{
	dir = 1
	},
/obj/machinery/door/airlock/hatch{
	name = "Maintenance Hatch"
	},
/turf/open/floor/iron/dark/textured_large,
/area/station/command/heads_quarters/nt_rep)
"e" = (
/obj/structure/table/wood,
/obj/item/table_clock{
	pixel_y = 16;
	pixel_x = 3
	},
/obj/item/folder/blue{
	pixel_y = -2;
	pixel_x = -2
	},
/obj/item/pen/fourcolor{
	pixel_y = -2;
	pixel_x = -5
	},
/turf/open/floor/carpet/green,
/area/station/command/heads_quarters/nt_rep)
"g" = (
/obj/effect/turf_decal/siding/wood,
/obj/structure/chair/comfy/black,
/turf/open/floor/wood,
/area/station/command/heads_quarters/nt_rep)
"h" = (
/obj/effect/turf_decal/siding/wood{
	dir = 4
	},
/obj/machinery/photocopier,
/obj/machinery/power/apc/auto_name/directional/north,
/obj/structure/cable,
/obj/machinery/light/warm/directional/north,
/obj/effect/turf_decal/siding/wood/corner{
	dir = 8
	},
/turf/open/floor/wood,
/area/station/command/heads_quarters/nt_rep)
"i" = (
/obj/effect/turf_decal/siding/wood,
/obj/effect/turf_decal/siding/wood{
	dir = 1
	},
/turf/open/floor/wood,
/area/station/command/heads_quarters/nt_rep)
"j" = (
/obj/structure/chair/office/tactical{
	dir = 1
	},
/obj/structure/sign/flag/nanotrasen/directional/south,
/obj/effect/landmark/start/nanotrasen_consultant,
/turf/open/floor/carpet/green,
/area/station/command/heads_quarters/nt_rep)
"k" = (
/obj/effect/turf_decal/siding/wood{
	dir = 1
	},
/obj/structure/table/wood,
/obj/item/reagent_containers/cup/glass/bottle/champagne{
	pixel_y = 20;
	pixel_x = 6
	},
/obj/item/reagent_containers/cup/glass/drinkingglass/shotglass{
	pixel_y = 11;
	pixel_x = -4
	},
/obj/item/storage/fancy/cigarettes/cigars/cohiba{
	pixel_x = 4;
	pixel_y = 3
	},
/obj/item/lighter{
	pixel_x = 5;
	pixel_y = -4
	},
/turf/open/floor/wood,
/area/station/command/heads_quarters/nt_rep)
"l" = (
/obj/effect/turf_decal/siding/wood{
	dir = 4
	},
/turf/open/floor/wood,
/area/station/command/heads_quarters/nt_rep)
"q" = (
/obj/structure/table/wood,
/obj/machinery/button/door/directional/west{
	id = "nt_rep_maint";
	name = "Door Bolts Control";
	specialfunctions = 4;
	normaldoorcontrol = 1;
	pixel_y = -5
	},
/obj/item/stamp/centcom{
	pixel_x = -8;
	pixel_y = 8
	},
/obj/item/stamp/denied{
	pixel_x = -8;
	pixel_y = 4
	},
/obj/item/stamp{
	pixel_x = -8
	},
/obj/item/paper_bin{
	pixel_y = 4;
	pixel_x = 4
	},
/obj/item/pen/fountain{
	pixel_x = 4;
	pixel_y = 4
	},
/obj/machinery/button/door/directional/east{
	id = "nt_rep_priv";
	name = "Privacy Shutters Control";
	pixel_x = -24;
	pixel_y = 5
	},
/turf/open/floor/carpet/green,
/area/station/command/heads_quarters/nt_rep)
"r" = (
/obj/structure/table/wood,
/turf/open/floor/carpet/green,
/area/station/command/heads_quarters/nt_rep)
"s" = (
/obj/effect/turf_decal/siding/wood/corner{
	dir = 4
	},
/obj/machinery/atmospherics/pipe/smart/manifold4w/scrubbers/hidden/layer2,
/obj/structure/cable,
/obj/effect/turf_decal/siding/wood{
	dir = 8
	},
/turf/open/floor/wood,
/area/station/command/heads_quarters/nt_rep)
"t" = (
/obj/machinery/light_switch/directional/north,
/obj/machinery/disposal/bin,
/obj/structure/disposalpipe/trunk{
	dir = 4
	},
/turf/open/floor/wood,
/area/station/command/heads_quarters/nt_rep)
"u" = (
/obj/effect/turf_decal/siding/wood{
	dir = 8
	},
/obj/machinery/atmospherics/pipe/smart/manifold4w/scrubbers/hidden/layer2,
/obj/structure/cable,
/obj/machinery/atmospherics/pipe/smart/manifold4w/supply/hidden/layer4,
/turf/open/floor/wood,
/area/station/command/heads_quarters/nt_rep)
"v" = (
/obj/structure/closet/secure_closet/nanotrasen_consultant,
/obj/item/clothing/accessory/medal/silver/bureaucracy,
/obj/item/clothing/accessory/medal/gold/nanotrasen_consultant,
/obj/item/clothing/accessory/medal/gold/ordom,
/obj/item/storage/briefcase/central_command,
/turf/open/floor/wood,
/area/station/command/heads_quarters/nt_rep)
"w" = (
/turf/open/floor/wood,
/area/station/command/heads_quarters/nt_rep)
"x" = (
/obj/effect/turf_decal/siding/wood,
/obj/effect/turf_decal/siding/wood/corner{
	dir = 4
	},
/turf/open/floor/wood,
/area/station/command/heads_quarters/nt_rep)
"y" = (
/turf/closed/wall/r_wall,
/area/station/command/heads_quarters/nt_rep)
"z" = (
/obj/effect/turf_decal/siding/wood/corner,
/obj/structure/filingcabinet/medical{
	pixel_x = -10;
	icon_state = "employmentcabinet"
	},
/obj/structure/filingcabinet/employment,
/obj/structure/filingcabinet/security{
	pixel_x = 10;
	icon_state = "employmentcabinet"
	},
/turf/open/floor/wood,
/area/station/command/heads_quarters/nt_rep)
"A" = (
/obj/effect/turf_decal/siding/wood/corner{
	dir = 8
	},
/obj/machinery/atmospherics/pipe/smart/manifold4w/supply/hidden/layer4,
/obj/machinery/atmospherics/pipe/smart/manifold4w/scrubbers/hidden/layer2,
/obj/structure/cable,
/obj/effect/turf_decal/siding/wood/corner{
	dir = 1
	},
/turf/open/floor/wood,
/area/station/command/heads_quarters/nt_rep)
"B" = (
/obj/effect/turf_decal/siding/wood,
/obj/machinery/airalarm/directional/west,
/turf/open/floor/wood,
/area/station/command/heads_quarters/nt_rep)
"D" = (
/turf/template_noop,
/area/template_noop)
"E" = (
/obj/machinery/door/airlock/corporate{
	name = "Nanotrasen Consultant's Office";
	id_tag = "nt_rep_maint"
	},
/obj/structure/disposalpipe/segment,
/obj/machinery/door/firedoor,
/obj/effect/mapping_helpers/airlock/access/all/cent_com/rep_door,
/obj/effect/landmark/navigate_destination/autoname,
/obj/effect/mapping_helpers/airlock/unres,
/obj/effect/turf_decal/siding/wood,
/turf/open/floor/iron/dark/textured_large,
/area/station/command/heads_quarters/nt_rep)
"F" = (
/obj/effect/turf_decal/siding/wood{
	dir = 1
	},
/obj/machinery/atmospherics/pipe/smart/manifold4w/scrubbers/hidden/layer2,
/turf/open/floor/wood,
/area/station/command/heads_quarters/nt_rep)
"H" = (
/obj/machinery/camera/autoname/directional/east,
/obj/machinery/atmospherics/components/unary/vent_pump/on/layer4{
	dir = 8
	},
/turf/open/floor/wood,
/area/station/command/heads_quarters/nt_rep)
"I" = (
/obj/structure/extinguisher_cabinet/directional/east,
/obj/structure/sign/flag/galfed/directional/north,
/obj/effect/turf_decal/tile/neutral/fourcorners,
/obj/structure/bed/dogbed{
	name = "Lisa's bed"
	},
/mob/living/basic/pet/dog/corgi/lisa,
/turf/open/floor/iron/dark,
/area/station/command/heads_quarters/nt_rep)
"J" = (
/obj/effect/turf_decal/siding/wood{
	dir = 1
	},
/obj/structure/chair/comfy/black{
	dir = 1
	},
/obj/effect/landmark/start/nanotrasen_consultant,
/turf/open/floor/wood,
/area/station/command/heads_quarters/nt_rep)
"L" = (
/obj/machinery/firealarm/directional/west,
/obj/structure/table/wood/fancy/green,
/obj/item/statuebust{
	pixel_y = 8
	},
/turf/open/floor/wood,
/area/station/command/heads_quarters/nt_rep)
"O" = (
/obj/structure/fireplace,
/obj/effect/turf_decal/tile/neutral/fourcorners,
/turf/open/floor/iron/dark,
/area/station/command/heads_quarters/nt_rep)
"Q" = (
/obj/structure/table/wood,
/obj/effect/turf_decal/siding/wood,
/obj/machinery/fax{
	fax_name = "Nanotrasen Consultant's Office";
	name = "Nanotrasen Consultant's Fax Machine"
	},
/obj/structure/cable,
/turf/open/floor/wood,
/area/station/command/heads_quarters/nt_rep)
"R" = (
/obj/effect/spawner/structure/window/reinforced,
/obj/machinery/door/poddoor/shutters/preopen{
	id = "nt_rep_priv";
	name = "Privacy Shutters"
	},
/obj/structure/cable,
/turf/open/floor/plating,
/area/station/command/heads_quarters/nt_rep)
"T" = (
/obj/machinery/vending/boozeomat/all_access,
/turf/closed/wall/r_wall,
/area/station/command/heads_quarters/nt_rep)
"U" = (
/obj/machinery/holopad,
/obj/effect/turf_decal/bot,
/turf/open/floor/iron/dark/textured_large,
/area/station/command/heads_quarters/nt_rep)
"V" = (
/obj/structure/sign/flag/nanotrasen/directional/north,
/obj/machinery/atmospherics/components/unary/vent_scrubber/on/layer2,
/obj/effect/turf_decal/tile/neutral/fourcorners,
/turf/open/floor/iron/dark,
/area/station/command/heads_quarters/nt_rep)
"W" = (
/obj/item/kirbyplants/random,
/turf/open/floor/carpet/green,
/area/station/command/heads_quarters/nt_rep)
"X" = (
/obj/structure/disposalpipe/segment{
	dir = 9
	},
/turf/open/floor/wood,
/area/station/command/heads_quarters/nt_rep)
"Y" = (
/obj/machinery/modular_computer/preset/command{
	dir = 4
	},
/obj/structure/sign/calendar/directional/west,
/turf/open/floor/carpet/green,
/area/station/command/heads_quarters/nt_rep)
"Z" = (
/obj/machinery/light_switch/directional/south,
/turf/open/floor/carpet/green,
/area/station/command/heads_quarters/nt_rep)

(1,1,1) = {"
y
y
y
y
y
y
y
"}
(2,1,1) = {"
y
t
L
B
q
Y
y
"}
(3,1,1) = {"
E
X
w
g
r
j
y
"}
(4,1,1) = {"
R
z
l
x
e
b
y
"}
(5,1,1) = {"
R
Q
U
i
W
Z
y
"}
(6,1,1) = {"
y
h
s
A
u
u
c
"}
(7,1,1) = {"
y
V
F
H
a
v
y
"}
(8,1,1) = {"
y
O
J
T
y
y
y
"}
(9,1,1) = {"
y
I
k
y
D
D
D
"}
(10,1,1) = {"
y
y
y
y
D
D
D
"}
