"ar" = (/obj/machinery/atmospherics/pipe/smart/manifold4w/scrubbers/hidden/layer2,/obj/machinery/atmospherics/pipe/smart/manifold4w/supply/hidden/layer4,/obj/structure/cable,/obj/effect/decal/cleanable/dirt,/obj/structure/railing{dir = 8},/obj/structure/railing{dir = 4},/turf/open/floor/iron/stairs/old,/area/station/maintenance/central/lesser)
"aO" = (/obj/effect/decal/cleanable/dirt,/obj/structure/closet/crate/trashcart,/obj/effect/spawner/random/trash/food_packaging,/obj/effect/spawner/random/trash/food_packaging,/obj/effect/spawner/random/trash/food_packaging,/obj/effect/spawner/random/trash/cigbutt,/obj/effect/spawner/random/trash/garbage,/turf/open/floor/iron/smooth,/area/station/maintenance/central/lesser)
"cV" = (/turf/closed/wall,/area/station/maintenance/central/lesser)
"eB" = (/obj/machinery/door/airlock/maintenance_hatch,/obj/effect/decal/cleanable/dirt,/obj/effect/mapping_helpers/airlock/cyclelink_helper{dir = 4},/obj/effect/mapping_helpers/airlock/access/any/engineering/maintenance/departmental,/obj/structure/disposalpipe/segment{dir = 4},/obj/machinery/atmospherics/pipe/smart/manifold4w/supply/hidden/layer4,/obj/machinery/atmospherics/pipe/smart/manifold4w/scrubbers/hidden/layer2,/obj/structure/cable,/turf/open/floor/catwalk_floor,/area/station/maintenance/central/lesser)
"fe" = (/obj/effect/turf_decal/stripes/end,/obj/structure/cable/multilayer/multiz,/obj/structure/sign/warning/electric_shock/directional/north,/obj/effect/decal/cleanable/dirt,/turf/open/floor/plating,/area/station/maintenance/central/lesser)
"fE" = (/obj/machinery/atmospherics/components/unary/vent_pump/on/layer4{dir = 8},/obj/effect/decal/cleanable/dirt,/turf/open/floor/iron/smooth,/area/station/maintenance/central/lesser)
"gs" = (/turf/closed/mineral/random/stationside/asteroid/porus,/area/station/asteroid)
"gt" = (/obj/structure/cable,/obj/effect/decal/cleanable/dirt,/obj/structure/disposalpipe/segment{dir = 4},/obj/machinery/atmospherics/pipe/smart/manifold4w/supply/hidden/layer4,/obj/machinery/atmospherics/pipe/smart/manifold4w/scrubbers/hidden/layer2,/obj/structure/sign/warning/vacuum/external/directional/south,/turf/open/floor/catwalk_floor,/area/station/maintenance/central/lesser)
"gQ" = (/obj/effect/decal/cleanable/dirt,/obj/structure/disposalpipe/segment{dir = 9},/obj/machinery/atmospherics/pipe/smart/manifold4w/supply/hidden/layer4,/obj/machinery/atmospherics/pipe/smart/manifold4w/scrubbers/hidden/layer2,/obj/structure/cable,/turf/open/floor/catwalk_floor,/area/station/maintenance/central/lesser)
"gZ" = (/obj/structure/cable,/obj/effect/decal/cleanable/dirt,/obj/structure/disposalpipe/segment{dir = 4},/obj/machinery/atmospherics/pipe/smart/manifold4w/supply/hidden/layer4,/obj/machinery/atmospherics/pipe/smart/manifold4w/scrubbers/hidden/layer2,/turf/open/floor/catwalk_floor,/area/station/maintenance/central/lesser)
"hQ" = (/obj/effect/decal/cleanable/dirt,/obj/structure/girder,/turf/open/floor/iron/smooth,/area/station/maintenance/central/lesser)
"hX" = (/obj/machinery/light/small/directional/north,/obj/machinery/atmospherics/pipe/smart/manifold4w/scrubbers/hidden/layer2,/obj/machinery/atmospherics/pipe/smart/manifold4w/supply/hidden/layer4,/obj/structure/cable,/obj/structure/ladder,/obj/effect/decal/cleanable/dirt,/turf/open/floor/catwalk_floor,/area/station/maintenance/central/lesser)
"ie" = (/obj/machinery/door/airlock/maintenance_hatch{name = "Maintenance Hatch"},/obj/effect/mapping_helpers/airlock/access/all/engineering/maintenance,/obj/effect/decal/cleanable/dirt,/turf/open/floor/iron/smooth,/area/station/maintenance/central/lesser)
"il" = (/obj/structure/grille,/obj/structure/girder,/turf/open/floor/plating/airless,/area/space/nearstation)
"kY" = (/obj/effect/decal/cleanable/dirt,/obj/structure/girder,/turf/open/floor/iron/smooth,/area/station/maintenance/department/crew_quarters/dorms)
"lu" = (/obj/machinery/duct,/obj/machinery/door/airlock/maintenance_hatch{name = "Water Access Maintenance Hatch"},/obj/effect/mapping_helpers/airlock/access/all/service/janitor,/obj/effect/decal/cleanable/dirt,/turf/open/floor/catwalk_floor,/area/station/maintenance/central/lesser)
"lx" = (/obj/effect/decal/cleanable/dirt,/obj/structure/disposalpipe/segment,/obj/machinery/atmospherics/pipe/smart/manifold4w/supply/hidden/layer4,/obj/machinery/atmospherics/pipe/smart/manifold4w/scrubbers/hidden/layer2,/obj/structure/cable,/turf/open/floor/catwalk_floor,/area/station/maintenance/central/lesser)
"mg" = (/obj/effect/turf_decal/sand/plating,/obj/structure/cable/layer1,/turf/open/floor/plating/airless,/area/station/asteroid)
"mu" = (/obj/effect/decal/cleanable/dirt,/turf/open/floor/catwalk_floor,/area/station/maintenance/central/lesser)
"mV" = (/obj/structure/cable,/obj/machinery/atmospherics/pipe/smart/manifold4w/supply/hidden/layer4,/obj/effect/decal/cleanable/dirt,/obj/machinery/door/airlock/external{name = "External Access"},/obj/effect/mapping_helpers/airlock/cyclelink_helper,/obj/effect/mapping_helpers/airlock/access/all/engineering/external,/turf/open/floor/catwalk_floor,/area/station/maintenance/central/lesser)
"na" = (/obj/effect/decal/cleanable/dirt,/obj/structure/rack,/obj/effect/spawner/random/trash/janitor_supplies,/obj/effect/spawner/random/trash/janitor_supplies,/turf/open/floor/iron/smooth,/area/station/maintenance/department/crew_quarters/dorms)
"ny" = (/obj/effect/decal/cleanable/dirt,/obj/machinery/atmospherics/pipe/smart/manifold4w/supply/hidden/layer4,/obj/machinery/atmospherics/pipe/smart/manifold4w/scrubbers/hidden/layer2,/obj/structure/cable,/turf/open/floor/catwalk_floor,/area/station/maintenance/department/crew_quarters/dorms)
"oP" = (/obj/effect/decal/cleanable/dirt,/obj/structure/railing,/obj/effect/turf_decal/siding/wideplating/dark,/turf/open/floor/iron/smooth,/area/station/maintenance/central/lesser)
"oT" = (/obj/effect/decal/cleanable/dirt,/turf/open/floor/catwalk_floor,/area/station/maintenance/department/crew_quarters/dorms)
"oU" = (/obj/effect/decal/cleanable/dirt,/obj/structure/disposalpipe/segment{dir = 4},/obj/machinery/atmospherics/pipe/smart/manifold4w/supply/hidden/layer4,/obj/machinery/atmospherics/pipe/smart/manifold4w/scrubbers/hidden/layer2,/obj/structure/cable,/turf/open/floor/catwalk_floor,/area/station/maintenance/central/lesser)
"pD" = (/obj/effect/turf_decal/sand/plating,/turf/open/floor/plating/airless,/area/station/asteroid)
"qg" = (/obj/effect/decal/cleanable/dirt,/obj/effect/spawner/random/engineering/canister,/turf/open/floor/iron/smooth,/area/station/maintenance/department/crew_quarters/dorms)
"rk" = (/obj/machinery/light/small/directional/east,/obj/effect/decal/cleanable/dirt,/turf/open/floor/iron/smooth,/area/station/maintenance/central/lesser)
"rA" = (/obj/modular_map_connector,/turf/template_noop,/area/template_noop)
"rK" = (/obj/effect/decal/cleanable/dirt,/obj/structure/disposalpipe/segment,/obj/machinery/atmospherics/pipe/smart/manifold4w/supply/hidden/layer4,/obj/machinery/atmospherics/pipe/smart/manifold4w/scrubbers/hidden/layer2,/obj/structure/cable,/turf/open/floor/catwalk_floor,/area/station/maintenance/department/crew_quarters/dorms)
"sf" = (/obj/structure/cable/layer1,/obj/effect/turf_decal/sand/plating,/turf/open/floor/plating/airless,/area/station/asteroid)
"sC" = (/obj/structure/cable/layer1,/obj/effect/decal/cleanable/dirt,/turf/open/floor/catwalk_floor,/area/station/maintenance/central/lesser)
"sU" = (/obj/effect/decal/cleanable/dirt,/obj/machinery/atmospherics/pipe/smart/manifold4w/scrubbers/hidden/layer2,/obj/machinery/atmospherics/pipe/smart/manifold4w/supply/hidden/layer4,/obj/structure/cable,/obj/machinery/door/airlock/public/glass,/obj/effect/turf_decal/trimline/white/corner,/obj/effect/turf_decal/trimline/white/corner{dir = 8},/obj/machinery/door/poddoor/preopen{id = "trammaintlmaobro"; name = "Glass Walkway Emergency Seal"},/obj/machinery/button/door/directional/west{initialized_button = "trammaintlmaobro"; name = "Glass Walkway Emergency Seal Toggle"},/turf/open/floor/catwalk_floor,/area/station/maintenance/department/crew_quarters/dorms)
"sX" = (/obj/effect/decal/cleanable/dirt,/obj/structure/disposalpipe/segment{dir = 4},/obj/machinery/atmospherics/pipe/smart/manifold4w/supply/hidden/layer4,/obj/machinery/atmospherics/pipe/smart/manifold4w/scrubbers/hidden/layer2,/obj/structure/cable,/obj/machinery/duct,/turf/open/floor/catwalk_floor,/area/station/maintenance/central/lesser)
"tb" = (/obj/machinery/light/small/directional/north,/obj/effect/decal/cleanable/dirt,/obj/effect/turf_decal/bot{dir = 1},/obj/structure/closet/crate/engineering,/obj/item/storage/toolbox/mechanical,/obj/effect/spawner/random/engineering/material,/obj/effect/spawner/random/engineering/material,/obj/item/clothing/suit/hazardvest,/obj/item/clothing/head/utility/hardhat,/turf/open/floor/iron/smooth,/area/station/maintenance/central/lesser)
"tI" = (/obj/machinery/plumbing/synthesizer{reagent_id = /datum/reagent/water},/obj/effect/decal/cleanable/dirt,/turf/open/floor/catwalk_floor,/area/station/maintenance/central/lesser)
"vC" = (/turf/closed/wall/r_wall,/area/station/maintenance/central/lesser)
"vM" = (/obj/effect/decal/cleanable/dirt,/obj/machinery/atmospherics/pipe/smart/manifold4w/scrubbers/hidden/layer2,/obj/machinery/atmospherics/pipe/smart/manifold4w/supply/hidden/layer4,/obj/structure/cable,/obj/effect/turf_decal/trimline/white/warning{dir = 4},/obj/effect/turf_decal/trimline/white/warning{dir = 8},/obj/structure/window/reinforced/spawner/west,/turf/open/floor/plating,/area/station/maintenance/department/crew_quarters/dorms)
"wo" = (/obj/effect/decal/cleanable/dirt,/obj/effect/decal/cleanable/cobweb/cobweb2,/turf/open/floor/iron/smooth,/area/station/maintenance/central/lesser)
"wM" = (/obj/machinery/duct,/obj/machinery/atmospherics/pipe/smart/manifold4w/supply/hidden/layer4,/obj/structure/cable,/obj/machinery/atmospherics/pipe/smart/manifold4w/scrubbers/hidden/layer2,/turf/closed/wall,/area/station/maintenance/department/crew_quarters/dorms)
"wQ" = (/obj/effect/decal/cleanable/dirt,/obj/structure/closet/wardrobe/mixed,/turf/open/floor/iron/smooth,/area/station/maintenance/department/crew_quarters/dorms)
"xc" = (/obj/effect/mapping_helpers/airlock/access/all/engineering/maintenance,/obj/effect/decal/cleanable/dirt,/obj/structure/disposalpipe/segment{dir = 4},/obj/machinery/atmospherics/pipe/smart/manifold4w/supply/hidden/layer4,/obj/machinery/atmospherics/pipe/smart/manifold4w/scrubbers/hidden/layer2,/obj/structure/cable,/obj/machinery/door/airlock/maintenance_hatch{name = "Maintenance Hatch"},/obj/machinery/duct,/turf/open/floor/catwalk_floor,/area/station/maintenance/central/lesser)
"xL" = (/obj/effect/turf_decal/stripes/white/line{dir = 1},/obj/effect/decal/cleanable/dirt,/turf/open/floor/plating,/area/station/maintenance/central/lesser)
"xW" = (/obj/effect/decal/cleanable/dirt,/obj/structure/disposalpipe/segment{dir = 6},/obj/machinery/atmospherics/pipe/smart/manifold4w/supply/hidden/layer4,/obj/machinery/atmospherics/pipe/smart/manifold4w/scrubbers/hidden/layer2,/obj/structure/cable,/turf/open/floor/catwalk_floor,/area/station/maintenance/central/lesser)
"yh" = (/obj/structure/lattice,/turf/open/space/basic,/area/space/nearstation)
"yi" = (/obj/effect/decal/cleanable/dirt,/obj/effect/turf_decal/bot{dir = 1},/obj/effect/spawner/random/engineering/atmospherics_portable,/turf/open/floor/iron/smooth,/area/station/maintenance/central/lesser)
"zr" = (/obj/effect/decal/cleanable/dirt,/obj/structure/closet/crate,/obj/effect/spawner/random/maintenance/two,/obj/effect/spawner/random/engineering/tool,/obj/effect/spawner/random/engineering/flashlight,/turf/open/floor/iron/smooth,/area/station/maintenance/department/crew_quarters/dorms)
"zF" = (/obj/item/assembly/mousetrap/armed,/obj/effect/decal/cleanable/dirt,/obj/effect/turf_decal/stripes/white/line{dir = 1},/turf/open/floor/plating,/area/station/maintenance/central/lesser)
"AN" = (/turf/template_noop,/area/template_noop)
"Bt" = (/obj/structure/cable,/obj/machinery/atmospherics/pipe/smart/manifold4w/supply/hidden/layer4,/obj/effect/decal/cleanable/dirt,/turf/open/floor/catwalk_floor,/area/station/maintenance/central/lesser)
"Bw" = (/obj/effect/decal/cleanable/dirt,/obj/structure/closet/crate,/obj/effect/spawner/random/maintenance/four,/turf/open/floor/iron/smooth,/area/station/maintenance/central/lesser)
"CB" = (/obj/effect/decal/cleanable/dirt,/turf/open/floor/iron/smooth,/area/station/maintenance/central/lesser)
"CU" = (/obj/effect/turf_decal/stripes/end{dir = 1},/obj/machinery/atmospherics/pipe/multiz/scrubbers/hidden/layer2{dir = 4},/obj/machinery/atmospherics/pipe/multiz/supply/hidden/layer4{dir = 4},/obj/effect/decal/cleanable/dirt,/turf/open/floor/plating,/area/station/maintenance/central/lesser)
"Dw" = (/obj/machinery/duct,/obj/effect/decal/cleanable/dirt,/turf/open/floor/catwalk_floor,/area/station/maintenance/central/lesser)
"DP" = (/obj/effect/decal/cleanable/dirt,/turf/open/floor/iron/smooth,/area/station/maintenance/department/crew_quarters/dorms)
"DV" = (/obj/structure/disposalpipe/segment{dir = 6},/obj/machinery/atmospherics/pipe/smart/manifold4w/supply/hidden/layer4,/obj/machinery/atmospherics/pipe/smart/manifold4w/scrubbers/hidden/layer2,/obj/structure/cable,/turf/open/floor/catwalk_floor,/area/station/maintenance/central/lesser)
"DX" = (/obj/modular_map_root/tramstation{key = "dormenginelower_attachment_b"; name = "dormenginelower_attachment_b"},/turf/open/floor/plating,/area/station/maintenance/central/lesser)
"DZ" = (/obj/effect/decal/cleanable/dirt,/obj/structure/disposalpipe/sorting/mail{dir = 8},/obj/effect/mapping_helpers/mail_sorting/service/hydroponics,/obj/effect/mapping_helpers/mail_sorting/service/janitor_closet,/obj/effect/mapping_helpers/mail_sorting/service/law_office,/obj/effect/mapping_helpers/mail_sorting/service/bar,/obj/machinery/atmospherics/pipe/smart/manifold4w/supply/hidden/layer4,/obj/machinery/atmospherics/pipe/smart/manifold4w/scrubbers/hidden/layer2,/obj/structure/cable,/turf/open/floor/catwalk_floor,/area/station/maintenance/central/lesser)
"Eg" = (/obj/effect/decal/cleanable/dirt,/obj/effect/spawner/random/structure/steam_vent,/turf/open/floor/iron/smooth,/area/station/maintenance/department/crew_quarters/dorms)
"Ek" = (/obj/effect/decal/cleanable/dirt,/obj/effect/turf_decal/stripes/white/line{dir = 1},/turf/open/floor/plating,/area/station/maintenance/central/lesser)
"Eq" = (/obj/structure/lattice,/obj/structure/window/reinforced/spawner/east,/turf/open/space/basic,/area/space/nearstation)
"Gs" = (/obj/structure/cable/multilayer/connected,/obj/effect/decal/cleanable/dirt,/turf/open/floor/catwalk_floor,/area/station/maintenance/central/lesser)
"GX" = (/obj/effect/decal/cleanable/dirt,/obj/structure/rack,/obj/effect/spawner/random/maintenance/five,/turf/open/floor/iron/smooth,/area/station/maintenance/central/lesser)
"Hw" = (/obj/effect/decal/cleanable/dirt,/obj/effect/decal/cleanable/cobweb/cobweb2,/obj/structure/rack,/obj/effect/spawner/random/maintenance/three,/obj/effect/spawner/random/engineering/material_cheap,/turf/open/floor/iron/smooth,/area/station/maintenance/department/crew_quarters/dorms)
"IK" = (/turf/open/misc/asteroid/airless,/area/station/asteroid)
"IL" = (/obj/effect/decal/cleanable/dirt,/obj/effect/spawner/random/trash/moisture_trap,/turf/open/floor/iron/smooth,/area/station/maintenance/department/crew_quarters/dorms)
"IN" = (/obj/effect/decal/cleanable/dirt,/obj/machinery/atmospherics/pipe/smart/manifold4w/scrubbers/hidden/layer2,/obj/machinery/atmospherics/pipe/smart/manifold4w/supply/hidden/layer4,/obj/structure/cable,/obj/machinery/duct,/turf/open/floor/catwalk_floor,/area/station/maintenance/department/crew_quarters/dorms)
"IS" = (/turf/template_noop,/area/station/maintenance/central/lesser)
"Jj" = (/obj/effect/decal/cleanable/dirt,/obj/effect/spawner/random/engineering/atmospherics_portable,/turf/open/floor/iron/smooth,/area/station/maintenance/department/crew_quarters/dorms)
"Jw" = (/obj/effect/decal/cleanable/dirt,/obj/machinery/atmospherics/pipe/smart/manifold4w/scrubbers/hidden/layer2,/obj/machinery/atmospherics/pipe/smart/manifold4w/supply/hidden/layer4,/obj/structure/cable,/turf/open/floor/catwalk_floor,/area/station/maintenance/department/crew_quarters/dorms)
"Kx" = (/obj/effect/decal/cleanable/dirt,/obj/machinery/atmospherics/pipe/smart/manifold4w/scrubbers/hidden/layer2,/obj/machinery/atmospherics/pipe/smart/manifold4w/supply/hidden/layer4,/obj/structure/cable,/obj/effect/turf_decal/trimline/white/warning{dir = 4},/obj/effect/turf_decal/trimline/white/warning{dir = 8},/obj/structure/window/reinforced/spawner/west,/obj/machinery/duct,/turf/open/floor/plating,/area/station/maintenance/department/crew_quarters/dorms)
"Lh" = (/obj/effect/decal/cleanable/dirt,/obj/structure/disposalpipe/segment{dir = 9},/obj/machinery/atmospherics/pipe/smart/manifold4w/supply/hidden/layer4,/obj/machinery/atmospherics/pipe/smart/manifold4w/scrubbers/hidden/layer2,/obj/structure/cable,/obj/machinery/duct,/turf/open/floor/catwalk_floor,/area/station/maintenance/central/lesser)
"Lq" = (/turf/open/space/basic,/area/space/nearstation)
"LT" = (/obj/effect/decal/cleanable/dirt,/obj/structure/disposalpipe/segment,/obj/machinery/atmospherics/pipe/smart/manifold4w/supply/hidden/layer4,/obj/machinery/atmospherics/pipe/smart/manifold4w/scrubbers/hidden/layer2,/obj/structure/cable,/obj/machinery/duct,/turf/open/floor/catwalk_floor,/area/station/maintenance/central/lesser)
"LX" = (/obj/item/assembly/mousetrap/armed,/obj/effect/decal/cleanable/dirt,/turf/open/floor/iron/smooth,/area/station/maintenance/central/lesser)
"NT" = (/turf/closed/wall,/area/station/maintenance/department/crew_quarters/dorms)
"OF" = (/obj/modular_map_root/tramstation{key = "dormenginelower_attachment_a"; name = "dormenginelower_attachment_a"},/turf/open/floor/plating,/area/station/maintenance/department/crew_quarters/dorms)
"PL" = (/obj/effect/decal/cleanable/dirt,/obj/structure/disposalpipe/segment{dir = 5},/obj/machinery/atmospherics/pipe/smart/manifold4w/supply/hidden/layer4,/obj/machinery/atmospherics/pipe/smart/manifold4w/scrubbers/hidden/layer2,/obj/structure/cable,/obj/machinery/duct,/turf/open/floor/catwalk_floor,/area/station/maintenance/department/crew_quarters/dorms)
"Qp" = (/obj/effect/decal/cleanable/dirt,/obj/structure/disposalpipe/segment,/obj/machinery/atmospherics/pipe/smart/manifold4w/supply/hidden/layer4,/obj/machinery/atmospherics/pipe/smart/manifold4w/scrubbers/hidden/layer2,/obj/structure/cable,/obj/machinery/duct,/turf/open/floor/catwalk_floor,/area/station/maintenance/department/crew_quarters/dorms)
"Qz" = (/obj/effect/decal/cleanable/dirt,/obj/machinery/atmospherics/pipe/smart/manifold4w/supply/hidden/layer4,/obj/machinery/atmospherics/pipe/smart/manifold4w/scrubbers/hidden/layer2,/obj/structure/cable,/obj/machinery/duct,/turf/open/floor/catwalk_floor,/area/station/maintenance/department/crew_quarters/dorms)
"Rg" = (/obj/effect/decal/cleanable/dirt,/obj/structure/mop_bucket,/obj/item/mop,/turf/open/floor/iron/smooth,/area/station/maintenance/central/lesser)
"RF" = (/obj/machinery/atmospherics/pipe/smart/manifold4w/scrubbers/hidden/layer2,/obj/machinery/atmospherics/pipe/smart/manifold4w/supply/hidden/layer4,/obj/structure/cable,/obj/effect/decal/cleanable/dirt,/turf/open/floor/catwalk_floor,/area/station/maintenance/central/lesser)
"Sa" = (/obj/effect/mapping_helpers/airlock/access/all/engineering/maintenance,/obj/effect/decal/cleanable/dirt,/obj/machinery/door/airlock/maintenance_hatch{name = "Maintenance Hatch"},/turf/open/floor/iron/smooth,/area/station/maintenance/central/lesser)
"Ta" = (/obj/machinery/atmospherics/pipe/smart/manifold4w/scrubbers/hidden/layer2,/obj/machinery/atmospherics/pipe/smart/manifold4w/supply/hidden/layer4,/obj/structure/cable,/obj/effect/decal/cleanable/dirt,/obj/structure/railing/corner,/obj/structure/railing/corner{dir = 8},/turf/open/floor/catwalk_floor,/area/station/maintenance/central/lesser)
"Tb" = (/obj/effect/decal/cleanable/dirt,/obj/machinery/power/apc/auto_name/directional/south,/obj/structure/cable,/turf/open/floor/catwalk_floor,/area/station/maintenance/central/lesser)
"Te" = (/obj/effect/decal/cleanable/dirt,/obj/structure/table,/obj/item/clothing/gloves/color/purple{pixel_y = 4},/obj/item/grenade/chem_grenade/cleaner{pixel_x = 7; pixel_y = 9},/obj/item/grenade/chem_grenade/cleaner,/turf/open/floor/iron/smooth,/area/station/maintenance/central/lesser)
"TZ" = (/obj/effect/decal/cleanable/dirt,/obj/structure/table,/obj/item/reagent_containers/spray/cleaner{pixel_x = 6; pixel_y = 6},/obj/item/grenade/chem_grenade/cleaner,/obj/item/grenade/chem_grenade/cleaner{pixel_y = 6; pixel_x = -7},/turf/open/floor/iron/smooth,/area/station/maintenance/central/lesser)
"Ul" = (/obj/effect/decal/cleanable/dirt,/obj/machinery/atmospherics/pipe/smart/manifold4w/scrubbers/hidden/layer2,/obj/machinery/atmospherics/pipe/smart/manifold4w/supply/hidden/layer4,/obj/structure/cable,/obj/machinery/door/airlock/public/glass,/obj/effect/turf_decal/trimline/white/corner{dir = 4},/obj/effect/turf_decal/trimline/white/corner{dir = 1},/obj/machinery/door/poddoor/preopen{id = "trammaintlmaobro"; name = "Glass Walkway Emergency Seal"},/obj/machinery/button/door/directional/west{initialized_button = "trammaintlmaobro"; name = "Glass Walkway Emergency Seal Toggle"},/obj/machinery/duct,/turf/open/floor/catwalk_floor,/area/station/maintenance/department/crew_quarters/dorms)
"UJ" = (/obj/effect/decal/cleanable/dirt,/obj/effect/mapping_helpers/airlock/access/all/engineering/maintenance,/obj/machinery/door/airlock/maintenance_hatch{name = "Maintenance Hatch"},/turf/open/floor/iron/smooth,/area/station/maintenance/central/lesser)
"US" = (/obj/effect/decal/cleanable/dirt,/obj/effect/decal/cleanable/cobweb,/turf/open/floor/iron/smooth,/area/station/maintenance/central/lesser)
"Vf" = (/obj/effect/decal/cleanable/dirt,/obj/machinery/light/small/directional/east,/obj/structure/rack,/obj/item/tank/internals/oxygen,/obj/item/clothing/mask/gas,/turf/open/floor/iron/smooth,/area/station/maintenance/central/lesser)
"Vr" = (/obj/effect/decal/cleanable/dirt,/obj/effect/decal/cleanable/cobweb,/obj/structure/sink/directional/south,/obj/structure/mirror/directional/north,/obj/item/lipstick/random,/turf/open/floor/plating,/area/station/maintenance/central/lesser)
"Vt" = (/obj/effect/decal/cleanable/dirt,/obj/structure/closet/l3closet/janitor,/turf/open/floor/iron/smooth,/area/station/maintenance/central/lesser)
"Xm" = (/obj/structure/cable,/obj/effect/decal/cleanable/dirt,/turf/open/floor/catwalk_floor,/area/station/maintenance/central/lesser)
"Xn" = (/obj/effect/decal/cleanable/dirt,/obj/structure/disposalpipe/segment{dir = 4},/obj/machinery/atmospherics/pipe/smart/manifold4w/supply/hidden/layer4,/obj/machinery/atmospherics/pipe/smart/manifold4w/scrubbers/hidden/layer2,/obj/structure/cable,/obj/machinery/duct,/turf/open/floor/catwalk_floor,/area/station/maintenance/department/crew_quarters/dorms)
"YG" = (/obj/effect/decal/cleanable/dirt,/obj/structure/closet/cardboard,/obj/effect/spawner/random/maintenance/four,/obj/effect/spawner/random/clothing/kittyears_or_rabbitears,/turf/open/floor/iron/smooth,/area/station/maintenance/department/crew_quarters/dorms)
"Zb" = (/obj/effect/spawner/structure/window,/turf/open/floor/plating,/area/station/maintenance/central/lesser)
"Zj" = (/obj/structure/cable/layer1,/obj/effect/decal/cleanable/dirt,/obj/machinery/door/airlock/external{name = "External Access"},/obj/effect/mapping_helpers/airlock/cyclelink_helper{dir = 1},/obj/effect/mapping_helpers/airlock/access/all/engineering/external,/turf/open/floor/catwalk_floor,/area/station/maintenance/central/lesser)
"ZY" = (/obj/effect/decal/cleanable/dirt,/obj/structure/railing,/obj/effect/turf_decal/siding/wideplating/dark,/obj/structure/table,/obj/item/storage/toolbox/electrical,/obj/item/clothing/gloves/cut,/turf/open/floor/iron/smooth,/area/station/maintenance/central/lesser)

(1,1,1) = {"
IKIKIKIKIKIKANANANANANANANANANANANANANANANANANANANANANANANANANANANANANANANANANANANANANANANANANANANANANANANANANANANANANANANANANANANANANANANANANANANANANANANANANANANAN
IKIKIKIKIKIKANANANANANANANANANANANANANANANANANANANANANANANANANANANANANANANANANANANANANANANANANANANANANANANANANANANANANANANANANANANANANANANANANANANANANANANANANANlxAN
IKIKIKIKIKIKANANANANANANANANANANANANANANANANANANANANANANANANANANANANANANANANANANANANANANANANANANANANANANANANANANANANANANANANANANANANANcVcVcVcVANANANANANCBCBCBCBlxAN
IKLqIKLqIKIKANANANANANANANANANANANANANANANANANANANANANANANANANANANANANANANANANANANANANANANANANANANANANANANANANANANANANANANANANANcVcVcVcVxWoUoUoUoUoUoUoUoUoUoUoUgQAN
LqLqLqLqIKIKANANANANANANANANANANANANANANANANANANANANANANANANANANANANANANANANANANANANANANANANANANANANANANANANANANANANANANANANANANcVxWoUoUgQcVANANANANANANANANANANANAN
LqLqLqLqLqIKANANANANANANANANANANANANANANANANANANANANANANANANANANANANANANANANANANANANANANANANANANANANANANANANANANANANANANANANANANcVlxANANANANANANANANANANANANANANANAN
LqLqLqLqLqIKANANANANANANANANANANANANANANANANANANANANANANANANANANANANANANANANANANANISISISISISISANANANANANANANANANANANANANANANANANcVlxANANANANANANANANANANANANANANANAN
LqLqLqLqLqIKANANANANANANANANANANANANANANANANANANANANANANANANANANANANANANANANANANANieCBCBCBwocVgsgsgsgsgsgsgsgsgsgsgsgsgsgsgsgsgscVlxANANANANANANANANANANANANANANANAN
LqLqLqLqANANANANANANANANANANANANANrAANANANANANANANANANANANANANANANANANANANANANANANISISISISCBcVcVcVcVcVcVcVgsgsgsgsgsgsgsgsgsgsgscVlxANANANANANANANANANANANANANANANAN
LqLqilyhNTJwJwJwJwJwJwJwJwJwJwJwJwJwANANANANANANANANANANANANANANANANANANANANANANANANANANISCBCBCBCBCBCBCBcVgsgsgsgsgsgsgsgsgsgsgscVlxANANANANANANANANANANANANANANANAN
LqililLqNTsUANANANANANANANDPDPDPDPDPANANANANANANANANANANANANANANANANANANANANANANANANANANISISISISISISISCBcVgsgsgsgsgsgsgsgsgsgsgscVlxANANANANANANANANANANANANANANANAN
LqilyhyhEqvMANANANANANANANnaqgkYJjJjANANANANANANANANANANANANANANANANANANANANANANANANANANANANANANANANISCBcVcVgsgsgsgsgsgsgsgsgsgscVlxcVVrRgANANANANANANANANANANANANAN
LqilLqLqEqvMANANANANANANANANANANANANANANANANANANANANANANANANANANANANANANANANANANANANANANANANANANANANISCBCBcVcVgsgsgsgsgsgsgsgsgscVlxcVCBTeANANANANANANANANANANANANAN
LqilLqLqEqvMANANANANANANANANANANANANANANANANANANANANANANANANANANANANANANANANANANANANANANANANANANANANISISCBCBcVgsgsgsgsgsgsgsgsgscVlxSaCBCBANANANANANANANANANANANANAN
LqilLqLqEqvMANANANANANANANANANANANANANANANANANANANANANANANANANANANANANANANANANANANANANANANANANANANANANISISCBcVgsgsgsgsgsgsgsgsgscVlxANANANANANANANANANANANANANANANAN
LqilyhyhEqvMANANANANANANANANANANANANANANANANANANANANANANANANANANANANANANANANANANANANANANANANANANANANANANISCBcVcVgsgsgsgsgsgsgsgscVlxANANANANANANANANANANANANANANANAN
LqilLqLqEqvMANANANANANANANANANANANANANANANANANANANANANANANANANANANANANANANANANANANANANANANANANANANANANANISCBwocVgsgsgsgsgsgsgsgsDXlxANANANANANANANANANANANANANANANAN
LqilLqLqEqvMANANANANANANANANANANANANANANANANANANANANANANANANANANANANANANANANANANANANANANANANANANANANANANISCBBwcVcVcVcVcVcVcVgsgscVlxANANANANANANANANANANANANANANANAN
LqilLqLqEqvMANANANANANANANANANANANANANANANANANANANANANANANANANANANANANANANANANANANANANANANANANANANANANANISCBhQcVUSCUhXfeCBcVgsgscVlxANANANANANANANANANANANANANANANAN
LqilLqLqEqKxwMANANANANANANANANANANANANANANANANANANANANANANANANANANANANANANANANANANANANANANANANANANANANANISCBGXcVCBCBRFLXCBcVgsgscVlxANANANANANANANANANANANANANANANAN
LqilyhyhEqKxANANANANANANANANANANANANANANANANANANANANANANANANANANANANANANANANANANANANANANANANANANANANANANISCBaOcVoPoPTaoPZYcVgscVcVlxcVyitbANANANANANANANANANANANANAN
LqilLqLqEqKxANANANANANANANANANANANANANANANANANANANANANANANANANANANANANANANANANANANANANANANANANANANANANANISUJZbcVzFxLarEkEkcVcVcVDVDZeBoUoUANANANANANANANANANANANANAN
LqilLqLqEqKxANANANANANANANANANANANANANANANANANANANANANANANANANANANANANANANANANANANANANANANANANANANANANcVxWoUoUoUgtgZgZoUoUoUoUoUgQmucVCBTbANANANANANANANANANANANANAN
LqilLqLqEqKxANANANANANANANANANANANANANANANANANANANANANANANANANANANANANANANANANANANANANANANANANANANANANxWgQcVcVcVcVmVcVvCANANANANANANANANANANANANANANANANANANANANANAN
LqilyhyhEqKxANANANANANANANwQYGkYzrHwANANANANANANANANANANANANANANANANANANANANANANANANANANANANANANANANANlxcVcVgscVXmBtfEvCANANANANANANANANANANANANANANANANANANANANANAN
LqililLqNTUlANANANANANANANDPDPDPDPDPANANANANANANANANANANANANANANANANANANANANANANANANANANANANANANANANANlxcVgsgscVGssCVfvCANANANANANANANANANANANANANANANANANANANANANAN
LqLqilyhNTINININININININININININININANANANANANANANANANANANANANANANANANANANANANANANANANANANxWoUoUoUoUoUgQcVgsIKcVcVZjcVvCANANANANANANANANANANANANANANANANANANANANANAN
ANANLqIKNTNTNTNTNTNTNTNTNTNTOFNTNTINANANANANANANANANANANANANANANANANANANANANANANANANANANANlxcVcVcVcVcVcVcVIKIKmgmgmgpDANANANANANANANANANANANANANANANANANANANANANANAN
ANANIKIKgsgsgsgsgsgsgsgsgsgsgsgsNTININANANANANANANANANANANANANANANANANANANANANANANANANANxWgQcVgsgsgsgsgsIKIKIKsfIKIKIKANANANANANANANANANANANANANANANANANANANANANANAN
ANANIKIKgsgsgsgsgsgsgsgsgsgsgsgsNTNTINANANANANANnyoTANANANANANANANANANANANoTrKANANANANANlxcVcVcVcVgsgsgsIKIKIKpDIKIKIKANANANANANANANANANANANANANANANANANANANANANANAN
ANANIKIKgsgsgsgsgsIKIKgsgsgsgsgsgsNTINANANANANANININININANANANANANANANININQzQpANANANANANlxcVtITZcVgsgsIKIKpDpDpDIKIKgsANANANANANANANANANANANANANANANANANANANANANANAN
ANANANIKgsIKgsIKIKIKIKIKgsgsgsgsgsNTINANANANANANINNTEgDPANANANANANANANDPILNTQpANANANANANLTluDwrkcVgsIKIKIKpDIKIKIKgsgsANANANANANANANANANANANANANANANANANANANANANANAN
ANANANIKgsIKIKIKIKIKIKIKgsgsgsgsgsNTINININININININNTNTNTANANANANANANANNTNTNTPLXnXnxcsXsXLhcVVtCBcVIKIKIKIKpDIKIKgsgsgsANANANANANANANANANANANANANANANANANANANANANANAN
ANANANgsgsIKIKIKIKIKIKgsgsgsgsgsgsNTNTNTNTNTNTNTNTNTIKIKANANANANANANANgsgsNTNTNTNTcVcVcVcVcVcVcVcVIKIKpDpDpDIKgsgsgsgsANANANANANANANANANANANANANANANANANANANANANANAN
"}
