//MAP CONVERTED BY dmm2tgm.py THIS HEADER COMMENT PREVENTS RECONVERSION, DO NOT REMOVE
"cF" = (
/obj/effect/turf_decal/delivery,
/obj/structure/table,
/obj/effect/spawner/random/entertainment/cigarette_pack,
/turf/open/floor/iron/dark,
/area/station/hallway/secondary/entry)
"dt" = (
/obj/machinery/light/directional/east,
/obj/effect/turf_decal/tile/dark_blue{
	dir = 1
	},
/obj/effect/turf_decal/tile/dark_blue,
/turf/open/floor/iron/white,
/area/station/hallway/secondary/entry)
"dV" = (
/obj/effect/turf_decal/tile/dark_blue{
	dir = 1
	},
/obj/effect/turf_decal/tile/dark_blue,
/obj/structure/chair/sofa/bench/tram/left{
	dir = 8
	},
/turf/open/floor/iron/white,
/area/station/hallway/secondary/entry)
"fy" = (
/obj/structure/lattice/catwalk,
/obj/structure/chair/sofa/bench/tram/left,
/turf/open/water,
/area/station/hallway/secondary/entry)
"fD" = (
/obj/effect/turf_decal/tile/dark_blue{
	dir = 1
	},
/obj/effect/turf_decal/tile/dark_blue,
/obj/machinery/status_display/evac/directional/north,
/obj/structure/chair/sofa/bench/tram/left,
/turf/open/floor/iron/white,
/area/station/hallway/secondary/entry)
"iU" = (
/obj/effect/landmark/start/assistant,
/obj/effect/turf_decal/tile/dark_blue{
	dir = 1
	},
/obj/effect/turf_decal/tile/dark_blue,
/obj/structure/chair/sofa/bench/tram/right,
/turf/open/floor/iron/white,
/area/station/hallway/secondary/entry)
"jp" = (
/obj/machinery/atmospherics/pipe/smart/manifold4w/scrubbers/hidden/layer2,
/obj/effect/turf_decal/tile/dark_blue{
	dir = 1
	},
/obj/effect/turf_decal/tile/dark_blue,
/obj/machinery/atmospherics/pipe/smart/manifold4w/supply/hidden/layer4,
/turf/open/floor/iron/white,
/area/station/hallway/secondary/entry)
"ka" = (
/obj/effect/turf_decal/tile/dark_blue{
	dir = 1
	},
/obj/effect/turf_decal/tile/dark_blue,
/obj/machinery/status_display/shuttle/directional/south{
	shuttle_id = "arrivals_shuttle"
	},
/turf/open/floor/iron/white,
/area/station/hallway/secondary/entry)
"kh" = (
/obj/effect/turf_decal/delivery,
/obj/machinery/vending/imported/mothic,
/turf/open/floor/iron/dark,
/area/station/hallway/secondary/entry)
"kX" = (
/turf/template_noop,
/area/template_noop)
"lA" = (
/obj/machinery/atmospherics/pipe/smart/manifold4w/scrubbers/hidden/layer2,
/obj/structure/disposalpipe/segment{
	dir = 5
	},
/obj/effect/turf_decal/tile/dark_blue{
	dir = 1
	},
/obj/effect/turf_decal/tile/dark_blue,
/obj/machinery/atmospherics/pipe/smart/manifold4w/supply/hidden/layer4,
/turf/open/floor/iron/white,
/area/station/hallway/secondary/entry)
"mO" = (
/obj/machinery/light/directional/east,
/turf/template_noop,
/area/template_noop)
"mW" = (
/obj/machinery/atmospherics/pipe/smart/manifold4w/scrubbers/hidden/layer2,
/obj/machinery/atmospherics/pipe/smart/manifold4w/supply/hidden/layer4,
/turf/template_noop,
/area/template_noop)
"ne" = (
/obj/effect/turf_decal/tile/dark_blue{
	dir = 1
	},
/obj/effect/turf_decal/tile/dark_blue,
/obj/machinery/status_display/evac/directional/north,
/turf/open/floor/iron/white,
/area/station/hallway/secondary/entry)
"qs" = (
/obj/structure/lattice,
/turf/open/space/basic,
/area/space/nearstation)
"ra" = (
/obj/effect/turf_decal/delivery,
/obj/machinery/vending/imported/tiziran,
/turf/open/floor/iron/dark,
/area/station/hallway/secondary/entry)
"rc" = (
/obj/effect/turf_decal/tile/dark_blue{
	dir = 1
	},
/obj/effect/turf_decal/tile/dark_blue,
/turf/open/floor/iron/white,
/area/station/hallway/secondary/entry)
"ry" = (
/obj/structure/flora/bush/fullgrass/style_random,
/obj/structure/flora/bush/ferny/style_random,
/obj/machinery/atmospherics/pipe/smart/manifold4w/supply/hidden/layer4,
/obj/machinery/atmospherics/pipe/smart/manifold4w/scrubbers/hidden/layer2,
/turf/open/floor/grass,
/area/station/hallway/secondary/entry)
"ty" = (
/obj/effect/mapping_helpers/airlock/cyclelink_helper,
/obj/machinery/door/airlock/external{
	name = "Arrivals External Airlock";
	space_dir = 1
	},
/obj/effect/mapping_helpers/airlock/unres,
/turf/open/floor/plating,
/area/station/hallway/secondary/entry)
"tI" = (
/turf/closed/wall/r_wall,
/area/station/hallway/secondary/entry)
"wd" = (
/obj/effect/turf_decal/tile/dark_blue{
	dir = 1
	},
/obj/effect/turf_decal/tile/dark_blue,
/obj/machinery/modular_computer/preset/time_clock/directional/south,
/turf/open/floor/iron/white,
/area/station/hallway/secondary/entry)
"wv" = (
/obj/structure/lattice/catwalk,
/obj/structure/marker_beacon/cerulean,
/turf/open/space/basic,
/area/space/nearstation)
"wG" = (
/turf/open/space/basic,
/area/space)
"wW" = (
/obj/structure/lattice/catwalk,
/obj/machinery/camera/autoname/directional/north,
/obj/item/kirbyplants/random,
/turf/open/water,
/area/station/hallway/secondary/entry)
"xc" = (
/obj/structure/lattice/catwalk,
/turf/open/water,
/area/station/hallway/secondary/entry)
"zk" = (
/obj/docking_port/stationary{
	dir = 4;
	dwidth = 1;
	height = 13;
	shuttle_id = "arrivals_stationary";
	name = "arrivals";
	roundstart_template = null;
	width = 5
	},
/turf/open/space/basic,
/area/space)
"zG" = (
/obj/effect/turf_decal/delivery,
/obj/machinery/vending/snack/orange,
/turf/open/floor/iron/dark,
/area/station/hallway/secondary/entry)
"zH" = (
/turf/closed/wall/mineral/plastitanium,
/area/space/nearstation)
"AE" = (
/obj/machinery/door/airlock/external{
	name = "Arrivals External Airlock";
	space_dir = 1
	},
/obj/effect/mapping_helpers/airlock/cyclelink_helper{
	dir = 1
	},
/obj/effect/mapping_helpers/airlock/unres,
/turf/open/floor/plating,
/area/station/hallway/secondary/entry)
"BE" = (
/obj/effect/turf_decal/delivery,
/obj/structure/closet/emcloset,
/turf/open/floor/iron/dark,
/area/station/hallway/secondary/entry)
"BJ" = (
/obj/effect/turf_decal/tile/dark_blue{
	dir = 1
	},
/obj/effect/turf_decal/tile/dark_blue,
/obj/item/radio/intercom/directional/south,
/turf/open/floor/iron/white,
/area/station/hallway/secondary/entry)
"BY" = (
/obj/structure/cable,
/obj/effect/turf_decal/tile/dark_blue{
	dir = 1
	},
/obj/effect/turf_decal/tile/dark_blue,
/obj/structure/disposalpipe/segment{
	dir = 10
	},
/turf/open/floor/iron/white,
/area/station/hallway/secondary/entry)
"Cn" = (
/obj/structure/railing{
	dir = 10
	},
/obj/effect/turf_decal/siding/brown{
	dir = 10
	},
/obj/structure/cable,
/obj/structure/disposalpipe/segment{
	dir = 5
	},
/obj/effect/turf_decal/tile/dark_blue{
	dir = 1
	},
/obj/effect/turf_decal/tile/dark_blue,
/turf/open/floor/iron/white,
/area/station/hallway/secondary/entry)
"Cs" = (
/obj/effect/turf_decal/tile/dark_blue{
	dir = 1
	},
/obj/effect/turf_decal/tile/dark_blue,
/obj/structure/chair/sofa/bench/tram/right{
	dir = 4
	},
/turf/open/floor/iron/white,
/area/station/hallway/secondary/entry)
"Da" = (
/obj/structure/cable,
/obj/effect/turf_decal/tile/dark_blue{
	dir = 1
	},
/obj/effect/turf_decal/tile/dark_blue,
/obj/structure/disposalpipe/segment{
	dir = 4
	},
/turf/open/floor/iron/white,
/area/station/hallway/secondary/entry)
"FP" = (
/obj/machinery/door/airlock/external{
	name = "Arrivals External Airlock";
	space_dir = 1
	},
/obj/effect/mapping_helpers/airlock/cyclelink_helper,
/obj/effect/mapping_helpers/airlock/unres,
/turf/open/floor/plating,
/area/station/hallway/secondary/entry)
"Gr" = (
/obj/effect/turf_decal/delivery,
/obj/machinery/vending/imported,
/turf/open/floor/iron/dark,
/area/station/hallway/secondary/entry)
"IN" = (
/turf/open/floor/catwalk_floor,
/area/station/hallway/secondary/entry)
"IX" = (
/obj/effect/turf_decal/tile/dark_blue{
	dir = 1
	},
/obj/effect/turf_decal/tile/dark_blue,
/obj/item/radio/intercom/directional/east,
/turf/open/floor/iron/white,
/area/station/hallway/secondary/entry)
"Jt" = (
/obj/effect/turf_decal/delivery,
/obj/machinery/vending/cigarette,
/turf/open/floor/iron/dark,
/area/station/hallway/secondary/entry)
"Lk" = (
/obj/effect/turf_decal/tile/dark_blue{
	dir = 1
	},
/obj/effect/turf_decal/tile/dark_blue,
/obj/machinery/atmospherics/pipe/smart/manifold4w/supply/hidden/layer4,
/obj/structure/cable,
/obj/machinery/atmospherics/pipe/smart/manifold4w/scrubbers/hidden/layer2,
/turf/open/floor/iron/white,
/area/station/hallway/secondary/entry)
"Ll" = (
/turf/closed/wall/r_wall,
/area/space/nearstation)
"Lo" = (
/obj/effect/turf_decal/delivery,
/obj/structure/closet/firecloset,
/obj/structure/sign/poster/timeclock_psa/directional/east,
/turf/open/floor/iron/dark,
/area/station/hallway/secondary/entry)
"LH" = (
/obj/effect/turf_decal/tile/dark_blue{
	dir = 1
	},
/obj/effect/turf_decal/tile/dark_blue,
/obj/machinery/atmospherics/components/unary/vent_pump/on/layer4{
	dir = 8
	},
/turf/open/floor/iron/white,
/area/station/hallway/secondary/entry)
"LS" = (
/obj/machinery/atmospherics/pipe/smart/manifold4w/supply/hidden/layer4,
/obj/machinery/atmospherics/pipe/smart/manifold4w/scrubbers/hidden/layer2,
/obj/structure/cable,
/obj/effect/turf_decal/tile/dark_blue{
	dir = 1
	},
/obj/effect/turf_decal/tile/dark_blue,
/turf/open/floor/iron/white,
/area/station/hallway/secondary/entry)
"Mp" = (
/obj/effect/turf_decal/delivery,
/obj/structure/table,
/obj/effect/spawner/random/food_or_drink,
/turf/open/floor/iron/dark,
/area/station/hallway/secondary/entry)
"MZ" = (
/obj/effect/spawner/structure/window/reinforced,
/turf/open/floor/plating,
/area/station/hallway/secondary/entry)
"Nz" = (
/obj/structure/lattice/catwalk,
/obj/machinery/computer/shuttle/arrivals/recall,
/turf/open/water,
/area/station/hallway/secondary/entry)
"Oa" = (
/obj/structure/lattice/catwalk,
/obj/machinery/camera/autoname/directional/south,
/turf/open/water,
/area/station/hallway/secondary/entry)
"Ol" = (
/obj/structure/railing{
	dir = 8
	},
/obj/effect/turf_decal/siding/brown{
	dir = 8
	},
/obj/machinery/atmospherics/pipe/smart/manifold4w/supply/hidden/layer4,
/obj/machinery/atmospherics/pipe/smart/manifold4w/scrubbers/hidden/layer2,
/obj/effect/turf_decal/tile/dark_blue,
/turf/open/floor/iron/white,
/area/station/hallway/secondary/entry)
"OF" = (
/obj/effect/turf_decal/delivery,
/obj/machinery/vending/cola/space_up,
/turf/open/floor/iron/dark,
/area/station/hallway/secondary/entry)
"OO" = (
/obj/effect/turf_decal/tile/dark_blue{
	dir = 1
	},
/obj/effect/turf_decal/tile/dark_blue,
/obj/structure/chair/sofa/bench/tram/right{
	dir = 8
	},
/turf/open/floor/iron/white,
/area/station/hallway/secondary/entry)
"PI" = (
/obj/effect/turf_decal/delivery,
/obj/machinery/vending/coffee,
/turf/open/floor/iron/dark,
/area/station/hallway/secondary/entry)
"QL" = (
/obj/item/radio/intercom/directional/west,
/obj/effect/turf_decal/tile/dark_blue{
	dir = 1
	},
/obj/effect/turf_decal/tile/dark_blue,
/turf/open/floor/iron/white,
/area/station/hallway/secondary/entry)
"Rb" = (
/obj/structure/railing/corner{
	dir = 8
	},
/obj/effect/turf_decal/siding/brown/corner{
	dir = 8
	},
/obj/structure/cable,
/obj/machinery/atmospherics/components/unary/vent_pump/on/layer4,
/obj/effect/turf_decal/tile/dark_blue{
	dir = 1
	},
/obj/effect/turf_decal/tile/dark_blue,
/obj/structure/disposalpipe/segment{
	dir = 4
	},
/turf/open/floor/iron/white,
/area/station/hallway/secondary/entry)
"Ru" = (
/obj/effect/turf_decal/tile/dark_blue{
	dir = 1
	},
/obj/effect/turf_decal/tile/dark_blue,
/obj/machinery/atmospherics/components/unary/vent_pump/on/layer4{
	dir = 4
	},
/turf/open/floor/iron/white,
/area/station/hallway/secondary/entry)
"RA" = (
/obj/item/kirbyplants/random,
/turf/template_noop,
/area/template_noop)
"RQ" = (
/obj/machinery/atmospherics/pipe/smart/manifold4w/scrubbers/hidden/layer2,
/obj/effect/turf_decal/tile/dark_blue{
	dir = 1
	},
/obj/effect/turf_decal/tile/dark_blue,
/obj/structure/disposalpipe/segment,
/obj/machinery/atmospherics/pipe/smart/manifold4w/supply/hidden/layer4,
/turf/open/floor/iron/white,
/area/station/hallway/secondary/entry)
"RZ" = (
/obj/effect/turf_decal/tile/dark_blue{
	dir = 1
	},
/obj/effect/turf_decal/tile/dark_blue,
/obj/structure/chair/sofa/bench/tram/left,
/turf/open/floor/iron/white,
/area/station/hallway/secondary/entry)
"Sb" = (
/obj/effect/turf_decal/delivery,
/obj/machinery/vending/snack/blue,
/turf/open/floor/iron/dark,
/area/station/hallway/secondary/entry)
"Sg" = (
/obj/effect/mapping_helpers/airlock/cyclelink_helper{
	dir = 1
	},
/obj/machinery/door/airlock/external{
	name = "Arrivals External Airlock";
	space_dir = 1
	},
/obj/effect/mapping_helpers/airlock/unres,
/turf/open/floor/plating,
/area/station/hallway/secondary/entry)
"SM" = (
/obj/structure/lattice/catwalk,
/obj/structure/chair/sofa/bench/tram/right,
/turf/open/water,
/area/station/hallway/secondary/entry)
"SY" = (
/obj/machinery/light/directional/south,
/turf/template_noop,
/area/template_noop)
"Uc" = (
/obj/effect/turf_decal/delivery,
/obj/machinery/vending/cola/pwr_game,
/turf/open/floor/iron/dark,
/area/station/hallway/secondary/entry)
"Uq" = (
/obj/effect/turf_decal/tile/dark_blue{
	dir = 1
	},
/obj/effect/turf_decal/tile/dark_blue,
/obj/machinery/light/directional/west,
/turf/open/floor/iron/white,
/area/station/hallway/secondary/entry)
"UE" = (
/obj/effect/turf_decal/tile/dark_blue{
	dir = 1
	},
/obj/effect/turf_decal/tile/dark_blue,
/obj/structure/chair/sofa/bench/tram/left{
	dir = 4
	},
/turf/open/floor/iron/white,
/area/station/hallway/secondary/entry)
"UP" = (
/obj/effect/turf_decal/delivery,
/obj/structure/closet/firecloset,
/obj/structure/sign/poster/timeclock_psa/directional/west,
/turf/open/floor/iron/dark,
/area/station/hallway/secondary/entry)
"UZ" = (
/obj/machinery/light/directional/west,
/turf/template_noop,
/area/template_noop)
"Wt" = (
/obj/effect/turf_decal/tile/dark_blue{
	dir = 1
	},
/obj/effect/turf_decal/tile/dark_blue,
/obj/machinery/light/directional/north,
/turf/open/floor/iron/white,
/area/station/hallway/secondary/entry)
"WZ" = (
/obj/effect/turf_decal/tile/dark_blue{
	dir = 1
	},
/obj/effect/turf_decal/tile/dark_blue,
/obj/effect/landmark/navigate_destination/dockarrival,
/turf/open/floor/iron/white,
/area/station/hallway/secondary/entry)
"Xh" = (
/obj/machinery/power/apc/auto_name/directional/east,
/obj/structure/cable,
/obj/effect/turf_decal/tile/dark_blue{
	dir = 1
	},
/obj/effect/turf_decal/tile/dark_blue,
/turf/open/floor/iron/white,
/area/station/hallway/secondary/entry)
"Zk" = (
/obj/effect/turf_decal/tile/dark_blue{
	dir = 1
	},
/obj/effect/turf_decal/tile/dark_blue,
/obj/machinery/atmospherics/pipe/smart/manifold4w/supply/hidden/layer4,
/obj/machinery/atmospherics/pipe/smart/manifold4w/scrubbers/hidden/layer2,
/turf/open/floor/iron/white,
/area/station/hallway/secondary/entry)
"Zv" = (
/obj/effect/turf_decal/delivery,
/obj/machinery/vending/imported/yangyu,
/turf/open/floor/iron/dark,
/area/station/hallway/secondary/entry)

(1,1,1) = {"
kX
kX
kX
kX
kX
kX
kX
kX
kX
kX
kX
kX
kX
kX
kX
kX
kX
kX
kX
kX
kX
kX
kX
kX
"}
(2,1,1) = {"
kX
kX
rc
Lk
Uq
QL
kX
kX
kX
kX
UZ
kX
kX
kX
kX
kX
kX
kX
kX
kX
kX
kX
kX
kX
"}
(3,1,1) = {"
kX
iU
kX
kX
LS
LS
LS
LS
LS
jp
jp
jp
jp
jp
jp
jp
rc
BJ
tI
zH
qs
qs
qs
wv
"}
(4,1,1) = {"
kX
RZ
kX
kX
OF
Sb
cF
PI
Gr
Jt
kh
Lo
BE
rc
rc
LH
OO
dV
MZ
wG
zk
wG
wG
wG
"}
(5,1,1) = {"
kX
kX
kX
kX
tI
tI
MZ
tI
MZ
tI
MZ
tI
tI
ne
ka
tI
MZ
MZ
tI
wG
wG
wG
wG
wG
"}
(6,1,1) = {"
kX
kX
kX
kX
xc
MZ
wG
qs
wG
qs
wG
MZ
Nz
rc
rc
FP
IN
IN
AE
wG
wG
wG
wG
wG
"}
(7,1,1) = {"
kX
kX
kX
SY
tI
tI
qs
qs
qs
qs
qs
tI
tI
Wt
wd
tI
MZ
MZ
tI
wG
wG
wG
wG
wG
"}
(8,1,1) = {"
kX
kX
kX
kX
xc
MZ
wG
qs
wG
qs
wG
MZ
SM
rc
rc
MZ
qs
qs
qs
wG
wG
wG
wG
wG
"}
(9,1,1) = {"
kX
kX
kX
kX
xc
MZ
wG
qs
wG
qs
wG
MZ
fy
rc
rc
MZ
qs
qs
qs
wG
wG
wG
wG
wG
"}
(10,1,1) = {"
kX
kX
kX
kX
Oa
tI
wG
qs
wG
qs
wG
tI
wW
WZ
rc
MZ
qs
qs
qs
wG
wG
wG
wG
wG
"}
(11,1,1) = {"
kX
kX
kX
kX
xc
MZ
wG
qs
wG
qs
wG
MZ
SM
rc
rc
MZ
qs
qs
qs
wG
wG
wG
wG
wG
"}
(12,1,1) = {"
kX
kX
kX
kX
xc
MZ
wG
qs
wG
qs
wG
MZ
fy
rc
rc
MZ
qs
qs
qs
wG
wG
wG
wG
wG
"}
(13,1,1) = {"
kX
kX
kX
SY
tI
tI
qs
qs
qs
qs
qs
tI
tI
Wt
wd
tI
MZ
MZ
tI
wG
wG
wG
wG
wG
"}
(14,1,1) = {"
kX
kX
Cn
ry
xc
MZ
wG
qs
wG
qs
wG
MZ
Nz
rc
rc
ty
IN
IN
Sg
wG
wG
wG
wG
wG
"}
(15,1,1) = {"
kX
kX
Rb
Ol
tI
Ll
MZ
tI
MZ
tI
MZ
tI
tI
ne
ka
tI
MZ
MZ
tI
wG
wG
wG
wG
wG
"}
(16,1,1) = {"
kX
iU
Da
jp
zG
Uc
Mp
PI
Zv
Jt
ra
UP
BE
rc
rc
Ru
UE
Cs
MZ
wG
wG
wG
wG
wG
"}
(17,1,1) = {"
kX
fD
BY
RQ
RQ
lA
jp
jp
jp
jp
jp
jp
jp
jp
jp
jp
Zk
BJ
tI
zH
qs
qs
qs
wv
"}
(18,1,1) = {"
kX
kX
Xh
IX
dt
kX
kX
kX
kX
kX
mO
kX
kX
kX
kX
kX
mW
RA
kX
kX
kX
kX
kX
kX
"}
(19,1,1) = {"
kX
kX
kX
kX
kX
kX
kX
kX
kX
kX
kX
kX
kX
kX
kX
kX
kX
kX
kX
kX
kX
kX
kX
kX
"}
