//MAP CONVERTED BY dmm2tgm.py THIS HEADER COMMENT PREVENTS RECONVERSION, DO NOT REMOVE
"a" = (
/turf/closed/wall,
/area/station/commons/fitness/recreation/sauna)
"c" = (
/obj/item/towel,
/obj/item/clothing/under/misc/skyrat/gear_harness,
/obj/structure/closet/secure_closet/personal/wall{
	pixel_y = 32
	},
/turf/open/floor/wood/tile,
/area/station/commons/fitness/recreation/sauna)
"e" = (
/obj/structure/window/reinforced/tinted/fulltile,
/turf/open/floor/plating,
/area/station/commons/fitness/recreation/sauna)
"g" = (
/obj/machinery/door/window/brigdoor/right/directional/east,
/obj/structure/fans/tiny,
/obj/machinery/door/poddoor/shutters/preopen{
	id = "sauna_priv";
	name = "Tactical Privacy Shutter";
	desc = "Heavy duty, airtight mechanical shutters for the most demanding enterprise resource planning."
	},
/turf/open/floor/wood/stairs/left,
/area/station/commons/fitness/recreation/sauna)
"i" = (
/obj/machinery/atmospherics/pipe/smart/manifold4w/scrubbers/hidden/layer2{
	dir = 8
	},
/obj/structure/cable,
/obj/machinery/power/apc/auto_name/directional/south,
/obj/machinery/atmospherics/pipe/smart/manifold4w/supply/hidden/layer4,
/turf/open/floor/wood/tile,
/area/station/commons/fitness/recreation/sauna)
"k" = (
/obj/machinery/vending/autodrobe,
/turf/open/floor/iron,
/area/station/commons/fitness/recreation)
"l" = (
/obj/effect/turf_decal/trimline/green/filled/line{
	dir = 4
	},
/turf/template_noop,
/area/template_noop)
"m" = (
/obj/machinery/atmospherics/components/unary/vent_pump/on/layer4{
	dir = 8
	},
/obj/machinery/atmospherics/pipe/smart/manifold4w/scrubbers/hidden/layer2{
	dir = 8
	},
/turf/open/floor/wood/tile,
/area/station/commons/fitness/recreation/sauna)
"o" = (
/obj/machinery/light/directional/east,
/obj/machinery/atmospherics/pipe/smart/manifold4w/scrubbers/hidden/layer2{
	dir = 8
	},
/obj/machinery/atmospherics/pipe/smart/manifold4w/supply/hidden/layer4,
/obj/structure/cable,
/obj/effect/turf_decal/trimline/green/filled/corner{
	dir = 4
	},
/turf/open/floor/iron,
/area/station/commons/fitness/recreation)
"p" = (
/turf/template_noop,
/area/template_noop)
"q" = (
/obj/structure/chair/sofa/bench/left{
	dir = 1
	},
/turf/open/floor/wood/tile,
/area/station/commons/fitness/recreation/sauna)
"r" = (
/obj/machinery/atmospherics/pipe/smart/manifold4w/scrubbers/hidden/layer2{
	dir = 8
	},
/obj/machinery/atmospherics/pipe/smart/manifold4w/supply/hidden/layer4,
/turf/open/floor/wood/tile,
/area/station/commons/fitness/recreation/sauna)
"s" = (
/obj/machinery/light/warm/dim/directional/east,
/turf/open/floor/wood/tile,
/area/station/commons/fitness/recreation/sauna)
"t" = (
/obj/machinery/atmospherics/pipe/smart/manifold4w/scrubbers/hidden/layer2{
	dir = 8
	},
/obj/machinery/atmospherics/pipe/smart/manifold4w/supply/hidden/layer4,
/obj/structure/cable,
/turf/open/floor/iron,
/area/station/commons/fitness/recreation)
"v" = (
/obj/item/radio/intercom/directional/south,
/turf/open/floor/wood/tile,
/area/station/commons/fitness/recreation/sauna)
"w" = (
/obj/structure/chair/sofa/bench,
/turf/open/floor/wood/tile,
/area/station/commons/fitness/recreation/sauna)
"y" = (
/obj/structure/sauna_oven,
/turf/open/floor/wood/tile,
/area/station/commons/fitness/recreation/sauna)
"B" = (
/obj/machinery/light/warm/directional/west,
/obj/machinery/atmospherics/pipe/smart/manifold4w/supply/hidden/layer4,
/obj/machinery/atmospherics/pipe/smart/manifold4w/scrubbers/hidden/layer2{
	dir = 8
	},
/obj/structure/closet/firecloset/wall{
	pixel_x = -32
	},
/turf/open/floor/wood/tile,
/area/station/commons/fitness/recreation/sauna)
"C" = (
/obj/machinery/button/door/directional/south{
	id = "sauna_priv";
	name = "Tactical Privacy Shutters";
	skin = "-warning";
	can_alter_skin = 0;
	icon_state = "button-warning"
	},
/obj/effect/landmark/navigate_destination/autoname,
/turf/open/floor/wood/tile,
/area/station/commons/fitness/recreation/sauna)
"E" = (
/obj/structure/chair/sofa/bench{
	dir = 1
	},
/turf/open/floor/wood/tile,
/area/station/commons/fitness/recreation/sauna)
"G" = (
/obj/machinery/door/airlock/service{
	name = "Sauna"
	},
/obj/machinery/atmospherics/pipe/smart/manifold4w/scrubbers/hidden/layer2{
	dir = 8
	},
/obj/structure/cable,
/obj/machinery/atmospherics/pipe/smart/manifold4w/supply/hidden/layer4,
/turf/open/floor/wood/tile,
/area/station/commons/fitness/recreation/sauna)
"H" = (
/obj/structure/chair/sofa/bench/right,
/turf/open/floor/wood/tile,
/area/station/commons/fitness/recreation/sauna)
"I" = (
/obj/structure/drain,
/obj/machinery/shower/directional/north,
/obj/structure/curtain,
/turf/open/floor/wood/tile,
/area/station/commons/fitness/recreation/sauna)
"J" = (
/obj/effect/spawner/structure/window/reinforced,
/obj/machinery/door/poddoor/shutters/preopen{
	id = "sauna_priv";
	name = "Tactical Privacy Shutter";
	desc = "Heavy duty, airtight mechanical shutters for the most demanding enterprise resource planning."
	},
/turf/open/floor/plating,
/area/station/commons/fitness/recreation/sauna)
"K" = (
/obj/structure/chair/sofa/bench/right{
	dir = 1
	},
/turf/open/floor/wood/tile,
/area/station/commons/fitness/recreation/sauna)
"L" = (
/turf/open/floor/wood/tile,
/area/station/commons/fitness/recreation/sauna)
"O" = (
/obj/structure/table/wood,
/obj/structure/towel_bin,
/turf/open/floor/wood/tile,
/area/station/commons/fitness/recreation/sauna)
"P" = (
/obj/machinery/atmospherics/components/unary/vent_scrubber/on/layer2{
	dir = 1
	},
/turf/open/floor/wood/tile,
/area/station/commons/fitness/recreation/sauna)
"Q" = (
/obj/structure/sink/directional/south,
/obj/item/reagent_containers/cup/bucket/wooden{
	pixel_y = 14;
	pixel_x = 10;
	name = "solid state sauna rehydration device"
	},
/obj/item/stack/sheet/mineral/wood/fifty,
/obj/machinery/button/door/directional/north{
	id = "sauna_priv";
	name = "Tactical Privacy Shutters";
	icon_state = "button-warning";
	can_alter_skin = 0;
	skin = "-warning";
	pixel_y = 33;
	pixel_x = 10
	},
/turf/open/floor/wood/tile,
/area/station/commons/fitness/recreation/sauna)
"R" = (
/obj/effect/landmark/start/assistant,
/obj/machinery/atmospherics/pipe/smart/manifold4w/scrubbers/hidden/layer2{
	dir = 8
	},
/obj/machinery/atmospherics/pipe/smart/manifold4w/supply/hidden/layer4,
/obj/structure/cable,
/turf/open/floor/iron,
/area/station/commons/fitness/recreation)
"T" = (
/obj/structure/dresser,
/turf/open/floor/wood/tile,
/area/station/commons/fitness/recreation/sauna)
"U" = (
/obj/machinery/vending/clothing,
/obj/machinery/atmospherics/components/unary/vent_scrubber/on/layer2{
	dir = 8
	},
/turf/open/floor/iron,
/area/station/commons/fitness/recreation)
"V" = (
/obj/structure/chair/sofa/bench/left,
/turf/open/floor/wood/tile,
/area/station/commons/fitness/recreation/sauna)
"Y" = (
/obj/machinery/atmospherics/pipe/smart/manifold4w/scrubbers/hidden/layer2{
	dir = 8
	},
/obj/machinery/atmospherics/pipe/smart/manifold4w/supply/hidden/layer4,
/obj/structure/cable,
/obj/effect/turf_decal/trimline/green/filled/line{
	dir = 4
	},
/turf/open/floor/iron,
/area/station/commons/fitness/recreation)
"Z" = (
/obj/item/towel,
/obj/item/clothing/under/misc/skyrat/gear_harness,
/obj/structure/closet/secure_closet/personal/wall{
	pixel_y = 32
	},
/obj/machinery/airalarm/directional/west,
/turf/open/floor/wood/tile,
/area/station/commons/fitness/recreation/sauna)

(1,1,1) = {"
p
p
l
Y
o
R
t
"}
(2,1,1) = {"
a
a
a
G
a
k
U
"}
(3,1,1) = {"
a
Z
B
i
a
a
p
"}
(4,1,1) = {"
a
c
r
e
a
a
p
"}
(5,1,1) = {"
a
c
m
P
I
a
p
"}
(6,1,1) = {"
a
T
O
C
a
a
p
"}
(7,1,1) = {"
a
e
e
g
a
p
p
"}
(8,1,1) = {"
a
Q
L
v
a
p
p
"}
(9,1,1) = {"
J
H
L
q
a
p
p
"}
(10,1,1) = {"
J
w
y
E
a
p
p
"}
(11,1,1) = {"
J
V
s
K
a
p
p
"}
(12,1,1) = {"
a
a
a
a
a
p
p
"}
