//MAP CONVERTED BY dmm2tgm.py THIS HEADER COMMENT PREVENTS RECONVERSION, DO NOT REMOVE
"a" = (
/obj/machinery/door/airlock/public/glass{
	name = "Cryopods Room"
	},
/obj/machinery/atmospherics/pipe/smart/manifold4w/scrubbers/hidden/layer2,
/obj/machinery/atmospherics/pipe/smart/manifold4w/supply/hidden/layer4,
/turf/open/floor/iron/dark,
/area/station/common/cryopods)
"b" = (
/obj/machinery/door/airlock/public/glass{
	name = "Cryopods Room"
	},
/turf/open/floor/iron,
/area/station/common/cryopods)
"d" = (
/obj/machinery/modular_computer/preset/time_clock/directional/south,
/turf/open/floor/iron,
/area/station/commons/dorms)
"f" = (
/obj/effect/turf_decal/siding/blue,
/turf/template_noop,
/area/template_noop)
"g" = (
/obj/structure/flora/bush/flowers_pp{
	name = "skyyblossoms"
	},
/obj/structure/flora/bush/flowers_pp/style_2{
	name = "skyyblossoms"
	},
/obj/effect/landmark/event_spawn,
/turf/open/floor/grass/fairy,
/area/station/commons/dorms)
"h" = (
/obj/effect/turf_decal/siding/purple{
	dir = 8
	},
/obj/structure/railing{
	dir = 8
	},
/obj/machinery/atmospherics/pipe/smart/manifold4w/scrubbers/hidden/layer2,
/obj/machinery/atmospherics/pipe/smart/manifold4w/supply/hidden/layer4,
/obj/effect/turf_decal/siding/blue{
	dir = 4
	},
/turf/open/floor/iron,
/area/station/commons/dorms)
"i" = (
/obj/effect/turf_decal/siding/purple/corner,
/obj/structure/railing/corner,
/obj/structure/disposalpipe/segment,
/turf/open/floor/iron,
/area/station/commons/dorms)
"j" = (
/obj/effect/turf_decal/siding,
/turf/open/floor/iron/dark,
/area/station/common/cryopods)
"k" = (
/obj/effect/turf_decal/siding,
/obj/machinery/computer/cryopod/directional/east,
/obj/machinery/light/cold/directional/east,
/obj/machinery/atmospherics/components/unary/vent_scrubber/on/layer2{
	dir = 1
	},
/turf/open/floor/iron/dark,
/area/station/common/cryopods)
"l" = (
/obj/structure/extinguisher_cabinet,
/turf/closed/wall,
/area/station/common/cryopods)
"n" = (
/obj/machinery/atmospherics/pipe/smart/manifold4w/supply/hidden/layer4,
/obj/machinery/atmospherics/pipe/smart/manifold4w/scrubbers/hidden/layer2,
/obj/structure/cable,
/turf/open/floor/iron/dark,
/area/station/common/cryopods)
"o" = (
/obj/machinery/cryopod{
	dir = 1
	},
/obj/effect/turf_decal/bot_blue,
/turf/open/floor/iron/dark,
/area/station/common/cryopods)
"q" = (
/obj/effect/turf_decal/siding/blue/corner{
	dir = 8
	},
/turf/template_noop,
/area/template_noop)
"r" = (
/obj/machinery/disposal/bin,
/obj/structure/railing{
	dir = 4
	},
/obj/structure/disposalpipe/trunk{
	dir = 1
	},
/obj/effect/turf_decal/siding/purple{
	dir = 4
	},
/turf/open/floor/iron,
/area/station/commons/dorms)
"s" = (
/obj/effect/mapping_helpers/apc/cell_10k,
/obj/machinery/power/apc/auto_name/directional/west,
/obj/structure/cable,
/obj/effect/turf_decal/siding/corner,
/obj/machinery/light/cold/directional/west,
/turf/open/floor/iron,
/area/station/common/cryopods)
"w" = (
/obj/machinery/door/airlock/maintenance,
/obj/machinery/atmospherics/pipe/smart/manifold4w/supply/hidden/layer4,
/obj/machinery/atmospherics/pipe/smart/manifold4w/scrubbers/hidden/layer2,
/obj/effect/mapping_helpers/airlock/access/all/engineering/maintenance,
/obj/structure/cable,
/turf/open/floor/plating,
/area/station/maintenance/starboard/fore)
"z" = (
/obj/effect/turf_decal/siding/purple,
/obj/structure/railing,
/turf/open/floor/iron,
/area/station/commons/dorms)
"A" = (
/turf/closed/wall,
/area/station/maintenance/starboard/fore)
"C" = (
/obj/structure/window/reinforced/spawner/directional/west,
/obj/structure/cable,
/obj/machinery/atmospherics/components/unary/vent_pump/on/layer4{
	dir = 4
	},
/turf/open/floor/iron/dark,
/area/station/common/cryopods)
"D" = (
/obj/machinery/cryopod{
	dir = 1
	},
/obj/effect/turf_decal/bot_blue,
/obj/machinery/airalarm/directional/east,
/turf/open/floor/iron/dark,
/area/station/common/cryopods)
"E" = (
/obj/structure/flora/bush/flowers_pp{
	name = "skyyblossoms"
	},
/obj/structure/flora/bush/flowers_pp/style_2{
	name = "skyyblossoms"
	},
/turf/open/floor/grass/fairy,
/area/station/commons/dorms)
"F" = (
/obj/structure/cable,
/obj/machinery/atmospherics/pipe/smart/manifold4w/supply/hidden/layer4,
/turf/open/floor/iron/dark,
/area/station/common/cryopods)
"G" = (
/obj/machinery/cryopod{
	dir = 1
	},
/obj/structure/window/reinforced/spawner/directional/west,
/obj/effect/turf_decal/bot_blue,
/turf/open/floor/iron/dark,
/area/station/common/cryopods)
"H" = (
/obj/effect/turf_decal/siding/purple,
/obj/structure/railing,
/obj/machinery/atmospherics/pipe/smart/manifold4w/supply/hidden/layer4,
/obj/machinery/atmospherics/pipe/smart/manifold4w/scrubbers/hidden/layer2,
/obj/effect/landmark/start/hangover,
/turf/open/floor/iron,
/area/station/commons/dorms)
"J" = (
/obj/effect/turf_decal/siding/purple,
/obj/structure/railing,
/obj/machinery/atmospherics/pipe/smart/manifold4w/scrubbers/hidden/layer2,
/obj/machinery/atmospherics/pipe/smart/manifold4w/supply/hidden/layer4,
/turf/open/floor/iron,
/area/station/commons/dorms)
"K" = (
/obj/machinery/door/window/left/directional/west,
/obj/structure/cable,
/obj/effect/turf_decal/siding,
/turf/open/floor/iron/dark,
/area/station/common/cryopods)
"L" = (
/obj/structure/ladder,
/obj/structure/sign/poster/contraband/random/directional/west,
/turf/open/floor/iron,
/area/station/common/cryopods)
"O" = (
/obj/structure/flora/bush/flowers_pp{
	name = "skyyblossoms"
	},
/obj/structure/flora/bush/flowers_pp/style_2{
	name = "skyyblossoms"
	},
/obj/effect/landmark/start/hangover,
/turf/open/floor/grass/fairy,
/area/station/commons/dorms)
"P" = (
/obj/machinery/atmospherics/pipe/smart/manifold4w/scrubbers/hidden/layer2,
/obj/machinery/atmospherics/pipe/smart/manifold4w/supply/hidden/layer4,
/obj/structure/cable,
/turf/open/floor/iron/dark,
/area/station/common/cryopods)
"Q" = (
/obj/structure/sign/poster/timeclock_psa/directional/south,
/obj/effect/turf_decal/siding/blue{
	dir = 8
	},
/turf/template_noop,
/area/template_noop)
"R" = (
/obj/effect/turf_decal/siding,
/obj/effect/landmark/navigate_destination/cryo,
/turf/open/floor/iron/dark,
/area/station/common/cryopods)
"S" = (
/turf/closed/wall,
/area/station/common/cryopods)
"W" = (
/obj/effect/spawner/structure/window,
/turf/open/floor/plating,
/area/station/common/cryopods)
"X" = (
/obj/effect/turf_decal/siding/purple/corner{
	dir = 8
	},
/obj/structure/railing/corner{
	dir = 8
	},
/obj/machinery/atmospherics/pipe/smart/manifold4w/scrubbers/hidden/layer2,
/obj/machinery/atmospherics/pipe/smart/manifold4w/supply/hidden/layer4,
/obj/effect/turf_decal/siding/blue/corner,
/turf/open/floor/iron,
/area/station/commons/dorms)
"Y" = (
/turf/closed/wall/r_wall,
/area/station/engineering/storage/tech)
"Z" = (
/obj/effect/turf_decal/siding{
	dir = 4
	},
/turf/open/floor/iron,
/area/station/common/cryopods)

(1,1,1) = {"
i
r
l
S
S
b
"}
(2,1,1) = {"
z
O
W
L
s
Z
"}
(3,1,1) = {"
H
E
W
C
K
G
"}
(4,1,1) = {"
J
O
W
F
j
o
"}
(5,1,1) = {"
J
g
W
F
R
o
"}
(6,1,1) = {"
X
h
a
P
j
o
"}
(7,1,1) = {"
f
d
S
n
k
D
"}
(8,1,1) = {"
q
Q
A
w
Y
Y
"}
