//MAP CONVERTED BY dmm2tgm.py THIS HEADER COMMENT PREVENTS RECONVERSION, DO NOT REMOVE
"a" = (
/turf/closed/wall/r_wall,
/area/station/command/heads_quarters/blueshield)
"b" = (
/obj/effect/turf_decal/siding/dark{
	dir = 1
	},
/obj/machinery/modular_computer/preset/command{
	dir = 8
	},
/obj/machinery/airalarm/directional/east,
/turf/open/floor/carpet/blue,
/area/station/command/heads_quarters/blueshield)
"d" = (
/obj/structure/table/wood,
/obj/machinery/fax{
	name = "Blueshield's Fax Machine";
	fax_name = "Blueshield's Office"
	},
/obj/item/radio/intercom/directional/west,
/turf/open/floor/wood,
/area/station/command/heads_quarters/blueshield)
"f" = (
/obj/structure/table/wood/fancy/blue,
/obj/machinery/computer/security/wooden_tv{
	pixel_y = 10
	},
/obj/item/book/manual/wiki/security_space_law{
	pixel_y = 3;
	pixel_x = 7
	},
/turf/open/floor/carpet/blue,
/area/station/command/heads_quarters/blueshield)
"h" = (
/turf/template_noop,
/area/template_noop)
"i" = (
/obj/effect/turf_decal/siding/dark{
	dir = 1
	},
/obj/structure/chair/office{
	dir = 8
	},
/obj/machinery/holopad,
/turf/open/floor/carpet/blue,
/area/station/command/heads_quarters/blueshield)
"j" = (
/obj/machinery/atmospherics/pipe/smart/manifold4w/supply/hidden/layer4,
/obj/structure/cable,
/obj/machinery/atmospherics/pipe/smart/manifold4w/scrubbers/hidden/layer2,
/obj/effect/turf_decal/tile/dark_blue/opposingcorners,
/turf/open/floor/iron/dark,
/area/station/command/bridge)
"l" = (
/obj/effect/turf_decal/delivery/red,
/obj/structure/closet/secure_closet/tac{
	req_access = list("captain")
	},
/obj/item/gun_maintenance_supplies,
/obj/item/clothing/suit/armor/riot,
/obj/item/clothing/head/helmet/toggleable/riot{
	pixel_y = 6
	},
/obj/item/ammo_box/magazine/wt550m9,
/obj/item/screwdriver,
/obj/item/shield/riot,
/obj/item/storage/toolbox/ammobox/wt550m9,
/obj/structure/window/reinforced/spawner/directional/south,
/obj/machinery/vending/wallmed/directional/north,
/turf/open/floor/iron/dark/textured,
/area/station/command/heads_quarters/blueshield)
"m" = (
/obj/machinery/atmospherics/pipe/smart/manifold4w/supply/hidden/layer4,
/obj/machinery/atmospherics/pipe/smart/manifold4w/scrubbers/hidden/layer2,
/obj/effect/landmark/event_spawn,
/obj/effect/turf_decal/tile/dark_blue/opposingcorners,
/obj/structure/cable,
/obj/effect/spawner/random/engineering/tracking_beacon,
/turf/open/floor/iron/dark,
/area/station/command/bridge)
"n" = (
/obj/structure/dresser,
/obj/item/modular_computer/laptop/preset/security{
	pixel_y = 8
	},
/turf/open/floor/carpet/blue,
/area/station/command/heads_quarters/blueshield)
"q" = (
/obj/machinery/atmospherics/pipe/smart/manifold4w/scrubbers/hidden/layer2,
/obj/structure/cable,
/obj/machinery/light/floor,
/obj/effect/turf_decal/tile/dark_blue/opposingcorners,
/obj/machinery/atmospherics/pipe/smart/manifold4w/supply/hidden/layer4,
/turf/open/floor/iron/dark,
/area/station/command/bridge)
"r" = (
/obj/effect/spawner/structure/window/reinforced,
/obj/structure/cable,
/obj/machinery/door/poddoor/preopen{
	id = "bridge blast";
	name = "Bridge Blast Door"
	},
/turf/open/floor/plating,
/area/station/command/bridge)
"s" = (
/obj/structure/cable,
/obj/machinery/atmospherics/pipe/smart/manifold4w/scrubbers/hidden/layer2,
/obj/machinery/atmospherics/pipe/smart/manifold4w/supply/hidden/layer4,
/turf/open/floor/wood,
/area/station/command/heads_quarters/blueshield)
"t" = (
/obj/structure/table/reinforced/rglass,
/obj/machinery/keycard_auth{
	pixel_y = 3
	},
/obj/effect/turf_decal/trimline/dark_blue/filled,
/turf/open/floor/iron/dark,
/area/station/command/bridge)
"u" = (
/obj/effect/mapping_helpers/turn_off_lights_with_lightswitch,
/obj/machinery/atmospherics/components/unary/vent_scrubber/on/layer2,
/turf/open/floor/wood,
/area/station/command/heads_quarters/blueshield)
"v" = (
/obj/machinery/atmospherics/pipe/smart/manifold4w/scrubbers/hidden/layer2,
/obj/machinery/atmospherics/components/unary/vent_pump/on/layer4{
	dir = 4
	},
/turf/open/floor/wood,
/area/station/command/heads_quarters/blueshield)
"w" = (
/obj/effect/turf_decal/siding/dark{
	dir = 1
	},
/obj/structure/table/wood,
/obj/machinery/requests_console/auto_name/directional/west,
/obj/effect/mapping_helpers/requests_console/information,
/obj/effect/mapping_helpers/requests_console/supplies,
/obj/effect/mapping_helpers/requests_console/assistance,
/obj/item/paper_bin{
	pixel_y = 4;
	pixel_x = -5
	},
/obj/item/pen/fourcolor{
	pixel_x = -5;
	pixel_y = 5
	},
/obj/machinery/recharger{
	pixel_x = 7;
	pixel_y = 6
	},
/turf/open/floor/carpet/blue,
/area/station/command/heads_quarters/blueshield)
"y" = (
/obj/effect/turf_decal/delivery/red,
/obj/structure/closet/secure_closet/blueshield,
/obj/item/taperecorder{
	name = "Captain's Log"
	},
/obj/item/clothing/gloves/tackler/combat/insulated/blueshield,
/obj/machinery/door/window/brigdoor/right/directional/east{
	req_access = list("captain");
	name = "Blueshield's Armory";
	dir = 2
	},
/obj/structure/sign/plaques/kiddie/perfect_man{
	pixel_y = 32
	},
/obj/machinery/light/small/blacklight/directional/north,
/turf/open/floor/iron/dark/textured,
/area/station/command/heads_quarters/blueshield)
"A" = (
/obj/effect/turf_decal/tile/dark_blue/opposingcorners,
/obj/machinery/door/airlock/highsecurity{
	name = "Blueshield's Quarters"
	},
/obj/structure/cable,
/obj/structure/cable,
/obj/machinery/atmospherics/pipe/smart/manifold4w/scrubbers/hidden/layer2,
/obj/machinery/atmospherics/pipe/smart/manifold4w/supply/hidden/layer4,
/obj/effect/mapping_helpers/airlock/access/all/command/captain,
/turf/open/floor/iron/dark,
/area/station/command/heads_quarters/blueshield)
"B" = (
/obj/structure/cable,
/obj/machinery/power/apc/auto_name/directional/east,
/turf/open/floor/wood,
/area/station/command/heads_quarters/blueshield)
"C" = (
/obj/machinery/atmospherics/pipe/smart/manifold4w/scrubbers/hidden/layer2,
/obj/structure/cable,
/obj/effect/turf_decal/tile/dark_blue/opposingcorners,
/obj/machinery/atmospherics/pipe/smart/manifold4w/supply/hidden/layer4,
/turf/open/floor/iron/dark,
/area/station/command/bridge)
"D" = (
/obj/machinery/atmospherics/pipe/smart/manifold4w/scrubbers/hidden/layer2,
/obj/structure/cable,
/obj/machinery/atmospherics/pipe/smart/manifold4w/supply/hidden/layer4,
/obj/effect/turf_decal/tile/dark_blue/opposingcorners,
/obj/machinery/atmospherics/pipe/smart/manifold4w/supply/hidden/layer4,
/turf/open/floor/iron/dark,
/area/station/command/bridge)
"E" = (
/obj/machinery/atmospherics/pipe/smart/manifold4w/scrubbers/hidden/layer2,
/obj/structure/cable,
/obj/effect/turf_decal/tile/dark_blue/opposingcorners,
/obj/structure/cable,
/obj/machinery/atmospherics/pipe/smart/manifold4w/supply/hidden/layer4,
/turf/open/floor/iron/dark,
/area/station/command/bridge)
"H" = (
/obj/machinery/computer/crew{
	dir = 4
	},
/turf/open/floor/wood,
/area/station/command/heads_quarters/blueshield)
"I" = (
/obj/structure/cable,
/obj/machinery/atmospherics/pipe/smart/manifold4w/supply/hidden/layer4,
/obj/machinery/atmospherics/pipe/smart/manifold4w/scrubbers/hidden/layer2,
/obj/effect/mapping_helpers/airlock/access/all/command/general,
/obj/machinery/door/firedoor,
/obj/machinery/door/poddoor/preopen{
	id = "bridge blast-2";
	name = "Bridge Blast Door"
	},
/obj/structure/disposalpipe/segment{
	dir = 10
	},
/obj/machinery/door/airlock/command/glass{
	name = "Bridge Access";
	id_tag = "innerbridge"
	},
/obj/effect/turf_decal/tile/dark_blue/fourcorners,
/turf/open/floor/iron/dark,
/area/station/command/bridge)
"M" = (
/obj/machinery/suit_storage_unit/security,
/obj/effect/turf_decal/delivery/red,
/obj/structure/window/reinforced/spawner/directional/south,
/obj/structure/reagent_dispensers/wall/peppertank/directional/north,
/turf/open/floor/iron/dark/textured,
/area/station/command/heads_quarters/blueshield)
"N" = (
/obj/item/bedsheet/nanotrasen,
/obj/structure/bed,
/obj/machinery/light/small/directional/south,
/turf/open/floor/carpet/blue,
/area/station/command/heads_quarters/blueshield)
"O" = (
/obj/effect/turf_decal/tile/dark_blue/opposingcorners,
/obj/structure/cable,
/obj/machinery/atmospherics/pipe/smart/manifold4w/scrubbers/hidden/layer2,
/obj/machinery/atmospherics/pipe/smart/manifold4w/supply/hidden/layer4,
/turf/open/floor/iron/dark,
/area/station/command/bridge)
"Q" = (
/obj/machinery/atmospherics/pipe/smart/manifold4w/scrubbers/hidden/layer2,
/obj/effect/turf_decal/tile/dark_blue/opposingcorners,
/obj/structure/cable,
/obj/machinery/atmospherics/pipe/smart/manifold4w/scrubbers/hidden/layer2,
/obj/machinery/atmospherics/pipe/smart/manifold4w/supply/hidden/layer4,
/turf/open/floor/iron/dark,
/area/station/command/bridge)
"R" = (
/obj/machinery/atmospherics/pipe/smart/manifold4w/scrubbers/hidden/layer2,
/obj/structure/cable,
/obj/machinery/atmospherics/pipe/smart/manifold4w/supply/hidden/layer4,
/obj/effect/turf_decal/tile/dark_blue/opposingcorners,
/obj/machinery/light/floor,
/obj/structure/disposalpipe/segment{
	dir = 5
	},
/turf/open/floor/iron/dark,
/area/station/command/bridge)
"Y" = (
/obj/effect/turf_decal/tile/dark_blue/opposingcorners,
/obj/structure/disposalpipe/trunk{
	dir = 8
	},
/obj/machinery/disposal/bin,
/turf/open/floor/iron/dark,
/area/station/command/bridge)

(1,1,1) = {"
h
h
h
a
a
a
a
a
a
a
"}
(2,1,1) = {"
h
h
h
a
l
H
d
w
f
a
"}
(3,1,1) = {"
h
h
h
a
y
u
v
i
N
a
"}
(4,1,1) = {"
h
h
h
a
M
B
s
b
n
a
"}
(5,1,1) = {"
h
h
h
a
a
a
A
a
a
a
"}
(6,1,1) = {"
h
h
h
h
h
h
O
h
h
h
"}
(7,1,1) = {"
h
h
h
h
h
h
O
h
h
h
"}
(8,1,1) = {"
h
h
h
E
Q
O
O
h
h
h
"}
(9,1,1) = {"
h
h
h
C
h
h
h
h
h
h
"}
(10,1,1) = {"
h
h
h
q
h
h
h
h
h
h
"}
(11,1,1) = {"
I
R
j
D
h
h
h
h
h
h
"}
(12,1,1) = {"
r
Y
t
m
h
h
h
h
h
h
"}
