//MAP CONVERTED BY dmm2tgm.py THIS HEADER COMMENT PREVENTS RECONVERSION, DO NOT REMOVE
"a" = (
/turf/template_noop,
/area/template_noop)
"b" = (
/obj/item/radio/intercom/directional/south,
/turf/open/floor/wood/tile,
/area/station/commons/fitness/recreation/sauna)
"c" = (
/obj/machinery/light/warm/dim/directional/east,
/turf/open/floor/wood/tile,
/area/station/commons/fitness/recreation/sauna)
"d" = (
/obj/structure/sink/directional/south,
/obj/item/reagent_containers/cup/bucket/wooden{
	pixel_y = 14;
	pixel_x = 10;
	name = "solid state sauna rehydration device"
	},
/obj/item/stack/sheet/mineral/wood/fifty,
/obj/machinery/button/door/directional/north{
	id = "sauna_priv";
	name = "Tactical Privacy Shutters";
	icon_state = "button-warning";
	can_alter_skin = 0;
	skin = "-warning";
	pixel_y = 33;
	pixel_x = 10
	},
/turf/open/floor/wood/tile,
/area/station/commons/fitness/recreation/sauna)
"f" = (
/obj/item/towel,
/obj/item/clothing/under/misc/skyrat/gear_harness,
/obj/structure/closet/secure_closet/personal/wall{
	pixel_y = 32
	},
/obj/item/clothing/shoes/sandal{
	pixel_y = -3
	},
/turf/open/floor/wood/tile,
/area/station/commons/fitness/recreation/sauna)
"g" = (
/turf/open/floor/wood/tile,
/area/station/commons/fitness/recreation/sauna)
"i" = (
/obj/machinery/vending/autodrobe,
/turf/open/floor/iron,
/area/station/commons/fitness/recreation)
"j" = (
/obj/structure/sauna_oven,
/turf/open/floor/wood/tile,
/area/station/commons/fitness/recreation/sauna)
"m" = (
/obj/machinery/door/airlock/maintenance{
	name = "Mothtainence Access"
	},
/obj/effect/mapping_helpers/airlock/abandoned,
/obj/effect/turf_decal/tile/purple/opposingcorners,
/obj/effect/turf_decal/tile/yellow/opposingcorners{
	dir = 1
	},
/turf/open/floor/iron,
/area/station/maintenance/starboard/fore)
"n" = (
/obj/item/towel,
/obj/item/clothing/under/misc/skyrat/gear_harness,
/obj/structure/closet/secure_closet/personal/wall{
	pixel_y = 32
	},
/obj/machinery/airalarm/directional/west,
/obj/item/clothing/shoes/sandal{
	pixel_y = -3
	},
/turf/open/floor/wood/tile,
/area/station/commons/fitness/recreation/sauna)
"o" = (
/obj/machinery/button/door/directional/south{
	id = "sauna_priv";
	name = "Tactical Privacy Shutters";
	skin = "-warning";
	can_alter_skin = 0;
	icon_state = "button-warning"
	},
/turf/open/floor/wood/tile,
/area/station/commons/fitness/recreation/sauna)
"p" = (
/obj/machinery/atmospherics/components/unary/vent_pump/on/layer4{
	dir = 8
	},
/obj/machinery/atmospherics/pipe/smart/manifold4w/scrubbers/hidden/layer2{
	dir = 8
	},
/turf/open/floor/wood/tile,
/area/station/commons/fitness/recreation/sauna)
"q" = (
/obj/structure/dresser,
/turf/open/floor/wood/tile,
/area/station/commons/fitness/recreation/sauna)
"r" = (
/obj/structure/chair/sofa/bench{
	dir = 1
	},
/turf/open/floor/wood/tile,
/area/station/commons/fitness/recreation/sauna)
"s" = (
/obj/structure/window/reinforced/tinted/fulltile,
/turf/open/floor/plating,
/area/station/commons/fitness/recreation/sauna)
"t" = (
/obj/machinery/atmospherics/pipe/smart/manifold4w/scrubbers/hidden/layer2{
	dir = 8
	},
/obj/structure/cable,
/obj/machinery/power/apc/auto_name/directional/south,
/obj/machinery/atmospherics/pipe/smart/manifold4w/supply/hidden/layer4,
/turf/open/floor/wood/tile,
/area/station/commons/fitness/recreation/sauna)
"v" = (
/obj/effect/turf_decal/trimline/green/filled/line{
	dir = 4
	},
/turf/template_noop,
/area/template_noop)
"w" = (
/obj/machinery/light/directional/east,
/obj/machinery/atmospherics/pipe/smart/manifold4w/scrubbers/hidden/layer2{
	dir = 8
	},
/obj/machinery/atmospherics/pipe/smart/manifold4w/supply/hidden/layer4,
/obj/structure/cable,
/obj/effect/turf_decal/trimline/green/filled/corner{
	dir = 4
	},
/turf/open/floor/iron,
/area/station/commons/fitness/recreation)
"y" = (
/obj/machinery/door/airlock/service{
	name = "Sauna"
	},
/obj/machinery/atmospherics/pipe/smart/manifold4w/scrubbers/hidden/layer2{
	dir = 8
	},
/obj/structure/cable,
/obj/machinery/atmospherics/pipe/smart/manifold4w/supply/hidden/layer4,
/turf/open/floor/wood/tile,
/area/station/commons/fitness/recreation/sauna)
"A" = (
/obj/effect/landmark/start/assistant,
/obj/machinery/atmospherics/pipe/smart/manifold4w/scrubbers/hidden/layer2{
	dir = 8
	},
/obj/machinery/atmospherics/pipe/smart/manifold4w/supply/hidden/layer4,
/obj/structure/cable,
/turf/open/floor/iron,
/area/station/commons/fitness/recreation)
"B" = (
/turf/closed/wall,
/area/station/commons/fitness/recreation/sauna)
"D" = (
/obj/structure/chair/sofa/bench,
/turf/open/floor/wood/tile,
/area/station/commons/fitness/recreation/sauna)
"E" = (
/obj/machinery/door/window/brigdoor/right/directional/east,
/obj/structure/fans/tiny,
/obj/machinery/door/poddoor/shutters/preopen{
	id = "sauna_priv";
	name = "Tactical Privacy Shutter";
	desc = "Heavy duty, airtight mechanical shutters for the most demanding enterprise resource planning."
	},
/turf/open/floor/wood/stairs/left,
/area/station/commons/fitness/recreation/sauna)
"F" = (
/obj/structure/chair/sofa/bench/left,
/turf/open/floor/wood/tile,
/area/station/commons/fitness/recreation/sauna)
"K" = (
/obj/structure/chair/sofa/bench/right,
/turf/open/floor/wood/tile,
/area/station/commons/fitness/recreation/sauna)
"L" = (
/obj/machinery/vending/clothing,
/obj/machinery/atmospherics/components/unary/vent_scrubber/on/layer2{
	dir = 8
	},
/turf/open/floor/iron,
/area/station/commons/fitness/recreation)
"M" = (
/obj/structure/chair/sofa/bench/left{
	dir = 1
	},
/turf/open/floor/wood/tile,
/area/station/commons/fitness/recreation/sauna)
"N" = (
/obj/machinery/light/warm/directional/west,
/obj/machinery/atmospherics/pipe/smart/manifold4w/supply/hidden/layer4,
/obj/machinery/atmospherics/pipe/smart/manifold4w/scrubbers/hidden/layer2{
	dir = 8
	},
/obj/structure/closet/firecloset/wall{
	pixel_x = -32
	},
/turf/open/floor/wood/tile,
/area/station/commons/fitness/recreation/sauna)
"O" = (
/obj/structure/chair/sofa/bench/right{
	dir = 1
	},
/turf/open/floor/wood/tile,
/area/station/commons/fitness/recreation/sauna)
"Q" = (
/obj/effect/spawner/structure/window/reinforced,
/obj/machinery/door/poddoor/shutters/preopen{
	id = "sauna_priv";
	name = "Tactical Privacy Shutter";
	desc = "Heavy duty, airtight mechanical shutters for the most demanding enterprise resource planning."
	},
/turf/open/floor/plating,
/area/station/commons/fitness/recreation/sauna)
"S" = (
/obj/machinery/atmospherics/pipe/smart/manifold4w/scrubbers/hidden/layer2{
	dir = 8
	},
/obj/machinery/atmospherics/pipe/smart/manifold4w/supply/hidden/layer4,
/obj/structure/cable,
/turf/open/floor/iron,
/area/station/commons/fitness/recreation)
"T" = (
/obj/machinery/atmospherics/pipe/smart/manifold4w/scrubbers/hidden/layer2{
	dir = 8
	},
/obj/machinery/atmospherics/pipe/smart/manifold4w/supply/hidden/layer4,
/obj/structure/cable,
/obj/effect/turf_decal/trimline/green/filled/line{
	dir = 4
	},
/obj/effect/landmark/navigate_destination/sauna,
/turf/open/floor/iron,
/area/station/commons/fitness/recreation)
"V" = (
/obj/machinery/atmospherics/pipe/smart/manifold4w/scrubbers/hidden/layer2{
	dir = 8
	},
/obj/machinery/atmospherics/pipe/smart/manifold4w/supply/hidden/layer4,
/turf/open/floor/wood/tile,
/area/station/commons/fitness/recreation/sauna)
"X" = (
/obj/structure/drain,
/obj/machinery/shower/directional/north,
/obj/structure/curtain,
/turf/open/floor/wood/tile,
/area/station/commons/fitness/recreation/sauna)
"Y" = (
/obj/structure/table/wood,
/obj/structure/towel_bin,
/turf/open/floor/wood/tile,
/area/station/commons/fitness/recreation/sauna)
"Z" = (
/obj/machinery/atmospherics/components/unary/vent_scrubber/on/layer2{
	dir = 1
	},
/turf/open/floor/wood/tile,
/area/station/commons/fitness/recreation/sauna)

(1,1,1) = {"
a
a
v
T
w
A
S
a
a
a
"}
(2,1,1) = {"
B
B
B
y
B
i
L
a
a
a
"}
(3,1,1) = {"
B
n
N
t
B
B
a
a
a
a
"}
(4,1,1) = {"
B
f
V
s
B
B
a
a
a
a
"}
(5,1,1) = {"
B
f
p
Z
X
B
a
a
a
a
"}
(6,1,1) = {"
B
q
Y
o
B
B
a
a
a
m
"}
(7,1,1) = {"
B
s
s
E
B
a
a
a
a
a
"}
(8,1,1) = {"
B
d
g
b
B
a
m
a
a
a
"}
(9,1,1) = {"
Q
K
g
M
B
a
a
a
a
a
"}
(10,1,1) = {"
Q
D
j
r
B
a
a
a
a
a
"}
(11,1,1) = {"
Q
F
c
O
B
a
a
a
a
a
"}
(12,1,1) = {"
B
B
B
B
B
a
a
a
a
a
"}
