//MAP CONVERTED BY dmm2tgm.py THIS HEADER COMMENT PREVENTS RECONVERSION, DO NOT REMOVE
"a" = (
/obj/structure/sign/delam_procedure,
/turf/closed/wall/r_wall,
/area/station/engineering/supermatter)
"b" = (
/obj/effect/spawner/structure/window/reinforced/plasma,
/turf/open/floor/engine,
/area/station/engineering/supermatter)
"z" = (
/turf/open/floor/noslip,
/area/station/engineering/supermatter/room)
"E" = (
/turf/template_noop,
/area/template_noop)
"J" = (
/turf/closed/wall/r_wall,
/area/station/engineering/supermatter)
"L" = (
/turf/template_noop,
/area/station/engineering/supermatter/room)
"O" = (
/obj/machinery/button/delam_scram,
/turf/template_noop,
/area/template_noop)
"Q" = (
/obj/machinery/atmospherics/components/unary/delam_scram/directional/east{
	dir = 8
	},
/turf/template_noop,
/area/template_noop)

(1,1,1) = {"
L
a
"}
(2,1,1) = {"
z
b
"}
(3,1,1) = {"
O
J
"}
(4,1,1) = {"
E
Q
"}
