//MAP CONVERTED BY dmm2tgm.py THIS HEADER COMMENT PREVENTS RECONVERSION, DO NOT REMOVE
"a" = (
/turf/template_noop,
/area/template_noop)
"u" = (
/turf/open/floor/wood,
/area/station/command/corporate_showroom)
"H" = (
/obj/machinery/power/apc/auto_name/directional/north,
/obj/structure/cable,
/turf/open/floor/wood,
/area/station/command/corporate_showroom)
"X" = (
/obj/machinery/atmospherics/components/unary/vent_pump/on/layer4,
/obj/structure/cable,
/turf/open/floor/wood,
/area/station/command/corporate_showroom)

(1,1,1) = {"
a
a
a
a
a
a
a
"}
(2,1,1) = {"
a
H
X
a
a
a
a
"}
(3,1,1) = {"
a
u
u
a
a
a
a
"}
(4,1,1) = {"
a
a
a
a
a
a
a
"}
(5,1,1) = {"
a
a
a
a
a
a
a
"}
