//MAP CONVERTED BY dmm2tgm.py THIS HEADER COMMENT PREVENTS RECONVERSION, DO NOT REMOVE
"a" = (
/turf/template_noop,
/area/template_noop)
"b" = (
/obj/structure/cable,
/obj/machinery/atmospherics/pipe/smart/manifold4w/supply/hidden/layer4,
/obj/structure/disposalpipe/segment{
	dir = 10
	},
/obj/effect/turf_decal/tile/purple{
	dir = 1
	},
/obj/effect/turf_decal/tile/purple,
/obj/machinery/atmospherics/pipe/smart/manifold4w/scrubbers/hidden/layer2,
/turf/open/floor/iron,
/area/station/service/barber)
"c" = (
/obj/machinery/atmospherics/pipe/smart/manifold4w/supply/hidden/layer4,
/obj/structure/cable,
/obj/structure/disposalpipe/segment{
	dir = 4
	},
/obj/machinery/door/airlock/maintenance{
	name = "Barbershop"
	},
/obj/effect/mapping_helpers/airlock/access/all/service/general,
/turf/open/floor/iron,
/area/station/service/barber)
"f" = (
/obj/effect/turf_decal/tile/purple{
	dir = 1
	},
/obj/effect/turf_decal/tile/purple,
/obj/machinery/door/airlock/public/glass,
/obj/machinery/door/poddoor/shutters/preopen{
	id = "barber_shutter";
	name = "Tactical Privacy Shutter";
	desc = "Heavy duty, airtight mechanical shutters for the most demanding enterprise resource planning."
	},
/obj/machinery/atmospherics/pipe/smart/manifold4w/scrubbers/hidden/layer2,
/obj/machinery/atmospherics/pipe/smart/manifold4w/supply/hidden/layer4,
/turf/open/floor/iron,
/area/station/service/barber)
"g" = (
/obj/structure/table/glass,
/obj/effect/turf_decal/tile/purple{
	dir = 1
	},
/obj/effect/turf_decal/tile/purple,
/obj/structure/mirror/directional/east,
/obj/item/reagent_containers/spray/barbers_aid{
	pixel_x = 6
	},
/obj/item/razor{
	pixel_x = -6
	},
/obj/structure/window/reinforced/spawner/directional/south,
/turf/open/floor/iron,
/area/station/service/barber)
"l" = (
/obj/effect/turf_decal/tile/purple{
	dir = 1
	},
/obj/effect/turf_decal/tile/purple,
/obj/machinery/firealarm/directional/west,
/obj/machinery/atmospherics/pipe/smart/manifold4w/scrubbers/hidden/layer2,
/obj/machinery/atmospherics/pipe/smart/manifold4w/supply/hidden/layer4,
/turf/open/floor/iron,
/area/station/service/barber)
"m" = (
/obj/effect/turf_decal/tile/purple{
	dir = 1
	},
/obj/effect/turf_decal/tile/purple,
/obj/machinery/light/warm/directional/south,
/obj/machinery/firealarm/directional/south,
/obj/machinery/atmospherics/components/unary/vent_pump/on/layer4{
	dir = 8
	},
/turf/open/floor/iron,
/area/station/service/barber)
"o" = (
/obj/machinery/light/warm/directional/north,
/obj/effect/turf_decal/tile/purple{
	dir = 1
	},
/obj/effect/turf_decal/tile/purple,
/obj/structure/chair/comfy/barber_chair{
	dir = 4
	},
/turf/open/floor/iron,
/area/station/service/barber)
"t" = (
/obj/structure/ladder,
/obj/effect/turf_decal/tile/purple,
/obj/effect/turf_decal/tile/purple{
	dir = 1
	},
/turf/open/floor/iron,
/area/station/service/barber)
"v" = (
/obj/machinery/atmospherics/pipe/smart/manifold4w/supply/hidden/layer4,
/obj/structure/cable,
/obj/structure/disposalpipe/segment{
	dir = 4
	},
/obj/effect/turf_decal/tile/purple,
/obj/effect/turf_decal/tile/purple{
	dir = 1
	},
/turf/open/floor/iron,
/area/station/service/barber)
"w" = (
/obj/effect/turf_decal/tile/purple{
	dir = 1
	},
/obj/effect/turf_decal/tile/purple,
/obj/effect/landmark/start/barber,
/obj/machinery/atmospherics/components/unary/vent_scrubber/on/layer2{
	dir = 8
	},
/turf/open/floor/iron,
/area/station/service/barber)
"x" = (
/obj/effect/turf_decal/tile/purple{
	dir = 1
	},
/obj/effect/turf_decal/tile/purple,
/obj/machinery/light/warm/directional/south,
/obj/structure/cable,
/obj/machinery/power/apc/auto_name/directional/south,
/turf/open/floor/iron,
/area/station/service/barber)
"z" = (
/obj/effect/turf_decal/tile/purple{
	dir = 1
	},
/obj/effect/turf_decal/tile/purple,
/obj/structure/chair/comfy/barber_chair{
	dir = 4
	},
/turf/open/floor/iron,
/area/station/service/barber)
"B" = (
/turf/closed/wall,
/area/station/service/barber)
"C" = (
/obj/machinery/atmospherics/pipe/smart/manifold4w/supply/hidden/layer4,
/obj/structure/cable,
/obj/structure/disposalpipe/segment{
	dir = 5
	},
/obj/structure/window/reinforced/spawner/directional/south,
/obj/effect/turf_decal/tile/purple{
	dir = 1
	},
/turf/open/floor/iron,
/area/station/service/barber)
"F" = (
/obj/effect/turf_decal/tile/purple{
	dir = 1
	},
/obj/effect/turf_decal/tile/purple,
/obj/structure/sink/directional/east,
/obj/structure/mirror/directional/west,
/obj/structure/extinguisher_cabinet/directional/south,
/turf/open/floor/iron,
/area/station/service/barber)
"G" = (
/obj/machinery/light/small/directional/east,
/obj/structure/table/glass,
/obj/effect/turf_decal/tile/purple{
	dir = 1
	},
/obj/effect/turf_decal/tile/purple,
/obj/item/lipstick/random,
/obj/item/reagent_containers/spray/quantum_hair_dye{
	pixel_x = 6
	},
/obj/machinery/light_switch/directional/east,
/turf/open/floor/iron,
/area/station/service/barber)
"H" = (
/obj/structure/table/glass,
/obj/effect/turf_decal/tile/purple{
	dir = 1
	},
/obj/effect/turf_decal/tile/purple,
/obj/structure/mirror/directional/east,
/obj/item/reagent_containers/dropper,
/obj/item/hairbrush/comb{
	pixel_y = 10
	},
/obj/machinery/airalarm/directional/north,
/turf/open/floor/iron,
/area/station/service/barber)
"I" = (
/obj/effect/turf_decal/tile/purple{
	dir = 1
	},
/obj/effect/turf_decal/tile/purple,
/obj/structure/sink/directional/east,
/obj/structure/mirror/directional/west,
/obj/machinery/atmospherics/pipe/smart/manifold4w/scrubbers/hidden/layer2,
/obj/machinery/atmospherics/pipe/smart/manifold4w/supply/hidden/layer4,
/turf/open/floor/iron,
/area/station/service/barber)
"J" = (
/obj/machinery/atmospherics/pipe/smart/manifold4w/supply/hidden/layer4,
/obj/structure/cable,
/obj/structure/disposalpipe/segment{
	dir = 4
	},
/obj/effect/turf_decal/tile/purple{
	dir = 1
	},
/obj/effect/turf_decal/tile/purple,
/turf/open/floor/iron,
/area/station/service/barber)
"L" = (
/obj/machinery/atmospherics/pipe/smart/manifold4w/scrubbers/hidden/layer2,
/turf/template_noop,
/area/template_noop)
"N" = (
/obj/structure/closet/secure_closet/barber,
/obj/effect/turf_decal/tile/purple{
	dir = 1
	},
/obj/effect/turf_decal/tile/purple,
/turf/open/floor/iron,
/area/station/service/barber)
"O" = (
/obj/machinery/vending/barbervend,
/obj/effect/turf_decal/tile/purple{
	dir = 1
	},
/obj/effect/turf_decal/tile/purple,
/turf/open/floor/iron,
/area/station/service/barber)
"P" = (
/obj/structure/table/glass,
/obj/item/hairbrush,
/obj/effect/turf_decal/tile/purple{
	dir = 1
	},
/obj/effect/turf_decal/tile/purple,
/obj/item/lipstick/random,
/turf/open/floor/iron,
/area/station/service/barber)
"Q" = (
/turf/closed/wall,
/area/station/commons/fitness/recreation)
"R" = (
/obj/effect/turf_decal/tile/purple{
	dir = 1
	},
/obj/machinery/atmospherics/components/unary/vent_pump/on/layer4{
	dir = 1
	},
/obj/structure/cable,
/turf/open/floor/iron,
/area/station/service/barber)
"S" = (
/obj/effect/turf_decal/tile/purple{
	dir = 1
	},
/obj/effect/turf_decal/tile/purple,
/obj/structure/bed/pod,
/turf/open/floor/iron,
/area/station/service/barber)
"U" = (
/obj/structure/cable,
/obj/machinery/atmospherics/pipe/smart/manifold4w/supply/hidden/layer4,
/obj/structure/disposalpipe/segment{
	dir = 8
	},
/obj/machinery/door/airlock/public/glass{
	name = "Barbershop"
	},
/obj/machinery/atmospherics/pipe/smart/manifold4w/scrubbers/hidden/layer2,
/turf/open/floor/iron,
/area/station/service/barber)
"W" = (
/obj/effect/turf_decal/tile/purple{
	dir = 1
	},
/obj/effect/turf_decal/tile/purple,
/obj/structure/chair/office/light{
	dir = 4
	},
/obj/machinery/button/door/directional/north{
	pixel_x = -8;
	id = "barber_shutter";
	name = "Office Privacy Shutters"
	},
/turf/open/floor/iron,
/area/station/service/barber)
"X" = (
/obj/effect/turf_decal/tile/purple{
	dir = 1
	},
/obj/effect/turf_decal/tile/purple,
/obj/item/kirbyplants/random,
/obj/machinery/light_switch/directional/north,
/obj/machinery/atmospherics/components/unary/vent_scrubber/on/layer2,
/turf/open/floor/iron,
/area/station/service/barber)
"Y" = (
/obj/effect/turf_decal/tile/purple{
	dir = 1
	},
/obj/effect/turf_decal/tile/purple,
/obj/effect/landmark/navigate_destination/autoname,
/obj/machinery/atmospherics/pipe/smart/manifold4w/scrubbers/hidden/layer2,
/obj/machinery/atmospherics/pipe/smart/manifold4w/supply/hidden/layer4,
/turf/open/floor/iron,
/area/station/service/barber)

(1,1,1) = {"
a
a
a
a
a
a
L
a
a
a
a
"}
(2,1,1) = {"
a
a
a
a
a
a
L
a
a
a
a
"}
(3,1,1) = {"
a
a
a
a
a
a
L
a
a
a
a
"}
(4,1,1) = {"
a
a
a
a
a
a
L
a
a
a
a
"}
(5,1,1) = {"
a
a
a
a
a
a
L
a
a
a
a
"}
(6,1,1) = {"
B
B
B
B
B
B
U
B
B
B
B
"}
(7,1,1) = {"
B
X
I
f
l
Y
b
C
t
F
B
"}
(8,1,1) = {"
B
W
m
B
o
w
z
J
R
x
B
"}
(9,1,1) = {"
B
S
P
B
H
G
g
v
O
N
B
"}
(10,1,1) = {"
B
B
B
B
B
B
B
c
B
B
B
"}
(11,1,1) = {"
a
a
a
a
B
B
B
a
a
a
Q
"}
