//MAP CONVERTED BY dmm2tgm.py THIS HEADER COMMENT PREVENTS RECONVERSION, DO NOT REMOVE
"a" = (
/turf/template_noop,
/area/template_noop)
"d" = (
/obj/machinery/atmospherics/pipe/smart/manifold4w/scrubbers/hidden/layer2,
/obj/machinery/atmospherics/pipe/smart/manifold4w/supply/hidden/layer4,
/turf/open/floor/glass/reinforced,
/area/station/hallway/secondary/entry)
"k" = (
/obj/docking_port/stationary{
	dir = 2;
	dwidth = 11;
	height = 22;
	name = "SS13: Auxiliary Dock, Station-Port";
	shuttle_id = "whiteship_home";
	width = 35
	},
/turf/template_noop,
/area/template_noop)
"q" = (
/obj/machinery/atmospherics/pipe/smart/manifold4w/supply/hidden/layer4,
/obj/machinery/atmospherics/pipe/smart/manifold4w/scrubbers/hidden/layer2,
/turf/open/floor/iron/dark,
/area/station/hallway/secondary/entry)
"B" = (
/turf/open/floor/glass/reinforced,
/area/station/hallway/secondary/entry)
"C" = (
/obj/docking_port/stationary{
	dheight = 3;
	dir = 8;
	dwidth = 8;
	height = 11;
	shuttle_id = "ferry_home";
	name = "Secondary Station Dock";
	width = 20
	},
/turf/template_noop,
/area/template_noop)
"F" = (
/turf/closed/wall,
/area/station/hallway/secondary/entry)
"G" = (
/turf/open/space/basic,
/area/space)
"J" = (
/obj/machinery/light/directional/west,
/turf/open/floor/iron/dark,
/area/station/hallway/secondary/entry)
"L" = (
/obj/machinery/door/airlock/external{
	name = "Transport Airlock"
	},
/obj/machinery/atmospherics/pipe/smart/manifold4w/supply/hidden/layer4,
/obj/machinery/atmospherics/pipe/smart/manifold4w/scrubbers/hidden/layer2,
/turf/open/floor/plating,
/area/station/hallway/secondary/entry)
"W" = (
/obj/machinery/door/airlock/external{
	name = "Auxiliary Airlock"
	},
/turf/open/floor/plating,
/area/station/hallway/secondary/entry)
"Y" = (
/turf/open/floor/iron/dark,
/area/station/hallway/secondary/entry)

(1,1,1) = {"
a
a
a
L
F
F
F
F
F
F
F
F
F
a
a
a
"}
(2,1,1) = {"
a
a
a
q
Y
J
Y
Y
Y
Y
J
Y
F
a
a
a
"}
(3,1,1) = {"
a
a
d
d
d
d
d
d
d
d
d
d
W
k
a
a
"}
(4,1,1) = {"
a
a
a
Y
Y
Y
Y
Y
Y
Y
Y
Y
F
a
a
a
"}
(5,1,1) = {"
a
a
a
F
F
F
F
F
F
F
B
B
F
a
a
a
"}
(6,1,1) = {"
a
a
a
G
a
a
a
a
a
F
B
B
F
a
a
a
"}
(7,1,1) = {"
a
a
a
a
a
a
a
a
a
F
W
W
F
a
a
a
"}
(8,1,1) = {"
a
a
a
a
a
a
a
a
a
a
a
a
a
a
a
a
"}
(9,1,1) = {"
a
a
a
a
a
a
a
a
a
a
a
a
a
a
a
a
"}
(10,1,1) = {"
a
a
a
a
a
a
a
a
a
a
a
a
a
a
a
a
"}
(11,1,1) = {"
a
a
a
a
a
a
a
a
a
a
a
a
a
a
a
a
"}
(12,1,1) = {"
a
a
a
a
a
a
a
a
a
a
a
C
a
a
a
a
"}
