//MAP CONVERTED BY dmm2tgm.py THIS HEADER COMMENT PREVENTS RECONVERSION, DO NOT REMOVE
"aA" = (
/obj/effect/turf_decal/trimline/green/filled/line,
/obj/machinery/vending/assist,
/turf/open/floor/iron,
/area/station/hallway/primary/starboard)
"bT" = (
/obj/structure/chair/sofa/corp/corner{
	dir = 1
	},
/obj/effect/landmark/start/nanotrasen_consultant,
/turf/open/floor/wood,
/area/station/command/heads_quarters/nt_rep)
"cK" = (
/obj/structure/cable,
/obj/machinery/atmospherics/pipe/smart/manifold4w/scrubbers/hidden/layer2,
/obj/machinery/atmospherics/pipe/smart/manifold4w/supply/hidden/layer4,
/obj/effect/turf_decal/tile/neutral/opposingcorners,
/turf/open/floor/iron/dark,
/area/station/command/heads_quarters/nt_rep)
"dk" = (
/obj/structure/bed/dogbed,
/mob/living/basic/pet/cat/jerry{
	name = "Bailey";
	desc = "The Consultant's trusted companion, ever increasing the profit margin and the amount of scratches on the couch."
	},
/obj/structure/sign/calendar/directional/north,
/turf/open/floor/carpet/red,
/area/station/command/heads_quarters/nt_rep)
"dr" = (
/obj/machinery/atmospherics/pipe/smart/manifold4w/scrubbers/hidden/layer2,
/obj/machinery/atmospherics/pipe/smart/manifold4w/supply/hidden/layer4,
/obj/effect/turf_decal/tile/neutral/opposingcorners,
/turf/open/floor/iron/dark,
/area/station/command/heads_quarters/nt_rep)
"fD" = (
/obj/structure/flora/bush/grassy,
/obj/structure/flora/bush/flowers_pp,
/obj/structure/curtain/cloth/fancy/mechanical{
	icon_state = "bounty-open";
	icon_type = "bounty";
	id = "nt_rep_priv";
	name = "curtain"
	},
/obj/structure/window/reinforced/fulltile,
/obj/structure/cable,
/turf/open/floor/grass,
/area/station/command/heads_quarters/nt_rep)
"hH" = (
/obj/structure/chair/office/tactical{
	dir = 4
	},
/turf/open/floor/wood,
/area/station/command/heads_quarters/nt_rep)
"jT" = (
/obj/structure/cable,
/obj/machinery/atmospherics/pipe/smart/manifold4w/scrubbers/hidden/layer2,
/obj/machinery/atmospherics/pipe/smart/manifold4w/supply/hidden/layer4,
/obj/effect/turf_decal/tile/neutral/opposingcorners,
/obj/effect/turf_decal/siding/dark{
	dir = 8
	},
/turf/open/floor/iron/dark,
/area/station/command/heads_quarters/nt_rep)
"kE" = (
/obj/machinery/button/door/directional/south{
	pixel_x = -2;
	name = "Quarters Door Lock";
	normaldoorcontrol = 1;
	specialfunctions = 4;
	id = "nt_rep_rear_bolt"
	},
/obj/machinery/button/door/directional/south{
	pixel_x = 7;
	id = "nt_rep_rear_priv";
	name = "Quarters Privacy Shutters"
	},
/obj/machinery/light_switch/directional/south{
	pixel_x = -10;
	pixel_y = -24
	},
/obj/machinery/light/small/blacklight/directional/west,
/obj/machinery/atmospherics/components/unary/vent_pump/on/layer4{
	dir = 4
	},
/obj/structure/dresser,
/turf/open/floor/carpet/green,
/area/station/command/heads_quarters/nt_rep)
"kK" = (
/obj/machinery/vending/imported/yangyu,
/turf/template_noop,
/area/template_noop)
"lz" = (
/turf/closed/wall,
/area/station/hallway/primary/starboard)
"lP" = (
/turf/template_noop,
/area/template_noop)
"lR" = (
/obj/machinery/atmospherics/components/unary/vent_scrubber/on/layer2,
/obj/machinery/firealarm/directional/north,
/obj/effect/landmark/start/nanotrasen_consultant,
/turf/open/floor/carpet/green,
/area/station/command/heads_quarters/nt_rep)
"oq" = (
/turf/open/floor/carpet/green,
/area/station/command/heads_quarters/nt_rep)
"pc" = (
/obj/machinery/firealarm/directional/north,
/turf/open/floor/wood,
/area/station/command/heads_quarters/nt_rep)
"qg" = (
/obj/structure/chair/office/tactical{
	dir = 8
	},
/obj/effect/landmark/start/nanotrasen_consultant,
/turf/open/floor/carpet/green,
/area/station/command/heads_quarters/nt_rep)
"qi" = (
/obj/effect/turf_decal/trimline/green/filled/line{
	dir = 8
	},
/obj/machinery/vending/imported/tiziran,
/turf/open/floor/iron,
/area/station/hallway/primary/starboard)
"qj" = (
/obj/structure/table/wood,
/obj/machinery/fax{
	fax_name = "Nanotrasen Consultant's Office";
	name = "Nanotrasen Consultant's Fax Machine"
	},
/obj/item/radio/intercom/directional/north,
/obj/effect/turf_decal/siding/dark{
	dir = 8
	},
/turf/open/floor/carpet/green,
/area/station/command/heads_quarters/nt_rep)
"qL" = (
/obj/effect/turf_decal/trimline/green/filled/line{
	dir = 4
	},
/obj/effect/turf_decal/trimline/green/filled/mid_joiner{
	dir = 4
	},
/obj/machinery/modular_computer/preset/time_clock/directional/east,
/turf/open/floor/iron/large,
/area/station/hallway/primary/central)
"qZ" = (
/obj/machinery/door/airlock/corporate{
	name = "NT Consultant's Office"
	},
/obj/machinery/door/firedoor,
/obj/effect/mapping_helpers/airlock/access/all/cent_com/rep_door,
/obj/effect/mapping_helpers/airlock/unres/delayed{
	dir = 1
	},
/obj/machinery/atmospherics/pipe/smart/manifold4w/scrubbers/hidden/layer2,
/obj/machinery/atmospherics/pipe/smart/manifold4w/supply/hidden/layer4,
/obj/effect/turf_decal/tile/neutral/opposingcorners,
/turf/open/floor/iron/dark,
/area/station/command/heads_quarters/nt_rep)
"sY" = (
/obj/structure/chair/sofa/corp/left{
	dir = 4
	},
/obj/item/newspaper{
	pixel_x = 3;
	pixel_y = -8
	},
/turf/open/floor/wood,
/area/station/command/heads_quarters/nt_rep)
"tA" = (
/obj/effect/turf_decal/trimline/green/filled/line{
	dir = 8
	},
/obj/machinery/vending/imported,
/turf/open/floor/iron,
/area/station/hallway/primary/starboard)
"vB" = (
/obj/machinery/atmospherics/components/unary/vent_pump/on/layer4{
	dir = 1
	},
/obj/effect/turf_decal/tile/neutral/opposingcorners,
/obj/structure/extinguisher_cabinet/directional/south,
/turf/open/floor/iron/dark,
/area/station/command/heads_quarters/nt_rep)
"wQ" = (
/obj/effect/turf_decal/tile/neutral/opposingcorners,
/obj/effect/turf_decal/siding/dark{
	dir = 8
	},
/obj/structure/bookcase/random/nonfiction,
/obj/item/toy/figure/dsquad{
	pixel_x = 6;
	pixel_y = 18
	},
/obj/machinery/camera/directional/south{
	c_tag = "Consultant's Office"
	},
/turf/open/floor/iron/dark,
/area/station/command/heads_quarters/nt_rep)
"yj" = (
/obj/machinery/atmospherics/pipe/smart/manifold4w/supply/hidden/layer4,
/obj/machinery/atmospherics/pipe/smart/manifold4w/scrubbers/hidden/layer2,
/obj/effect/spawner/random/loot/dignitary/consultant,
/turf/open/floor/carpet/green,
/area/station/command/heads_quarters/nt_rep)
"zB" = (
/obj/structure/table/glass,
/obj/item/hand_labeler,
/obj/effect/decal/cleanable/dirt,
/obj/effect/turf_decal/trimline/green/filled/line,
/turf/open/floor/iron,
/area/station/hallway/primary/starboard)
"AE" = (
/obj/machinery/button/curtain{
	id = "nt_rep_priv";
	name = "curtain control";
	pixel_x = 35;
	pixel_y = 10;
	req_access = list("theatre");
	dir = 4
	},
/obj/machinery/button/door/directional/east{
	pixel_y = 10;
	id = "nt_rep_priv";
	name = "Office Shutters Control"
	},
/obj/machinery/light_switch/directional/east,
/obj/structure/filingcabinet/medical{
	pixel_x = -10
	},
/obj/structure/filingcabinet/employment{
	name = "employment forms filing cabinet"
	},
/obj/structure/filingcabinet/medical{
	pixel_x = 10;
	name = "medical records filing cabinet"
	},
/obj/machinery/newscaster/directional/north,
/turf/open/floor/carpet/green,
/area/station/command/heads_quarters/nt_rep)
"Bh" = (
/obj/effect/turf_decal/tile/neutral/opposingcorners,
/turf/open/floor/iron/dark,
/area/station/command/heads_quarters/nt_rep)
"DP" = (
/turf/closed/wall/r_wall,
/area/station/command/heads_quarters/nt_rep)
"EC" = (
/obj/structure/table/wood/fancy/green,
/obj/machinery/chem_dispenser/drinks{
	dir = 8
	},
/turf/open/floor/carpet/red,
/area/station/command/heads_quarters/nt_rep)
"FF" = (
/obj/structure/table/wood,
/obj/effect/turf_decal/siding/dark{
	dir = 8
	},
/obj/item/clipboard{
	pixel_x = 4;
	pixel_y = 3
	},
/obj/item/reagent_containers/cup/glass/mug/nanotrasen{
	pixel_x = 5;
	pixel_y = 5
	},
/obj/item/phone{
	desc = "Supposedly a direct line to Nanotrasen Central Command. It's not even plugged in.";
	pixel_x = -7;
	pixel_y = 9
	},
/turf/open/floor/carpet/green,
/area/station/command/heads_quarters/nt_rep)
"Gp" = (
/obj/structure/table/wood,
/obj/item/clothing/accessory/pocketwatch,
/turf/open/floor/carpet/green,
/area/station/command/heads_quarters/nt_rep)
"GK" = (
/obj/machinery/light_switch/directional/north,
/obj/item/kirbyplants/random,
/turf/open/floor/wood,
/area/station/command/heads_quarters/nt_rep)
"HW" = (
/obj/structure/table/glass,
/obj/item/paper_bin{
	pixel_x = -2;
	pixel_y = 4
	},
/obj/effect/decal/cleanable/dirt,
/obj/effect/turf_decal/trimline/green/filled/line,
/turf/open/floor/iron,
/area/station/hallway/primary/starboard)
"Il" = (
/obj/effect/turf_decal/trimline/green/filled/line,
/obj/structure/table/glass,
/turf/open/floor/iron,
/area/station/hallway/primary/starboard)
"Iv" = (
/obj/machinery/computer/station_goal{
	dir = 8
	},
/turf/open/floor/carpet/green,
/area/station/command/heads_quarters/nt_rep)
"Iw" = (
/obj/machinery/power/apc/auto_name/directional/north,
/obj/structure/cable,
/obj/machinery/atmospherics/pipe/smart/manifold4w/scrubbers/hidden/layer2,
/obj/machinery/atmospherics/pipe/smart/manifold4w/supply/hidden/layer4,
/obj/effect/turf_decal/tile/neutral/opposingcorners,
/obj/machinery/light/warm/directional/north,
/turf/open/floor/iron/dark,
/area/station/command/heads_quarters/nt_rep)
"IS" = (
/turf/closed/wall,
/area/station/hallway/primary/central)
"JX" = (
/obj/machinery/atmospherics/components/unary/vent_scrubber/on/layer2,
/turf/open/floor/wood,
/area/station/command/heads_quarters/nt_rep)
"Ld" = (
/obj/effect/turf_decal/tile/neutral/opposingcorners,
/obj/machinery/airalarm/directional/south,
/obj/item/kirbyplants/random,
/turf/open/floor/iron/dark,
/area/station/command/heads_quarters/nt_rep)
"Mm" = (
/obj/machinery/vending/imported/mothic,
/turf/template_noop,
/area/template_noop)
"MI" = (
/obj/structure/table/glass,
/obj/item/clothing/head/costume/festive,
/obj/effect/decal/cleanable/dirt,
/obj/effect/turf_decal/trimline/green/filled/line,
/turf/open/floor/iron,
/area/station/hallway/primary/starboard)
"NY" = (
/obj/structure/table/glass,
/obj/item/stack/package_wrap,
/obj/effect/decal/cleanable/dirt,
/obj/effect/turf_decal/trimline/green/filled/line,
/turf/open/floor/iron,
/area/station/hallway/primary/starboard)
"Ot" = (
/turf/open/floor/wood,
/area/station/command/heads_quarters/nt_rep)
"Ou" = (
/obj/structure/filingcabinet{
	pixel_x = -10
	},
/obj/structure/grandfatherclock{
	pixel_x = 7
	},
/obj/item/reagent_containers/cup/glass/bottle/whiskey,
/obj/item/cigarette/cigar/cohiba,
/obj/effect/turf_decal/tile/neutral/opposingcorners,
/turf/open/floor/iron/dark,
/area/station/command/heads_quarters/nt_rep)
"QK" = (
/obj/structure/cable,
/obj/machinery/atmospherics/pipe/smart/manifold4w/scrubbers/hidden/layer2,
/obj/machinery/atmospherics/pipe/smart/manifold4w/supply/hidden/layer4,
/turf/open/floor/wood,
/area/station/command/heads_quarters/nt_rep)
"QN" = (
/obj/structure/closet/secure_closet/nanotrasen_consultant,
/obj/item/clothing/accessory/medal/gold/ordom,
/obj/item/clothing/accessory/medal/silver/bureaucracy,
/obj/item/hand_labeler,
/obj/item/clothing/accessory/pocketprotector,
/obj/structure/secure_safe/directional/north,
/obj/item/storage/box/drinkingglasses,
/turf/open/floor/carpet/green,
/area/station/command/heads_quarters/nt_rep)
"SD" = (
/obj/machinery/atmospherics/components/unary/vent_scrubber/on/layer2{
	dir = 1
	},
/obj/effect/turf_decal/tile/neutral/opposingcorners,
/turf/open/floor/iron/dark,
/area/station/command/heads_quarters/nt_rep)
"Tu" = (
/obj/structure/table/wood,
/obj/item/paper_bin{
	pixel_y = 4;
	pixel_x = -5
	},
/obj/item/pen/fourcolor{
	pixel_x = -5;
	pixel_y = 5
	},
/obj/item/pen/fountain{
	pixel_x = -5;
	pixel_y = 5
	},
/obj/item/stamp/granted{
	pixel_y = 12;
	pixel_x = 8
	},
/obj/item/stamp/denied{
	pixel_x = 8;
	pixel_y = 6
	},
/obj/item/stamp/centcom{
	pixel_x = 8
	},
/obj/effect/turf_decal/siding/dark{
	dir = 8
	},
/obj/machinery/atmospherics/components/unary/vent_pump/on/layer4,
/turf/open/floor/carpet/green,
/area/station/command/heads_quarters/nt_rep)
"Ty" = (
/obj/machinery/light/warm/directional/east,
/obj/structure/table/wood/fancy/green,
/obj/machinery/chem_dispenser/drinks/beer{
	dir = 8
	},
/turf/open/floor/carpet/red,
/area/station/command/heads_quarters/nt_rep)
"TL" = (
/obj/structure/cable,
/obj/machinery/door/airlock/corporate{
	name = "NT Consultant's Office";
	id_tag = "nt_rep_front_bolt"
	},
/obj/machinery/atmospherics/pipe/smart/manifold4w/scrubbers/hidden/layer2,
/obj/machinery/atmospherics/pipe/smart/manifold4w/supply/hidden/layer4,
/obj/machinery/door/firedoor,
/obj/machinery/door/poddoor/shutters/preopen{
	id = "nt_rep_front_priv";
	name = "Tactical Privacy Shutter";
	desc = "Heavy duty, airtight mechanical shutters for the most demanding enterprise resource planning."
	},
/obj/effect/mapping_helpers/airlock/unres/delayed{
	dir = 4
	},
/obj/effect/landmark/navigate_destination/autoname,
/obj/effect/mapping_helpers/airlock/access/any/cent_com/rep_or_captain,
/turf/open/floor/wood,
/area/station/command/heads_quarters/nt_rep)
"TQ" = (
/obj/structure/table/glass,
/obj/item/storage/briefcase/secure,
/obj/effect/decal/cleanable/dirt,
/obj/effect/turf_decal/trimline/green/filled/line,
/turf/open/floor/iron,
/area/station/hallway/primary/starboard)
"TV" = (
/obj/structure/table/wood,
/obj/item/storage/box/drinkingglasses,
/obj/machinery/coffeemaker/impressa,
/obj/item/storage/box/coffeepack,
/turf/open/floor/wood,
/area/station/command/heads_quarters/nt_rep)
"Uo" = (
/obj/machinery/photocopier,
/obj/machinery/requests_console/auto_name/directional/north,
/obj/effect/mapping_helpers/requests_console/announcement,
/obj/effect/mapping_helpers/requests_console/information,
/obj/effect/mapping_helpers/requests_console/supplies,
/obj/effect/mapping_helpers/requests_console/assistance,
/turf/open/floor/carpet/green,
/area/station/command/heads_quarters/nt_rep)
"Uq" = (
/obj/machinery/modular_computer/preset/command{
	dir = 8
	},
/obj/machinery/light/warm/directional/east,
/obj/structure/sign/flag/nanotrasen/directional/east,
/turf/open/floor/carpet/green,
/area/station/command/heads_quarters/nt_rep)
"UQ" = (
/obj/structure/table/glass,
/obj/effect/decal/cleanable/dirt,
/obj/effect/turf_decal/trimline/green/filled/line,
/turf/open/floor/iron,
/area/station/hallway/primary/starboard)
"Vb" = (
/obj/machinery/vending/boozeomat,
/turf/closed/wall/r_wall,
/area/station/command/heads_quarters/nt_rep)
"Vm" = (
/obj/structure/bed/double{
	dir = 8
	},
/obj/item/bedsheet/centcom/double,
/obj/machinery/light/small/blacklight/directional/east,
/turf/open/floor/carpet/green,
/area/station/command/heads_quarters/nt_rep)
"Xm" = (
/obj/machinery/light/warm/directional/south,
/obj/structure/chair/sofa/corp/right{
	dir = 1
	},
/turf/open/floor/wood,
/area/station/command/heads_quarters/nt_rep)

(1,1,1) = {"
IS
qL
lP
lP
lP
lP
lP
IS
"}
(2,1,1) = {"
lz
DP
fD
fD
TL
fD
fD
DP
"}
(3,1,1) = {"
MI
DP
GK
Ot
QK
sY
bT
DP
"}
(4,1,1) = {"
TQ
DP
pc
Ot
QK
QK
Xm
DP
"}
(5,1,1) = {"
NY
DP
dk
hH
JX
QK
TV
DP
"}
(6,1,1) = {"
UQ
DP
qj
FF
Tu
jT
wQ
DP
"}
(7,1,1) = {"
zB
DP
Uo
qg
oq
cK
Ou
DP
"}
(8,1,1) = {"
HW
DP
AE
Uq
Iv
cK
Ld
DP
"}
(9,1,1) = {"
Il
DP
DP
DP
Vb
cK
vB
DP
"}
(10,1,1) = {"
Il
DP
QN
kE
DP
Iw
SD
DP
"}
(11,1,1) = {"
Il
DP
lR
yj
qZ
dr
Bh
DP
"}
(12,1,1) = {"
aA
DP
Vm
Gp
DP
EC
Ty
DP
"}
(13,1,1) = {"
lz
DP
DP
DP
DP
DP
DP
DP
"}
(14,1,1) = {"
lP
lP
lP
kK
Mm
tA
qi
lz
"}
