//MAP CONVERTED BY dmm2tgm.py THIS HEADER COMMENT PREVENTS RECONVERSION, DO NOT REMOVE
"a" = (
/turf/template_noop,
/area/template_noop)
"b" = (
/obj/item/kirbyplants/random,
/turf/open/floor/carpet/green,
/area/station/command/heads_quarters/nt_rep)
"c" = (
/obj/structure/table/wood,
/obj/item/table_clock{
	pixel_y = 16;
	pixel_x = 7
	},
/obj/structure/sign/flag/galfed/directional/north,
/turf/open/floor/carpet/green,
/area/station/command/heads_quarters/nt_rep)
"d" = (
/obj/structure/table/glass,
/obj/item/stack/package_wrap,
/obj/effect/decal/cleanable/dirt,
/obj/effect/turf_decal/trimline/green/filled/line,
/turf/open/floor/iron,
/area/station/hallway/primary/starboard)
"e" = (
/obj/structure/table/glass,
/obj/item/hand_labeler,
/obj/effect/decal/cleanable/dirt,
/obj/effect/turf_decal/trimline/green/filled/line,
/turf/open/floor/iron,
/area/station/hallway/primary/starboard)
"f" = (
/obj/effect/turf_decal/siding/wood,
/obj/structure/filingcabinet/security{
	pixel_x = 10
	},
/obj/structure/filingcabinet,
/obj/structure/filingcabinet/medical{
	pixel_x = -10
	},
/turf/open/floor/carpet/green,
/area/station/command/heads_quarters/nt_rep)
"g" = (
/obj/structure/chair/comfy/black{
	dir = 8
	},
/turf/open/floor/wood,
/area/station/command/heads_quarters/nt_rep)
"h" = (
/obj/effect/turf_decal/trimline/green/filled/line,
/obj/machinery/vending/assist,
/turf/open/floor/iron,
/area/station/hallway/primary/starboard)
"i" = (
/obj/machinery/door/airlock/corporate{
	name = "NT Consultant's Office"
	},
/obj/machinery/door/firedoor,
/obj/effect/mapping_helpers/airlock/access/all/cent_com/rep_door,
/obj/effect/mapping_helpers/airlock/unres{
	dir = 1
	},
/obj/machinery/atmospherics/pipe/smart/manifold4w/scrubbers/hidden/layer2,
/obj/machinery/atmospherics/pipe/smart/manifold4w/supply/hidden/layer4,
/turf/open/floor/carpet/green,
/area/station/command/heads_quarters/nt_rep)
"j" = (
/obj/machinery/atmospherics/components/unary/vent_scrubber/on/layer2{
	dir = 1
	},
/turf/open/floor/wood,
/area/station/command/heads_quarters/nt_rep)
"k" = (
/obj/machinery/button/door/directional/north{
	pixel_x = -8;
	id = "nt_rep_front_priv";
	name = "Office Privacy Shutters"
	},
/obj/machinery/button/door/directional/north{
	pixel_x = 1;
	name = "Office Door Lock";
	id = "nt_rep_front_bolt";
	specialfunctions = 4;
	normaldoorcontrol = 1
	},
/obj/machinery/light_switch/directional/north{
	pixel_x = 9;
	pixel_y = 24
	},
/turf/open/floor/carpet/green,
/area/station/command/heads_quarters/nt_rep)
"l" = (
/obj/machinery/airalarm/directional/south,
/obj/machinery/atmospherics/components/unary/vent_pump/on/layer4{
	dir = 1
	},
/turf/open/floor/wood,
/area/station/command/heads_quarters/nt_rep)
"m" = (
/obj/effect/turf_decal/trimline/green/filled/line{
	dir = 8
	},
/obj/machinery/vending/imported,
/turf/open/floor/iron,
/area/station/hallway/primary/starboard)
"n" = (
/obj/machinery/vending/boozeomat,
/turf/open/floor/wood,
/area/station/command/heads_quarters/nt_rep)
"o" = (
/obj/structure/sign/calendar/directional/north,
/turf/open/floor/wood,
/area/station/command/heads_quarters/nt_rep)
"p" = (
/obj/machinery/fax{
	fax_name = "Nanotrasen Consultant's Office";
	name = "Nanotrasen Consultant's Fax Machine"
	},
/obj/structure/table/wood,
/turf/open/floor/carpet/green,
/area/station/command/heads_quarters/nt_rep)
"q" = (
/obj/structure/table/glass,
/obj/item/storage/briefcase/secure,
/obj/effect/decal/cleanable/dirt,
/obj/effect/turf_decal/trimline/green/filled/line,
/turf/open/floor/iron,
/area/station/hallway/primary/starboard)
"r" = (
/obj/structure/cable,
/obj/machinery/door/airlock/corporate{
	name = "NT Consultant's Office";
	id_tag = "nt_rep_front_bolt"
	},
/obj/machinery/atmospherics/pipe/smart/manifold4w/scrubbers/hidden/layer2,
/obj/machinery/atmospherics/pipe/smart/manifold4w/supply/hidden/layer4,
/obj/machinery/door/firedoor,
/obj/effect/mapping_helpers/airlock/access/all/cent_com/rep_door,
/obj/machinery/door/poddoor/shutters/preopen{
	id = "nt_rep_front_priv";
	name = "Tactical Privacy Shutter";
	desc = "Heavy duty, airtight mechanical shutters for the most demanding enterprise resource planning."
	},
/obj/effect/mapping_helpers/airlock/unres{
	dir = 4
	},
/turf/open/floor/wood,
/area/station/command/heads_quarters/nt_rep)
"s" = (
/obj/effect/turf_decal/trimline/green/filled/line{
	dir = 4
	},
/obj/effect/turf_decal/trimline/green/filled/mid_joiner{
	dir = 4
	},
/obj/machinery/modular_computer/preset/time_clock/directional/east,
/turf/open/floor/iron/large,
/area/station/hallway/primary/central)
"t" = (
/obj/structure/table/glass,
/obj/item/paper_bin{
	pixel_x = -2;
	pixel_y = 4
	},
/obj/effect/decal/cleanable/dirt,
/obj/effect/turf_decal/trimline/green/filled/line,
/turf/open/floor/iron,
/area/station/hallway/primary/starboard)
"u" = (
/obj/machinery/modular_computer/preset/command{
	dir = 8
	},
/obj/machinery/light/warm/directional/east,
/turf/open/floor/carpet/green,
/area/station/command/heads_quarters/nt_rep)
"v" = (
/turf/open/floor/carpet/green,
/area/station/command/heads_quarters/nt_rep)
"w" = (
/obj/effect/spawner/structure/window/reinforced,
/obj/structure/cable,
/obj/machinery/door/poddoor/shutters/preopen{
	id = "nt_rep_front_priv";
	name = "Tactical Privacy Shutter";
	desc = "Heavy duty, airtight mechanical shutters for the most demanding enterprise resource planning."
	},
/turf/open/floor/plating,
/area/station/command/heads_quarters/nt_rep)
"x" = (
/obj/machinery/atmospherics/pipe/smart/manifold4w/scrubbers/hidden/layer2,
/obj/machinery/atmospherics/pipe/smart/manifold4w/supply/hidden/layer4,
/turf/open/floor/carpet/green,
/area/station/command/heads_quarters/nt_rep)
"y" = (
/obj/structure/table/wood,
/obj/machinery/light/warm/directional/east,
/turf/open/floor/wood,
/area/station/command/heads_quarters/nt_rep)
"z" = (
/obj/machinery/photocopier,
/obj/machinery/light_switch/directional/north,
/turf/open/floor/wood,
/area/station/command/heads_quarters/nt_rep)
"A" = (
/obj/structure/closet/secure_closet/nanotrasen_consultant,
/obj/item/assembly/flash/handheld,
/turf/open/floor/carpet/green,
/area/station/command/heads_quarters/nt_rep)
"B" = (
/obj/machinery/atmospherics/components/unary/vent_scrubber/on/layer2,
/turf/open/floor/carpet/green,
/area/station/command/heads_quarters/nt_rep)
"C" = (
/obj/machinery/vending/imported/yangyu,
/turf/template_noop,
/area/template_noop)
"D" = (
/obj/effect/landmark/start/nanotrasen_consultant,
/obj/structure/chair/comfy/black{
	dir = 4
	},
/turf/open/floor/wood,
/area/station/command/heads_quarters/nt_rep)
"E" = (
/obj/machinery/atmospherics/pipe/smart/manifold4w/scrubbers/hidden/layer2,
/obj/machinery/atmospherics/pipe/smart/manifold4w/supply/hidden/layer4,
/turf/open/floor/wood,
/area/station/command/heads_quarters/nt_rep)
"F" = (
/obj/effect/turf_decal/trimline/green/filled/line{
	dir = 8
	},
/obj/machinery/vending/imported/tiziran,
/turf/open/floor/iron,
/area/station/hallway/primary/starboard)
"G" = (
/obj/structure/table/wood,
/obj/item/paper_bin/carbon{
	pixel_y = 4;
	pixel_x = -4
	},
/obj/item/pen/fountain{
	pixel_x = -4;
	pixel_y = 6
	},
/obj/item/stamp{
	pixel_x = 8;
	pixel_y = 8
	},
/obj/item/stamp/denied{
	pixel_x = 8
	},
/obj/item/stamp/centcom{
	pixel_y = 10
	},
/turf/open/floor/carpet/green,
/area/station/command/heads_quarters/nt_rep)
"H" = (
/obj/structure/table/glass,
/obj/effect/decal/cleanable/dirt,
/obj/effect/turf_decal/trimline/green/filled/line,
/turf/open/floor/iron,
/area/station/hallway/primary/starboard)
"I" = (
/obj/structure/extinguisher_cabinet/directional/south,
/turf/open/floor/wood,
/area/station/command/heads_quarters/nt_rep)
"J" = (
/obj/machinery/vending/imported/mothic,
/turf/template_noop,
/area/template_noop)
"K" = (
/turf/closed/wall/r_wall,
/area/station/command/heads_quarters/nt_rep)
"L" = (
/obj/machinery/light/warm/directional/south,
/obj/structure/table/wood,
/turf/open/floor/wood,
/area/station/command/heads_quarters/nt_rep)
"M" = (
/obj/structure/cable,
/obj/machinery/atmospherics/pipe/smart/manifold4w/scrubbers/hidden/layer2,
/obj/machinery/atmospherics/pipe/smart/manifold4w/supply/hidden/layer4,
/turf/open/floor/wood,
/area/station/command/heads_quarters/nt_rep)
"N" = (
/obj/machinery/power/apc/auto_name/directional/north,
/obj/structure/cable,
/obj/machinery/atmospherics/pipe/smart/manifold4w/scrubbers/hidden/layer2,
/obj/machinery/atmospherics/pipe/smart/manifold4w/supply/hidden/layer4,
/turf/open/floor/wood,
/area/station/command/heads_quarters/nt_rep)
"O" = (
/turf/closed/wall,
/area/station/hallway/primary/starboard)
"P" = (
/obj/structure/sign/flag/nanotrasen/directional/south,
/turf/open/floor/wood,
/area/station/command/heads_quarters/nt_rep)
"Q" = (
/obj/machinery/newscaster/directional/north,
/obj/structure/cable,
/obj/machinery/atmospherics/pipe/smart/manifold4w/scrubbers/hidden/layer2,
/obj/machinery/atmospherics/pipe/smart/manifold4w/supply/hidden/layer4,
/turf/open/floor/wood,
/area/station/command/heads_quarters/nt_rep)
"R" = (
/obj/structure/table/glass,
/obj/item/clothing/head/costume/festive,
/obj/effect/decal/cleanable/dirt,
/obj/effect/turf_decal/trimline/green/filled/line,
/turf/open/floor/iron,
/area/station/hallway/primary/starboard)
"S" = (
/obj/machinery/button/door/directional/south{
	pixel_x = -2;
	name = "Quarters Door Lock";
	normaldoorcontrol = 1;
	specialfunctions = 4;
	id = "nt_rep_rear_bolt"
	},
/obj/machinery/button/door/directional/south{
	pixel_x = 7;
	id = "nt_rep_rear_priv";
	name = "Quarters Privacy Shutters"
	},
/obj/machinery/light_switch/directional/south{
	pixel_x = -10;
	pixel_y = -24
	},
/obj/machinery/light/small/blacklight/directional/west,
/obj/item/radio/intercom/directional/west,
/obj/machinery/atmospherics/components/unary/vent_pump/on/layer4{
	dir = 4
	},
/turf/open/floor/carpet/green,
/area/station/command/heads_quarters/nt_rep)
"T" = (
/obj/machinery/firealarm/directional/south,
/turf/open/floor/wood,
/area/station/command/heads_quarters/nt_rep)
"U" = (
/turf/open/floor/wood,
/area/station/command/heads_quarters/nt_rep)
"V" = (
/obj/structure/chair/comfy/beige{
	dir = 4
	},
/turf/open/floor/carpet/green,
/area/station/command/heads_quarters/nt_rep)
"W" = (
/obj/structure/bed/double{
	dir = 8
	},
/obj/item/bedsheet/centcom/double,
/obj/effect/landmark/start/nanotrasen_consultant,
/obj/machinery/light/small/blacklight/directional/east,
/turf/open/floor/carpet/green,
/area/station/command/heads_quarters/nt_rep)
"X" = (
/obj/effect/turf_decal/trimline/green/filled/line,
/obj/structure/table/glass,
/turf/open/floor/iron,
/area/station/hallway/primary/starboard)
"Y" = (
/obj/structure/table/wood,
/turf/open/floor/carpet/green,
/area/station/command/heads_quarters/nt_rep)
"Z" = (
/obj/structure/chair/office/tactical{
	dir = 8
	},
/obj/effect/landmark/start/nanotrasen_consultant,
/turf/open/floor/carpet/green,
/area/station/command/heads_quarters/nt_rep)

(1,1,1) = {"
a
s
a
a
a
a
a
a
"}
(2,1,1) = {"
O
K
w
w
r
w
w
K
"}
(3,1,1) = {"
R
K
z
U
M
U
D
K
"}
(4,1,1) = {"
q
K
o
U
M
M
L
K
"}
(5,1,1) = {"
d
K
b
V
V
M
g
K
"}
(6,1,1) = {"
H
K
c
Y
G
M
T
K
"}
(7,1,1) = {"
e
K
k
Z
v
M
I
K
"}
(8,1,1) = {"
t
K
f
u
p
M
P
K
"}
(9,1,1) = {"
X
K
K
K
K
Q
l
K
"}
(10,1,1) = {"
X
K
A
S
K
N
j
K
"}
(11,1,1) = {"
X
K
B
x
i
E
U
K
"}
(12,1,1) = {"
h
K
W
Y
K
n
y
K
"}
(13,1,1) = {"
O
K
K
K
K
K
K
K
"}
(14,1,1) = {"
a
a
a
C
J
m
F
a
"}
