//MAP CONVERTED BY dmm2tgm.py THIS HEADER COMMENT PREVENTS RECONVERSION, DO NOT REMOVE
"aA" = (
/obj/effect/turf_decal/trimline/green/filled/line,
/obj/machinery/vending/assist,
/turf/open/floor/iron,
/area/station/hallway/primary/starboard)
"bT" = (
/obj/effect/landmark/start/nanotrasen_consultant,
/obj/structure/chair/comfy/black{
	dir = 4
	},
/turf/open/floor/wood,
/area/station/command/heads_quarters/nt_rep)
"cK" = (
/obj/machinery/newscaster/directional/north,
/obj/structure/cable,
/obj/machinery/atmospherics/pipe/smart/manifold4w/scrubbers/hidden/layer2,
/obj/machinery/atmospherics/pipe/smart/manifold4w/supply/hidden/layer4,
/turf/open/floor/wood,
/area/station/command/heads_quarters/nt_rep)
"dk" = (
/obj/item/kirbyplants/random,
/turf/open/floor/carpet/green,
/area/station/command/heads_quarters/nt_rep)
"dr" = (
/obj/machinery/atmospherics/pipe/smart/manifold4w/scrubbers/hidden/layer2,
/obj/machinery/atmospherics/pipe/smart/manifold4w/supply/hidden/layer4,
/turf/open/floor/wood,
/area/station/command/heads_quarters/nt_rep)
"fD" = (
/obj/effect/spawner/structure/window/reinforced,
/obj/structure/cable,
/obj/machinery/door/poddoor/shutters/preopen{
	id = "nt_rep_front_priv";
	name = "Tactical Privacy Shutter";
	desc = "Heavy duty, airtight mechanical shutters for the most demanding enterprise resource planning."
	},
/turf/open/floor/plating,
/area/station/command/heads_quarters/nt_rep)
"hH" = (
/obj/structure/chair/comfy/beige{
	dir = 4
	},
/turf/open/floor/carpet/green,
/area/station/command/heads_quarters/nt_rep)
"kE" = (
/obj/machinery/button/door/directional/south{
	pixel_x = -2;
	name = "Quarters Door Lock";
	normaldoorcontrol = 1;
	specialfunctions = 4;
	id = "nt_rep_rear_bolt"
	},
/obj/machinery/button/door/directional/south{
	pixel_x = 7;
	id = "nt_rep_rear_priv";
	name = "Quarters Privacy Shutters"
	},
/obj/machinery/light_switch/directional/south{
	pixel_x = -10;
	pixel_y = -24
	},
/obj/machinery/light/small/blacklight/directional/west,
/obj/item/radio/intercom/directional/west,
/obj/machinery/atmospherics/components/unary/vent_pump/on/layer4{
	dir = 4
	},
/turf/open/floor/carpet/green,
/area/station/command/heads_quarters/nt_rep)
"kK" = (
/obj/machinery/vending/imported/yangyu,
/turf/template_noop,
/area/template_noop)
"lz" = (
/turf/closed/wall,
/area/station/hallway/primary/starboard)
"lP" = (
/turf/template_noop,
/area/template_noop)
"lR" = (
/obj/machinery/atmospherics/components/unary/vent_scrubber/on/layer2,
/obj/machinery/firealarm/directional/north,
/turf/open/floor/carpet/green,
/area/station/command/heads_quarters/nt_rep)
"oq" = (
/obj/effect/landmark/navigate_destination/autoname,
/turf/open/floor/carpet/green,
/area/station/command/heads_quarters/nt_rep)
"pc" = (
/obj/structure/sign/calendar/directional/north,
/turf/open/floor/wood,
/area/station/command/heads_quarters/nt_rep)
"qg" = (
/obj/structure/chair/office/tactical{
	dir = 8
	},
/obj/effect/landmark/start/nanotrasen_consultant,
/turf/open/floor/carpet/green,
/area/station/command/heads_quarters/nt_rep)
"qi" = (
/obj/effect/turf_decal/trimline/green/filled/line{
	dir = 8
	},
/obj/machinery/vending/imported/tiziran,
/turf/open/floor/iron,
/area/station/hallway/primary/starboard)
"qj" = (
/obj/structure/table/wood,
/obj/item/table_clock{
	pixel_y = 16;
	pixel_x = 7
	},
/obj/structure/sign/flag/galfed/directional/north,
/turf/open/floor/carpet/green,
/area/station/command/heads_quarters/nt_rep)
"qL" = (
/obj/effect/turf_decal/trimline/green/filled/line{
	dir = 4
	},
/obj/effect/turf_decal/trimline/green/filled/mid_joiner{
	dir = 4
	},
/obj/machinery/modular_computer/preset/time_clock/directional/east,
/turf/open/floor/iron/large,
/area/station/hallway/primary/central)
"qZ" = (
/obj/machinery/door/airlock/corporate{
	name = "NT Consultant's Office"
	},
/obj/machinery/door/firedoor,
/obj/effect/mapping_helpers/airlock/access/all/cent_com/rep_door,
/obj/effect/mapping_helpers/airlock/unres{
	dir = 1
	},
/obj/machinery/atmospherics/pipe/smart/manifold4w/scrubbers/hidden/layer2,
/obj/machinery/atmospherics/pipe/smart/manifold4w/supply/hidden/layer4,
/turf/open/floor/carpet/green,
/area/station/command/heads_quarters/nt_rep)
"tA" = (
/obj/effect/turf_decal/trimline/green/filled/line{
	dir = 8
	},
/obj/machinery/vending/imported,
/turf/open/floor/iron,
/area/station/hallway/primary/starboard)
"vB" = (
/obj/machinery/airalarm/directional/south,
/obj/machinery/atmospherics/components/unary/vent_pump/on/layer4{
	dir = 1
	},
/turf/open/floor/wood,
/area/station/command/heads_quarters/nt_rep)
"wQ" = (
/obj/machinery/firealarm/directional/south,
/turf/open/floor/wood,
/area/station/command/heads_quarters/nt_rep)
"yj" = (
/obj/machinery/atmospherics/pipe/smart/manifold4w/scrubbers/hidden/layer2,
/obj/machinery/atmospherics/pipe/smart/manifold4w/supply/hidden/layer4,
/turf/open/floor/carpet/green,
/area/station/command/heads_quarters/nt_rep)
"zB" = (
/obj/structure/table/glass,
/obj/item/hand_labeler,
/obj/effect/decal/cleanable/dirt,
/obj/effect/turf_decal/trimline/green/filled/line,
/turf/open/floor/iron,
/area/station/hallway/primary/starboard)
"AE" = (
/obj/effect/turf_decal/siding/wood,
/obj/structure/filingcabinet/security{
	pixel_x = 10
	},
/obj/structure/filingcabinet,
/obj/structure/filingcabinet/medical{
	pixel_x = -10
	},
/turf/open/floor/carpet/green,
/area/station/command/heads_quarters/nt_rep)
"DP" = (
/turf/closed/wall/r_wall,
/area/station/command/heads_quarters/nt_rep)
"EC" = (
/obj/machinery/vending/boozeomat,
/turf/open/floor/wood,
/area/station/command/heads_quarters/nt_rep)
"Gp" = (
/obj/structure/table/wood,
/turf/open/floor/carpet/green,
/area/station/command/heads_quarters/nt_rep)
"GK" = (
/obj/machinery/photocopier,
/obj/machinery/light_switch/directional/north,
/turf/open/floor/wood,
/area/station/command/heads_quarters/nt_rep)
"HW" = (
/obj/structure/table/glass,
/obj/item/paper_bin{
	pixel_x = -2;
	pixel_y = 4
	},
/obj/effect/decal/cleanable/dirt,
/obj/effect/turf_decal/trimline/green/filled/line,
/turf/open/floor/iron,
/area/station/hallway/primary/starboard)
"Il" = (
/obj/effect/turf_decal/trimline/green/filled/line,
/obj/structure/table/glass,
/turf/open/floor/iron,
/area/station/hallway/primary/starboard)
"Iv" = (
/obj/machinery/fax{
	fax_name = "Nanotrasen Consultant's Office";
	name = "Nanotrasen Consultant's Fax Machine"
	},
/obj/structure/table/wood,
/turf/open/floor/carpet/green,
/area/station/command/heads_quarters/nt_rep)
"Iw" = (
/obj/machinery/power/apc/auto_name/directional/north,
/obj/structure/cable,
/obj/machinery/atmospherics/pipe/smart/manifold4w/scrubbers/hidden/layer2,
/obj/machinery/atmospherics/pipe/smart/manifold4w/supply/hidden/layer4,
/turf/open/floor/wood,
/area/station/command/heads_quarters/nt_rep)
"IS" = (
/turf/closed/wall,
/area/station/hallway/primary/central)
"Ld" = (
/obj/structure/sign/flag/nanotrasen/directional/south,
/turf/open/floor/wood,
/area/station/command/heads_quarters/nt_rep)
"Mm" = (
/obj/machinery/vending/imported/mothic,
/turf/template_noop,
/area/template_noop)
"MI" = (
/obj/structure/table/glass,
/obj/item/clothing/head/costume/festive,
/obj/effect/decal/cleanable/dirt,
/obj/effect/turf_decal/trimline/green/filled/line,
/turf/open/floor/iron,
/area/station/hallway/primary/starboard)
"NY" = (
/obj/structure/table/glass,
/obj/item/stack/package_wrap,
/obj/effect/decal/cleanable/dirt,
/obj/effect/turf_decal/trimline/green/filled/line,
/turf/open/floor/iron,
/area/station/hallway/primary/starboard)
"Ot" = (
/turf/open/floor/wood,
/area/station/command/heads_quarters/nt_rep)
"Ou" = (
/obj/structure/extinguisher_cabinet/directional/south,
/turf/open/floor/wood,
/area/station/command/heads_quarters/nt_rep)
"QK" = (
/obj/structure/cable,
/obj/machinery/atmospherics/pipe/smart/manifold4w/scrubbers/hidden/layer2,
/obj/machinery/atmospherics/pipe/smart/manifold4w/supply/hidden/layer4,
/turf/open/floor/wood,
/area/station/command/heads_quarters/nt_rep)
"QN" = (
/obj/structure/closet/secure_closet/nanotrasen_consultant,
/obj/item/assembly/flash/handheld,
/turf/open/floor/carpet/green,
/area/station/command/heads_quarters/nt_rep)
"SD" = (
/obj/machinery/atmospherics/components/unary/vent_scrubber/on/layer2{
	dir = 1
	},
/turf/open/floor/wood,
/area/station/command/heads_quarters/nt_rep)
"Tu" = (
/obj/structure/table/wood,
/obj/item/paper_bin/carbon{
	pixel_y = 4;
	pixel_x = -4
	},
/obj/item/pen/fountain{
	pixel_x = -4;
	pixel_y = 6
	},
/obj/item/stamp{
	pixel_x = 8;
	pixel_y = 8
	},
/obj/item/stamp/denied{
	pixel_x = 8
	},
/obj/item/stamp/centcom{
	pixel_y = 10
	},
/turf/open/floor/carpet/green,
/area/station/command/heads_quarters/nt_rep)
"Ty" = (
/obj/structure/table/wood,
/obj/machinery/light/warm/directional/east,
/turf/open/floor/wood,
/area/station/command/heads_quarters/nt_rep)
"TL" = (
/obj/structure/cable,
/obj/machinery/door/airlock/corporate{
	name = "NT Consultant's Office";
	id_tag = "nt_rep_front_bolt"
	},
/obj/machinery/atmospherics/pipe/smart/manifold4w/scrubbers/hidden/layer2,
/obj/machinery/atmospherics/pipe/smart/manifold4w/supply/hidden/layer4,
/obj/machinery/door/firedoor,
/obj/effect/mapping_helpers/airlock/access/all/cent_com/rep_door,
/obj/machinery/door/poddoor/shutters/preopen{
	id = "nt_rep_front_priv";
	name = "Tactical Privacy Shutter";
	desc = "Heavy duty, airtight mechanical shutters for the most demanding enterprise resource planning."
	},
/obj/effect/mapping_helpers/airlock/unres{
	dir = 4
	},
/turf/open/floor/wood,
/area/station/command/heads_quarters/nt_rep)
"TQ" = (
/obj/structure/table/glass,
/obj/item/storage/briefcase/secure,
/obj/effect/decal/cleanable/dirt,
/obj/effect/turf_decal/trimline/green/filled/line,
/turf/open/floor/iron,
/area/station/hallway/primary/starboard)
"TV" = (
/obj/structure/chair/comfy/black{
	dir = 8
	},
/turf/open/floor/wood,
/area/station/command/heads_quarters/nt_rep)
"Uo" = (
/obj/machinery/button/door/directional/north{
	pixel_x = -8;
	id = "nt_rep_front_priv";
	name = "Office Privacy Shutters"
	},
/obj/machinery/button/door/directional/north{
	pixel_x = 1;
	name = "Office Door Lock";
	id = "nt_rep_front_bolt";
	specialfunctions = 4;
	normaldoorcontrol = 1
	},
/obj/machinery/light_switch/directional/north{
	pixel_x = 9;
	pixel_y = 24
	},
/turf/open/floor/carpet/green,
/area/station/command/heads_quarters/nt_rep)
"Uq" = (
/obj/machinery/modular_computer/preset/command{
	dir = 8
	},
/obj/machinery/light/warm/directional/east,
/turf/open/floor/carpet/green,
/area/station/command/heads_quarters/nt_rep)
"UQ" = (
/obj/structure/table/glass,
/obj/effect/decal/cleanable/dirt,
/obj/effect/turf_decal/trimline/green/filled/line,
/turf/open/floor/iron,
/area/station/hallway/primary/starboard)
"Vm" = (
/obj/structure/bed/double{
	dir = 8
	},
/obj/item/bedsheet/centcom/double,
/obj/effect/landmark/start/nanotrasen_consultant,
/obj/machinery/light/small/blacklight/directional/east,
/turf/open/floor/carpet/green,
/area/station/command/heads_quarters/nt_rep)
"Xm" = (
/obj/machinery/light/warm/directional/south,
/obj/structure/table/wood,
/turf/open/floor/wood,
/area/station/command/heads_quarters/nt_rep)

(1,1,1) = {"
IS
qL
lP
lP
lP
lP
lP
IS
"}
(2,1,1) = {"
lz
DP
fD
fD
TL
fD
fD
DP
"}
(3,1,1) = {"
MI
DP
GK
Ot
QK
Ot
bT
DP
"}
(4,1,1) = {"
TQ
DP
pc
Ot
QK
QK
Xm
DP
"}
(5,1,1) = {"
NY
DP
dk
hH
hH
QK
TV
DP
"}
(6,1,1) = {"
UQ
DP
qj
Gp
Tu
QK
wQ
DP
"}
(7,1,1) = {"
zB
DP
Uo
qg
oq
QK
Ou
DP
"}
(8,1,1) = {"
HW
DP
AE
Uq
Iv
QK
Ld
DP
"}
(9,1,1) = {"
Il
DP
DP
DP
DP
cK
vB
DP
"}
(10,1,1) = {"
Il
DP
QN
kE
DP
Iw
SD
DP
"}
(11,1,1) = {"
Il
DP
lR
yj
qZ
dr
Ot
DP
"}
(12,1,1) = {"
aA
DP
Vm
Gp
DP
EC
Ty
DP
"}
(13,1,1) = {"
lz
DP
DP
DP
DP
DP
DP
DP
"}
(14,1,1) = {"
lP
lP
lP
kK
Mm
tA
qi
lz
"}
