//MAP CONVERTED BY dmm2tgm.py THIS HEADER COMMENT PREVENTS RECONVERSION, DO NOT REMOVE
"aF" = (
/obj/item/paper_bin/carbon,
/obj/item/pen,
/obj/structure/table/reinforced,
/obj/machinery/light/no_nightlight/directional/west,
/turf/open/floor/iron/shuttle/evac,
/area/shuttle/transport)
"cz" = (
/obj/effect/turf_decal/stripes/white/line{
	dir = 4;
	color = "#ffff81"
	},
/obj/structure/chair/comfy/shuttle{
	dir = 8
	},
/obj/machinery/computer/crew{
	dir = 4;
	density = 0;
	pixel_x = -24
	},
/turf/open/floor/iron/shuttle/evac,
/area/shuttle/transport)
"fT" = (
/obj/effect/turf_decal/bot,
/obj/machinery/light/no_nightlight/directional/south,
/obj/structure/closet/emcloset/wall/empty{
	pixel_x = 26
	},
/obj/item/storage/toolbox/emergency,
/obj/item/tank/internals/emergency_oxygen/engi,
/obj/item/tank/internals/emergency_oxygen/engi,
/obj/item/clothing/mask/gas/alt,
/obj/item/clothing/mask/gas/alt,
/turf/open/floor/iron/shuttle/evac,
/area/shuttle/transport)
"go" = (
/obj/effect/turf_decal/stripes/white/line{
	dir = 8;
	color = "#ffff81"
	},
/obj/effect/turf_decal/caution{
	dir = 4
	},
/turf/open/floor/iron/shuttle/ferry{
	dir = 4;
	icon_state = "floor"
	},
/area/shuttle/transport)
"gS" = (
/obj/structure/marker_beacon/burgundy,
/obj/structure/fluff/metalpole/end{
	pixel_y = -32
	},
/turf/closed/wall/mineral/titanium/spaceship/nodiagonal,
/area/shuttle/transport)
"ht" = (
/obj/structure/chair/comfy/shuttle{
	dir = 4
	},
/obj/machinery/computer/crew{
	dir = 8;
	density = 0;
	pixel_x = 24
	},
/obj/effect/turf_decal/stripes/white/line{
	dir = 8;
	color = "#ffff81"
	},
/turf/open/floor/iron/shuttle/evac,
/area/shuttle/transport)
"hw" = (
/obj/effect/spawner/structure/window/reinforced/shuttle,
/turf/open/indestructible/plating,
/area/shuttle/transport)
"jG" = (
/obj/machinery/light/no_nightlight/directional/west,
/obj/structure/chair/comfy/shuttle{
	dir = 4
	},
/turf/open/floor/iron/shuttle/evac,
/area/shuttle/transport)
"jP" = (
/turf/open/floor/iron/shuttle/ferry{
	dir = 4;
	icon_state = "floor"
	},
/area/shuttle/transport)
"nC" = (
/obj/structure/marker_beacon/burgundy,
/turf/closed/wall/mineral/titanium/nodiagonal,
/area/shuttle/transport)
"oR" = (
/obj/machinery/light/no_nightlight/directional/north,
/obj/structure/closet/emcloset/wall{
	pixel_x = 26
	},
/obj/effect/turf_decal/bot,
/obj/structure/chair/comfy/shuttle{
	dir = 8
	},
/turf/open/floor/iron/shuttle/evac,
/area/shuttle/transport)
"rq" = (
/obj/effect/turf_decal/stripes/white/line{
	dir = 8;
	color = "#ffff81"
	},
/obj/effect/turf_decal/caution{
	dir = 4
	},
/turf/open/floor/iron/shuttle/ferry{
	dir = 8;
	icon_state = "floor"
	},
/area/shuttle/transport)
"sk" = (
/obj/structure/table/reinforced,
/obj/item/folder,
/obj/item/crowbar,
/obj/machinery/light/no_nightlight/directional/east,
/turf/open/floor/iron/shuttle/evac,
/area/shuttle/transport)
"tB" = (
/obj/effect/turf_decal/stripes/white/line{
	dir = 4;
	color = "#ffff81"
	},
/obj/effect/turf_decal/caution{
	dir = 8
	},
/turf/open/floor/iron/shuttle/ferry{
	dir = 8;
	icon_state = "floor"
	},
/area/shuttle/transport)
"yF" = (
/obj/machinery/light/no_nightlight/directional/east,
/obj/structure/chair/comfy/shuttle{
	dir = 8
	},
/turf/open/floor/iron/shuttle/evac,
/area/shuttle/transport)
"zs" = (
/obj/effect/turf_decal/stripes/white/line{
	dir = 2;
	color = "#ffff81"
	},
/obj/machinery/power/shuttle_engine/propulsion,
/turf/open/indestructible/plating,
/area/shuttle/transport)
"By" = (
/obj/structure/fans/tiny/forcefield{
	dir = 8
	},
/obj/machinery/door/airlock/grunge,
/turf/open/floor/iron/shuttle/ferry{
	dir = 8;
	icon_state = "floor"
	},
/area/shuttle/transport)
"CC" = (
/turf/closed/wall/mineral/titanium/nodiagonal,
/area/shuttle/transport)
"CM" = (
/turf/open/floor/iron/shuttle/ferry{
	dir = 8;
	icon_state = "floor"
	},
/area/shuttle/transport)
"Ed" = (
/obj/effect/turf_decal/stripes/white/line{
	dir = 4;
	color = "#ffff81"
	},
/obj/structure/chair/comfy/shuttle{
	dir = 8
	},
/obj/machinery/computer/security{
	dir = 4;
	density = 0;
	pixel_x = -24
	},
/turf/open/floor/iron/shuttle/evac,
/area/shuttle/transport)
"Ei" = (
/obj/structure/closet/crate,
/turf/open/floor/iron/shuttle/evac,
/area/shuttle/transport)
"El" = (
/turf/closed/wall/mineral/titanium/spaceship,
/area/shuttle/transport)
"Fz" = (
/obj/machinery/power/shuttle_engine/heater,
/turf/closed/wall/mineral/titanium/spaceship/nodiagonal,
/area/shuttle/transport)
"GQ" = (
/obj/effect/turf_decal/stripes/white/line{
	dir = 4;
	color = "#ffff81"
	},
/obj/effect/turf_decal/caution{
	dir = 8
	},
/turf/open/floor/iron/shuttle/ferry{
	dir = 4;
	icon_state = "floor"
	},
/area/shuttle/transport)
"Hn" = (
/turf/closed/wall/mineral/titanium/spaceship/nodiagonal,
/area/shuttle/transport)
"Io" = (
/obj/structure/chair/comfy/shuttle{
	dir = 1
	},
/obj/machinery/computer/shuttle/ferry/request{
	dir = 2;
	pixel_y = 24;
	density = 0
	},
/turf/open/floor/iron/shuttle/ferry{
	dir = 4;
	icon_state = "floor"
	},
/area/shuttle/transport)
"Mr" = (
/turf/closed/wall/mineral/titanium,
/area/shuttle/transport)
"ON" = (
/turf/template_noop,
/area/template_noop)
"Qg" = (
/obj/structure/fans/tiny/forcefield{
	dir = 8
	},
/obj/docking_port/mobile{
	dir = 8;
	shuttle_id = "ferry";
	name = "ferry shuttle";
	port_direction = 4
	},
/obj/machinery/door/airlock/grunge,
/turf/open/floor/iron/shuttle/ferry{
	dir = 8;
	icon_state = "floor"
	},
/area/shuttle/transport)
"Ql" = (
/obj/effect/turf_decal/bot,
/obj/machinery/light/no_nightlight/directional/south,
/obj/structure/closet/generic/wall/empty{
	pixel_x = -25;
	name = "first-aid closet";
	desc = "It's a storage unit for emergency medical supplies."
	},
/obj/item/storage/medkit/emergency,
/obj/item/healthanalyzer,
/obj/item/reagent_containers/hypospray,
/turf/open/floor/iron/shuttle/evac,
/area/shuttle/transport)
"SN" = (
/obj/structure/chair/comfy/shuttle{
	dir = 4
	},
/obj/machinery/computer/security{
	dir = 8;
	density = 0;
	pixel_x = 24
	},
/obj/effect/turf_decal/stripes/white/line{
	dir = 8;
	color = "#ffff81"
	},
/turf/open/floor/iron/shuttle/evac,
/area/shuttle/transport)
"SQ" = (
/obj/machinery/light/no_nightlight/directional/north,
/obj/structure/closet/emcloset/wall{
	pixel_x = -25
	},
/obj/effect/turf_decal/bot,
/obj/structure/chair/comfy/shuttle{
	dir = 4
	},
/turf/open/floor/iron/shuttle/evac,
/area/shuttle/transport)
"Tk" = (
/obj/structure/fans/tiny/forcefield{
	dir = 8
	},
/obj/machinery/door/airlock/grunge,
/turf/open/floor/iron/shuttle/ferry{
	dir = 4;
	icon_state = "floor"
	},
/area/shuttle/transport)
"UD" = (
/obj/machinery/door/airlock/shuttle/glass{
	req_access = list("cent_general")
	},
/turf/open/floor/iron/stairs{
	color = "#777d88"
	},
/area/shuttle/transport)
"YJ" = (
/obj/machinery/power/shuttle_engine/propulsion,
/obj/effect/turf_decal/stripes/white/line{
	dir = 2;
	color = "#ffff81"
	},
/turf/open/indestructible/plating,
/area/shuttle/transport)

(1,1,1) = {"
Mr
nC
CC
CC
CC
CC
CC
Tk
By
CC
Fz
YJ
ON
"}
(2,1,1) = {"
hw
aF
cz
Ed
Ql
CC
SQ
go
rq
jG
El
Fz
zs
"}
(3,1,1) = {"
CC
Io
CM
jP
CM
UD
jP
CM
jP
CM
Ei
Hn
gS
"}
(4,1,1) = {"
hw
sk
ht
SN
fT
CC
oR
GQ
tB
yF
El
Fz
zs
"}
(5,1,1) = {"
Mr
nC
CC
CC
CC
CC
CC
Tk
Qg
CC
Fz
YJ
ON
"}
