//MAP CONVERTED BY dmm2tgm.py THIS HEADER COMMENT PREVENTS RECONVERSION, DO NOT REMOVE
"ad" = (
/obj/effect/decal/cleanable/dirt,
/obj/machinery/airalarm/directional/south,
/obj/effect/mapping_helpers/airalarm/away_general_access,
/turf/open/floor/iron/shuttle/cargo,
/area/shuttle/blackmarket_chevvy)
"aG" = (
/obj/effect/turf_decal/box/corners{
	dir = 1
	},
/obj/effect/turf_decal/tile/neutral/diagonal_centre,
/turf/open/floor/pod/dark,
/area/shuttle/blackmarket_chevvy)
"bu" = (
/obj/machinery/atmospherics/pipe/smart/manifold4w/supply/hidden/layer4,
/obj/machinery/atmospherics/pipe/smart/manifold4w/scrubbers/hidden/layer2,
/turf/open/floor/iron/shuttle/cargo,
/area/shuttle/blackmarket_chevvy)
"cq" = (
/obj/structure/marker_beacon/olive,
/turf/closed/wall/mineral/titanium,
/area/shuttle/blackmarket_chevvy)
"cL" = (
/obj/machinery/atmospherics/pipe/smart/manifold4w/supply/hidden/layer4,
/obj/machinery/atmospherics/pipe/smart/manifold4w/scrubbers/hidden/layer2,
/obj/effect/decal/cleanable/dirt,
/turf/open/floor/iron/shuttle/cargo,
/area/shuttle/blackmarket_chevvy)
"en" = (
/obj/structure/fans/tiny,
/obj/machinery/door/airlock/external{
	id_tag = "burstexts"
	},
/obj/docking_port/mobile{
	name = "Chevvy";
	port_direction = 4;
	preferred_direction = 8;
	shuttle_id = "blackmarket_chevvy";
	dir = 8
	},
/turf/open/floor/catwalk_floor,
/area/shuttle/blackmarket_chevvy)
"eu" = (
/obj/structure/fans/tiny,
/obj/machinery/door/airlock/external{
	id_tag = "burstexts"
	},
/turf/open/floor/catwalk_floor,
/area/shuttle/blackmarket_chevvy)
"fp" = (
/turf/closed/wall/mineral/titanium,
/area/shuttle/blackmarket_chevvy)
"jm" = (
/obj/structure/railing,
/obj/effect/turf_decal/tile/neutral/diagonal_centre,
/obj/effect/turf_decal/box/corners{
	dir = 8
	},
/turf/open/floor/pod/dark,
/area/shuttle/blackmarket_chevvy)
"jD" = (
/obj/machinery/power/shuttle_engine/heater{
	pixel_y = 9
	},
/obj/machinery/atmospherics/components/unary/passive_vent{
	dir = 1;
	name = "killroom vent"
	},
/turf/open/floor/plating,
/area/shuttle/blackmarket_chevvy)
"ka" = (
/obj/structure/marker_beacon/burgundy,
/turf/closed/wall/mineral/titanium,
/area/shuttle/blackmarket_chevvy)
"lK" = (
/obj/effect/turf_decal/siding/wideplating/dark{
	dir = 8
	},
/obj/machinery/atmospherics/components/unary/vent_scrubber/on/layer2{
	dir = 4
	},
/turf/open/floor/iron/shuttle/cargo,
/area/shuttle/blackmarket_chevvy)
"mP" = (
/obj/effect/spawner/random/structure/crate_loot,
/obj/effect/turf_decal/tile/neutral/diagonal_centre,
/obj/structure/railing{
	dir = 6
	},
/obj/effect/turf_decal/box/corners,
/turf/open/floor/pod/dark,
/area/shuttle/blackmarket_chevvy)
"nB" = (
/obj/machinery/atmospherics/pipe/smart/manifold4w/supply/hidden/layer4,
/obj/machinery/atmospherics/pipe/smart/manifold4w/scrubbers/hidden/layer2,
/obj/machinery/light/cold/directional/north,
/obj/machinery/button/door/directional/north{
	name = "External Airlock Bolt Control";
	normaldoorcontrol = 1;
	specialfunctions = 4;
	id = "burstexts"
	},
/obj/effect/decal/cleanable/dirt,
/turf/open/floor/iron/shuttle/cargo,
/area/shuttle/blackmarket_chevvy)
"ph" = (
/obj/effect/decal/cleanable/dirt,
/obj/effect/spawner/random/structure/crate_abandoned,
/turf/open/floor/iron/shuttle/cargo,
/area/shuttle/blackmarket_chevvy)
"pI" = (
/obj/structure/chair/comfy/shuttle{
	dir = 8
	},
/turf/open/floor/iron/shuttle/ferry,
/area/shuttle/blackmarket_chevvy)
"pM" = (
/obj/machinery/atmospherics/components/unary/vent_scrubber/on/layer2,
/turf/open/floor/iron/shuttle/cargo,
/area/shuttle/blackmarket_chevvy)
"rE" = (
/obj/machinery/modular_computer/preset/civilian{
	dir = 1
	},
/obj/machinery/light/cold/directional/south,
/obj/machinery/button/door/directional/south{
	id = "burstwindf";
	name = "Window Shutter Control";
	pixel_x = 7
	},
/obj/machinery/button/door/directional/south{
	pixel_x = -7;
	id = "burstcargo";
	name = "Cargo Doors"
	},
/turf/open/floor/iron/shuttle/ferry,
/area/shuttle/blackmarket_chevvy)
"ss" = (
/obj/effect/decal/cleanable/dirt,
/obj/effect/turf_decal/tile/neutral/diagonal_centre,
/obj/effect/turf_decal/box/corners,
/turf/open/floor/pod/dark,
/area/shuttle/blackmarket_chevvy)
"tH" = (
/obj/structure/window/reinforced/plasma/spawner/directional/south,
/obj/structure/window/reinforced/survival_pod/spawner/directional/north,
/obj/machinery/atmospherics/pipe/smart/manifold4w/supply/hidden/layer4,
/obj/machinery/atmospherics/pipe/smart/manifold4w/scrubbers/hidden/layer2,
/obj/machinery/portable_atmospherics/canister/oxygen,
/turf/open/floor/catwalk_floor,
/area/shuttle/blackmarket_chevvy)
"uW" = (
/obj/effect/decal/cleanable/dirt,
/obj/effect/turf_decal/tile/neutral/diagonal_centre,
/obj/effect/turf_decal/box/corners{
	dir = 4
	},
/turf/open/floor/pod/dark,
/area/shuttle/blackmarket_chevvy)
"vK" = (
/obj/effect/decal/cleanable/dirt,
/obj/structure/closet/emcloset/wall{
	pixel_x = -28
	},
/obj/effect/turf_decal/siding/wideplating/dark{
	dir = 1
	},
/obj/item/storage/toolbox/mechanical,
/turf/open/floor/iron/shuttle/cargo,
/area/shuttle/blackmarket_chevvy)
"yt" = (
/obj/structure/window/reinforced/shuttle,
/obj/machinery/door/poddoor/shutters/preopen{
	dir = 8;
	id = "burstwindf"
	},
/turf/open/floor/plating,
/area/shuttle/blackmarket_chevvy)
"yM" = (
/obj/machinery/atmospherics/pipe/smart/manifold4w/supply/hidden/layer4,
/obj/machinery/atmospherics/pipe/smart/manifold4w/scrubbers/hidden/layer2,
/obj/effect/decal/cleanable/dirt,
/obj/structure/closet/secure_closet/wall{
	pixel_x = 33
	},
/turf/open/floor/iron/shuttle/ferry,
/area/shuttle/blackmarket_chevvy)
"zi" = (
/turf/open/floor/catwalk_floor,
/area/shuttle/blackmarket_chevvy)
"zH" = (
/obj/machinery/power/shuttle_engine/heater{
	pixel_y = 9
	},
/turf/open/floor/plating,
/area/shuttle/blackmarket_chevvy)
"zQ" = (
/obj/structure/window/reinforced/plasma/spawner/directional/west,
/obj/machinery/airalarm/directional/north,
/obj/effect/mapping_helpers/airalarm/away_general_access,
/obj/machinery/computer/shuttle/caravan/blackmarket_chevvy{
	dir = 4
	},
/turf/open/floor/iron/shuttle/ferry,
/area/shuttle/blackmarket_chevvy)
"CN" = (
/obj/machinery/light/floor,
/obj/effect/turf_decal/siding/wideplating/dark{
	dir = 8
	},
/obj/effect/decal/cleanable/dirt,
/obj/machinery/atmospherics/components/unary/vent_pump/on/layer4{
	dir = 4
	},
/turf/open/floor/iron/shuttle/cargo,
/area/shuttle/blackmarket_chevvy)
"Dx" = (
/obj/machinery/button/door/directional/south{
	id = "burstcargo";
	name = "Blast Door Control"
	},
/obj/effect/decal/cleanable/dirt,
/obj/effect/turf_decal/siding/wideplating/dark{
	dir = 1
	},
/turf/open/floor/iron/shuttle/cargo,
/area/shuttle/blackmarket_chevvy)
"DD" = (
/obj/structure/marker_beacon/olive,
/turf/closed/wall/mineral/titanium/nodiagonal,
/area/shuttle/blackmarket_chevvy)
"Ee" = (
/obj/structure/fans/tiny/forcefield{
	dir = 4
	},
/obj/machinery/door/poddoor/preopen{
	id = "burstcargo"
	},
/turf/open/floor/engine,
/area/shuttle/blackmarket_chevvy)
"EO" = (
/obj/machinery/atmospherics/components/unary/vent_scrubber/on/layer2,
/obj/machinery/atmospherics/pipe/smart/manifold4w/supply/hidden/layer4,
/turf/open/floor/iron/shuttle/ferry,
/area/shuttle/blackmarket_chevvy)
"Fr" = (
/obj/machinery/atmospherics/pipe/smart/manifold4w/supply/hidden/layer4,
/obj/effect/turf_decal/siding/wideplating/dark/corner{
	dir = 8
	},
/turf/open/floor/iron/shuttle/cargo,
/area/shuttle/blackmarket_chevvy)
"Fu" = (
/obj/effect/turf_decal/tile/neutral/diagonal_centre,
/obj/effect/spawner/random/structure/crate_abandoned,
/obj/structure/railing{
	dir = 5
	},
/obj/effect/turf_decal/box/corners{
	dir = 4
	},
/turf/open/floor/pod/dark,
/area/shuttle/blackmarket_chevvy)
"Gs" = (
/obj/machinery/atmospherics/pipe/smart/manifold4w/scrubbers/hidden/layer2,
/obj/machinery/atmospherics/pipe/smart/manifold4w/supply/hidden/layer4,
/obj/structure/closet/firecloset/wall{
	pixel_x = 31
	},
/turf/open/floor/iron/shuttle/cargo,
/area/shuttle/blackmarket_chevvy)
"GC" = (
/obj/machinery/door/airlock/external,
/turf/open/floor/catwalk_floor,
/area/shuttle/blackmarket_chevvy)
"GO" = (
/obj/machinery/door/poddoor/shutters/preopen{
	id = "burstwinds"
	},
/obj/structure/window/reinforced/shuttle,
/turf/open/floor/plating,
/area/shuttle/blackmarket_chevvy)
"Hj" = (
/obj/effect/decal/cleanable/dirt,
/turf/closed/wall/mineral/titanium/interior,
/area/shuttle/blackmarket_chevvy)
"Ii" = (
/obj/structure/window/reinforced/plasma/spawner/directional/south,
/obj/machinery/atmospherics/components/unary/portables_connector/visible/layer4{
	dir = 4
	},
/obj/structure/window/reinforced/survival_pod/spawner/directional/north,
/obj/machinery/portable_atmospherics/canister/air,
/turf/open/floor/iron/shuttle/ferry,
/area/shuttle/blackmarket_chevvy)
"JW" = (
/obj/effect/turf_decal/siding/wideplating/dark{
	dir = 8
	},
/obj/effect/decal/cleanable/dirt,
/turf/open/floor/iron/shuttle/cargo,
/area/shuttle/blackmarket_chevvy)
"NC" = (
/obj/machinery/atmospherics/components/unary/vent_pump/on/layer4,
/turf/open/floor/iron/shuttle/ferry,
/area/shuttle/blackmarket_chevvy)
"Ov" = (
/turf/template_noop,
/area/template_noop)
"OB" = (
/obj/structure/window/reinforced/plasma/spawner/directional/south,
/obj/structure/window/reinforced/survival_pod/spawner/directional/north,
/obj/machinery/atmospherics/pipe/smart/manifold4w/supply/hidden/layer4,
/turf/open/floor/catwalk_floor,
/area/shuttle/blackmarket_chevvy)
"OR" = (
/obj/effect/turf_decal/siding/wideplating/dark/corner{
	dir = 1
	},
/obj/effect/decal/cleanable/dirt,
/turf/open/floor/iron/shuttle/cargo,
/area/shuttle/blackmarket_chevvy)
"PJ" = (
/obj/structure/railing{
	dir = 1
	},
/obj/effect/decal/cleanable/dirt,
/obj/effect/spawner/random/structure/crate_loot,
/obj/effect/turf_decal/tile/neutral/diagonal_centre,
/obj/effect/turf_decal/box/corners{
	dir = 1
	},
/turf/open/floor/pod/dark,
/area/shuttle/blackmarket_chevvy)
"PY" = (
/obj/machinery/atmospherics/components/unary/vent_pump/on/layer4{
	dir = 4
	},
/obj/effect/turf_decal/siding/wideplating/dark,
/turf/open/floor/iron/shuttle/cargo,
/area/shuttle/blackmarket_chevvy)
"RN" = (
/obj/structure/window/reinforced/plasma/spawner/directional/west,
/obj/item/radio/intercom/directional/south,
/obj/machinery/computer/camera_advanced/shuttle_docker/blackmarket_chevvy{
	dir = 4
	},
/turf/open/floor/iron/shuttle/ferry,
/area/shuttle/blackmarket_chevvy)
"RP" = (
/obj/machinery/atmospherics/pipe/smart/manifold4w/scrubbers/hidden/layer2,
/obj/machinery/atmospherics/pipe/smart/manifold4w/supply/hidden/layer4,
/obj/effect/decal/cleanable/dirt,
/turf/open/floor/iron/shuttle/cargo,
/area/shuttle/blackmarket_chevvy)
"SY" = (
/obj/effect/turf_decal/tile/neutral/diagonal_centre,
/obj/effect/turf_decal/box/corners{
	dir = 8
	},
/turf/open/floor/pod/dark,
/area/shuttle/blackmarket_chevvy)
"Tk" = (
/obj/machinery/atmospherics/pipe/smart/manifold4w/scrubbers/hidden/layer2,
/obj/machinery/atmospherics/pipe/smart/manifold4w/supply/hidden/layer4,
/turf/open/floor/iron/shuttle/cargo,
/area/shuttle/blackmarket_chevvy)
"TD" = (
/obj/effect/turf_decal/siding/wideplating/dark,
/turf/open/floor/iron/shuttle/cargo,
/area/shuttle/blackmarket_chevvy)
"Vy" = (
/obj/machinery/light/floor,
/obj/effect/turf_decal/siding/wideplating/dark{
	dir = 8
	},
/obj/effect/decal/cleanable/dirt,
/turf/open/floor/iron/shuttle/cargo,
/area/shuttle/blackmarket_chevvy)
"VX" = (
/obj/structure/window/reinforced/shuttle,
/obj/machinery/door/poddoor/shutters/preopen{
	id = "burstwindf"
	},
/turf/open/floor/plating,
/area/shuttle/blackmarket_chevvy)
"VZ" = (
/obj/structure/chair/comfy/shuttle{
	dir = 8
	},
/obj/effect/decal/cleanable/dirt,
/turf/open/floor/iron/shuttle/ferry,
/area/shuttle/blackmarket_chevvy)
"Wf" = (
/obj/structure/window/reinforced/plasma/spawner/directional/south,
/obj/machinery/door/window/survival_pod/left/directional/north,
/obj/machinery/atmospherics/pipe/smart/manifold4w/supply/hidden/layer4,
/obj/machinery/atmospherics/pipe/smart/manifold4w/scrubbers/hidden/layer2,
/turf/open/floor/catwalk_floor,
/area/shuttle/blackmarket_chevvy)
"Yg" = (
/obj/machinery/light/cold/directional/north,
/obj/machinery/button/door/directional/north{
	id = "burstwinds";
	name = "Window Shutter Control"
	},
/turf/open/floor/iron/shuttle/cargo,
/area/shuttle/blackmarket_chevvy)
"YP" = (
/obj/structure/fluff/metalpole/anchor{
	dir = 4;
	pixel_x = -33
	},
/turf/closed/wall/mineral/titanium/nodiagonal,
/area/shuttle/blackmarket_chevvy)
"YX" = (
/turf/closed/wall/mineral/titanium/nodiagonal,
/area/shuttle/blackmarket_chevvy)
"ZC" = (
/obj/effect/decal/cleanable/dirt,
/turf/open/floor/iron/shuttle/cargo,
/area/shuttle/blackmarket_chevvy)
"ZE" = (
/obj/machinery/atmospherics/pipe/smart/manifold4w/supply/hidden/layer4,
/obj/machinery/atmospherics/pipe/smart/manifold4w/scrubbers/hidden/layer2,
/obj/machinery/door/airlock/shuttle,
/turf/open/floor/iron/shuttle/ferry,
/area/shuttle/blackmarket_chevvy)
"ZW" = (
/obj/machinery/power/shuttle_engine/propulsion/burst/right{
	pixel_y = 10
	},
/turf/template_noop,
/area/shuttle/blackmarket_chevvy)

(1,1,1) = {"
Ov
fp
YP
Ee
Ee
Ee
Ee
YP
YX
YX
ka
"}
(2,1,1) = {"
ka
YX
TD
PJ
SY
aG
jm
vK
GC
zi
eu
"}
(3,1,1) = {"
GO
ph
PY
Fu
ss
uW
mP
Dx
YX
YX
fp
"}
(4,1,1) = {"
YX
Yg
Fr
Vy
JW
lK
CN
OR
Ii
zH
ZW
"}
(5,1,1) = {"
GO
pM
RP
Tk
Gs
Tk
Tk
Tk
OB
zH
ZW
"}
(6,1,1) = {"
cq
YX
zQ
RN
YX
Hj
cL
bu
Wf
zH
ZW
"}
(7,1,1) = {"
Ov
VX
pI
VZ
rE
YX
nB
ZC
tH
jD
ZW
"}
(8,1,1) = {"
Ov
VX
NC
EO
yM
ZE
bu
ad
YX
YX
DD
"}
(9,1,1) = {"
Ov
fp
yt
yt
YX
YX
en
YX
fp
Ov
Ov
"}
