//MAP CONVERTED BY dmm2tgm.py THIS HEADER COMMENT PREVENTS RECONVERSION, DO NOT REMOVE
"aP" = (
/obj/machinery/atmospherics/components/unary/vent_scrubber/on/layer2{
	dir = 8
	},
/obj/effect/turf_decal/tile/brown/half{
	dir = 8
	},
/turf/open/floor/iron,
/area/shuttle/tarkon_driver)
"bF" = (
/obj/machinery/light/directional/east,
/obj/structure/table/reinforced,
/obj/machinery/recharger,
/obj/effect/turf_decal/tile/dark_blue/diagonal_edge,
/turf/open/floor/iron,
/area/shuttle/tarkon_driver)
"cP" = (
/obj/machinery/door/airlock/titanium/glass,
/obj/effect/mapping_helpers/airlock/access/all/tarkon/general,
/turf/open/floor/catwalk_floor/iron_dark,
/area/shuttle/tarkon_driver)
"cS" = (
/obj/machinery/door/airlock/titanium,
/obj/docking_port/mobile{
	name = "Tarkon Driver";
	port_direction = 2;
	preferred_direction = 8;
	shuttle_id = "tarkon_driver"
	},
/obj/structure/fans/tiny/invisible,
/obj/structure/cable,
/turf/open/floor/iron,
/area/shuttle/tarkon_driver)
"ef" = (
/turf/open/floor/iron/recharge_floor,
/area/shuttle/tarkon_driver)
"fg" = (
/obj/machinery/atmospherics/components/unary/vent_pump/on/layer4{
	dir = 4
	},
/obj/effect/turf_decal/tile/brown/half{
	dir = 4
	},
/turf/open/floor/iron,
/area/shuttle/tarkon_driver)
"fy" = (
/obj/effect/spawner/structure/window/reinforced/shuttle,
/obj/machinery/door/poddoor{
	id = "driverwindows"
	},
/turf/open/floor/mineral/titanium,
/area/shuttle/tarkon_driver)
"fE" = (
/obj/machinery/light/directional/west,
/obj/structure/table/reinforced,
/obj/item/clothing/mask/gas,
/obj/effect/turf_decal/tile/dark_blue/diagonal_edge,
/turf/open/floor/iron,
/area/shuttle/tarkon_driver)
"gu" = (
/obj/machinery/atmospherics/pipe/smart/manifold4w/supply/hidden/layer4,
/obj/machinery/atmospherics/pipe/smart/manifold4w/scrubbers/hidden/layer2,
/turf/open/floor/catwalk_floor/iron_dark,
/area/shuttle/tarkon_driver)
"hH" = (
/obj/machinery/atmospherics/pipe/smart/manifold4w/scrubbers/hidden/layer2,
/turf/closed/wall/mineral/titanium/spaceship,
/area/shuttle/tarkon_driver)
"hW" = (
/obj/structure/chair/comfy/shuttle{
	dir = 8
	},
/turf/open/floor/iron,
/area/shuttle/tarkon_driver)
"if" = (
/obj/machinery/door/airlock/titanium,
/obj/structure/fans/tiny/invisible,
/obj/structure/cable,
/turf/open/floor/iron,
/area/shuttle/tarkon_driver)
"ik" = (
/obj/structure/cable,
/obj/machinery/power/terminal{
	dir = 4
	},
/obj/machinery/atmospherics/pipe/smart/manifold4w/supply/hidden/layer4,
/turf/open/floor/iron,
/area/shuttle/tarkon_driver)
"io" = (
/obj/machinery/atmospherics/pipe/smart/manifold4w/supply/hidden/layer4,
/turf/open/floor/catwalk_floor/iron_dark,
/area/shuttle/tarkon_driver)
"iF" = (
/obj/structure/cable,
/obj/machinery/atmospherics/pipe/smart/manifold4w/scrubbers/hidden/layer2,
/turf/open/floor/iron,
/area/shuttle/tarkon_driver)
"jG" = (
/obj/structure/cable,
/obj/machinery/power/terminal{
	dir = 4
	},
/obj/machinery/atmospherics/pipe/smart/manifold4w/scrubbers/hidden/layer2,
/turf/open/floor/iron,
/area/shuttle/tarkon_driver)
"ni" = (
/obj/machinery/atmospherics/pipe/smart/manifold4w/scrubbers/hidden/layer2,
/obj/machinery/atmospherics/pipe/smart/manifold4w/supply/hidden/layer4,
/obj/effect/turf_decal/tile/brown/half{
	dir = 4
	},
/turf/open/floor/iron,
/area/shuttle/tarkon_driver)
"nn" = (
/obj/structure/rack/shelf,
/obj/effect/spawner/random/medical/medkit,
/obj/machinery/airalarm/directional/east,
/obj/effect/mapping_helpers/airalarm/all_access,
/obj/effect/spawner/random/medical/medkit,
/obj/effect/spawner/random/medical/medkit_rare,
/obj/effect/turf_decal/tile/brown{
	dir = 1
	},
/turf/open/floor/iron,
/area/shuttle/tarkon_driver)
"nz" = (
/obj/machinery/atmospherics/pipe/smart/manifold4w/supply/hidden/layer4,
/obj/machinery/atmospherics/pipe/smart/manifold4w/scrubbers/hidden/layer2,
/obj/machinery/door/airlock/titanium/glass,
/obj/effect/mapping_helpers/airlock/access/all/tarkon/general,
/turf/open/floor/catwalk_floor/iron_dark,
/area/shuttle/tarkon_driver)
"ob" = (
/obj/machinery/suit_storage_unit/industrial/tarkon,
/obj/effect/turf_decal/tile/brown{
	dir = 4
	},
/turf/open/floor/iron,
/area/shuttle/tarkon_driver)
"oz" = (
/obj/machinery/airalarm/directional/south,
/obj/effect/mapping_helpers/airalarm/all_access,
/obj/machinery/atmospherics/components/unary/vent_pump/on/layer4{
	dir = 1
	},
/obj/effect/turf_decal/tile/brown/half{
	dir = 1
	},
/turf/open/floor/iron,
/area/shuttle/tarkon_driver)
"rr" = (
/obj/machinery/light/directional/north,
/obj/machinery/atmospherics/pipe/smart/manifold4w/supply/hidden/layer4,
/turf/open/floor/iron,
/area/shuttle/tarkon_driver)
"st" = (
/obj/machinery/light/directional/south,
/obj/machinery/atmospherics/components/unary/portables_connector/layer4{
	dir = 1
	},
/obj/machinery/portable_atmospherics/canister/air,
/obj/effect/turf_decal/tile/brown/half{
	dir = 4
	},
/turf/open/floor/iron,
/area/shuttle/tarkon_driver)
"sv" = (
/obj/machinery/atmospherics/components/unary/vent_scrubber/on/layer2,
/turf/open/floor/iron,
/area/shuttle/tarkon_driver)
"tV" = (
/turf/closed/wall/mineral/titanium/nodiagonal,
/area/shuttle/tarkon_driver)
"uk" = (
/obj/machinery/door/airlock/titanium,
/obj/effect/mapping_helpers/airlock/access/all/tarkon/general,
/obj/structure/fans/tiny/invisible,
/turf/open/floor/iron,
/area/shuttle/tarkon_driver)
"vo" = (
/turf/open/floor/catwalk_floor/iron_dark,
/area/shuttle/tarkon_driver)
"zo" = (
/obj/machinery/atmospherics/pipe/smart/manifold4w/supply/hidden/layer4,
/obj/effect/turf_decal/tile/brown/half{
	dir = 8
	},
/turf/open/floor/iron,
/area/shuttle/tarkon_driver)
"zL" = (
/obj/machinery/power/shuttle_engine/propulsion/burst,
/obj/machinery/atmospherics/components/unary/passive_vent/layer2{
	dir = 1
	},
/turf/open/floor/mineral/titanium,
/area/shuttle/tarkon_driver)
"Al" = (
/obj/machinery/computer/camera_advanced/shuttle_docker/tarkon_driver,
/obj/effect/turf_decal/tile/dark_blue/diagonal_edge,
/turf/open/floor/iron,
/area/shuttle/tarkon_driver)
"Ap" = (
/obj/structure/chair/comfy/shuttle{
	dir = 4
	},
/obj/machinery/airalarm/directional/north,
/obj/effect/mapping_helpers/airalarm/all_access,
/turf/open/floor/iron,
/area/shuttle/tarkon_driver)
"AX" = (
/obj/machinery/light/directional/north,
/obj/structure/tank_dispenser,
/obj/effect/turf_decal/tile/brown/half{
	dir = 4
	},
/turf/open/floor/iron,
/area/shuttle/tarkon_driver)
"BH" = (
/obj/machinery/recharge_station,
/turf/open/floor/iron,
/area/shuttle/tarkon_driver)
"BP" = (
/obj/machinery/atmospherics/components/unary/vent_scrubber/on/layer2,
/turf/open/floor/catwalk_floor/iron_dark,
/area/shuttle/tarkon_driver)
"BS" = (
/obj/machinery/airalarm/directional/east,
/obj/effect/mapping_helpers/airalarm/all_access,
/obj/structure/chair/comfy/shuttle{
	dir = 8
	},
/obj/effect/turf_decal/tile/brown/anticorner{
	dir = 1
	},
/turf/open/floor/iron,
/area/shuttle/tarkon_driver)
"Cf" = (
/obj/structure/rack/shelf,
/obj/item/flashlight/flare,
/obj/item/flashlight/flare,
/obj/item/flashlight/flare,
/obj/machinery/door/window/right/directional/west,
/turf/open/floor/iron,
/area/shuttle/tarkon_driver)
"Cn" = (
/obj/structure/rack/shelf,
/obj/item/tank/internals/emergency_oxygen,
/obj/item/tank/internals/emergency_oxygen,
/obj/item/tank/internals/emergency_oxygen,
/obj/machinery/door/window/right/directional/west,
/obj/machinery/light/directional/south,
/turf/open/floor/iron,
/area/shuttle/tarkon_driver)
"Cv" = (
/obj/machinery/power/shuttle_engine/propulsion/burst,
/turf/open/floor/mineral/titanium,
/area/shuttle/tarkon_driver)
"DF" = (
/obj/machinery/mech_bay_recharge_port{
	dir = 2
	},
/turf/open/floor/iron,
/area/shuttle/tarkon_driver)
"Em" = (
/turf/template_noop,
/area/template_noop)
"Fi" = (
/obj/structure/table/reinforced,
/obj/item/tank/internals/emergency_oxygen/engi,
/obj/machinery/airalarm/directional/west,
/obj/effect/mapping_helpers/airalarm/all_access,
/obj/effect/turf_decal/tile/dark_blue/half,
/obj/effect/turf_decal/tile/dark_blue/diagonal_edge,
/turf/open/floor/iron,
/area/shuttle/tarkon_driver)
"Fp" = (
/obj/structure/table/reinforced,
/obj/item/crowbar/red,
/obj/effect/turf_decal/tile/dark_blue/diagonal_edge,
/turf/open/floor/iron,
/area/shuttle/tarkon_driver)
"Gl" = (
/obj/structure/cable,
/obj/machinery/atmospherics/pipe/smart/manifold4w/scrubbers/hidden/layer2,
/obj/effect/turf_decal/tile/brown/half{
	dir = 8
	},
/turf/open/floor/iron,
/area/shuttle/tarkon_driver)
"Gn" = (
/obj/effect/turf_decal/tile/brown/half{
	dir = 4
	},
/turf/open/floor/iron,
/area/shuttle/tarkon_driver)
"GN" = (
/turf/closed/wall/mineral/titanium/spaceship,
/area/shuttle/tarkon_driver)
"GX" = (
/obj/machinery/light/directional/north,
/obj/structure/cable,
/obj/machinery/atmospherics/pipe/smart/manifold4w/supply/hidden/layer4,
/turf/open/floor/iron,
/area/shuttle/tarkon_driver)
"HI" = (
/obj/machinery/atmospherics/pipe/smart/manifold4w/scrubbers/hidden/layer2,
/turf/open/floor/catwalk_floor/iron_dark,
/area/shuttle/tarkon_driver)
"HY" = (
/obj/machinery/door/airlock/titanium,
/turf/open/floor/catwalk_floor/iron_dark,
/area/shuttle/tarkon_driver)
"IP" = (
/obj/structure/closet/crate/internals,
/obj/item/clothing/head/helmet/space/eva,
/obj/item/clothing/mask/breath,
/obj/item/clothing/suit/space/eva,
/obj/item/tank/internals/oxygen,
/obj/item/tank/internals/oxygen,
/obj/item/clothing/suit/space/eva,
/obj/item/clothing/head/helmet/space/eva,
/obj/item/clothing/mask/breath,
/obj/machinery/door/window/right/directional/east,
/obj/machinery/light/directional/south,
/turf/open/floor/iron,
/area/shuttle/tarkon_driver)
"Jm" = (
/obj/structure/chair/comfy/shuttle{
	dir = 4
	},
/obj/effect/turf_decal/tile/brown/anticorner{
	dir = 4
	},
/turf/open/floor/iron,
/area/shuttle/tarkon_driver)
"Jo" = (
/obj/structure/table/reinforced,
/obj/machinery/light/directional/south,
/obj/item/pickaxe/drill,
/obj/effect/turf_decal/tile/brown/half{
	dir = 8
	},
/turf/open/floor/iron,
/area/shuttle/tarkon_driver)
"JF" = (
/turf/closed/wall/mineral/titanium,
/area/shuttle/tarkon_driver)
"JS" = (
/obj/structure/table/reinforced,
/obj/machinery/button/door{
	id = "driverwindows";
	name = "Blast Shield Control"
	},
/obj/item/binoculars{
	pixel_x = 9;
	pixel_y = 10
	},
/obj/effect/turf_decal/tile/dark_blue/diagonal_edge,
/turf/open/floor/iron,
/area/shuttle/tarkon_driver)
"JY" = (
/obj/machinery/computer/shuttle/tarkon_driver,
/obj/effect/turf_decal/tile/dark_blue/diagonal_edge,
/turf/open/floor/iron,
/area/shuttle/tarkon_driver)
"Kv" = (
/obj/machinery/atmospherics/components/unary/vent_scrubber/on/layer2,
/obj/effect/turf_decal/tile/dark_blue/half,
/obj/effect/turf_decal/tile/dark_blue/diagonal_edge,
/turf/open/floor/iron,
/area/shuttle/tarkon_driver)
"LG" = (
/turf/closed/wall/mineral/titanium/spaceship/nodiagonal,
/area/shuttle/tarkon_driver)
"Mh" = (
/obj/machinery/door/airlock/titanium,
/obj/machinery/atmospherics/pipe/smart/manifold4w/supply/hidden/layer4,
/obj/machinery/atmospherics/pipe/smart/manifold4w/scrubbers/hidden/layer2,
/turf/open/floor/catwalk_floor/iron_dark,
/area/shuttle/tarkon_driver)
"Ml" = (
/obj/structure/cable,
/obj/machinery/atmospherics/pipe/smart/manifold4w/scrubbers/hidden/layer2,
/turf/open/floor/catwalk_floor/iron_dark,
/area/shuttle/tarkon_driver)
"Nj" = (
/obj/structure/chair/comfy/shuttle{
	dir = 8
	},
/obj/machinery/airalarm/directional/north,
/obj/effect/mapping_helpers/airalarm/all_access,
/turf/open/floor/iron,
/area/shuttle/tarkon_driver)
"Ny" = (
/obj/machinery/atmospherics/components/unary/vent_pump/on/layer4{
	dir = 1
	},
/obj/effect/turf_decal/tile/brown/half{
	dir = 1
	},
/turf/open/floor/iron,
/area/shuttle/tarkon_driver)
"Ow" = (
/obj/structure/cable,
/turf/open/floor/catwalk_floor/iron_dark,
/area/shuttle/tarkon_driver)
"OJ" = (
/obj/machinery/suit_storage_unit/industrial/tarkon,
/obj/effect/turf_decal/tile/brown/half{
	dir = 4
	},
/turf/open/floor/iron,
/area/shuttle/tarkon_driver)
"Pn" = (
/obj/machinery/power/smes/engineering,
/obj/structure/cable,
/turf/open/floor/iron,
/area/shuttle/tarkon_driver)
"Qe" = (
/obj/structure/rack/shelf,
/obj/effect/turf_decal/tile/brown/half{
	dir = 8
	},
/obj/item/storage/toolbox/emergency/turret/mag_fed/hoplite/pre_filled,
/obj/item/storage/toolbox/emergency/turret/mag_fed/hoplite/pre_filled{
	pixel_y = 10
	},
/turf/open/floor/iron,
/area/shuttle/tarkon_driver)
"Rg" = (
/obj/effect/turf_decal/tile/brown/half{
	dir = 8
	},
/turf/open/floor/iron,
/area/shuttle/tarkon_driver)
"Rn" = (
/obj/machinery/atmospherics/pipe/smart/manifold4w/supply/hidden/layer4,
/obj/machinery/airalarm/directional/north,
/obj/effect/mapping_helpers/airalarm/all_access,
/obj/effect/turf_decal/tile/brown/half{
	dir = 4
	},
/turf/open/floor/iron,
/area/shuttle/tarkon_driver)
"Sd" = (
/obj/structure/cable,
/obj/machinery/atmospherics/components/unary/vent_scrubber/on/layer2,
/turf/open/floor/iron,
/area/shuttle/tarkon_driver)
"St" = (
/obj/structure/closet/crate/internals,
/obj/item/clothing/head/helmet/space/eva,
/obj/item/clothing/mask/breath,
/obj/item/clothing/suit/space/eva,
/obj/item/tank/internals/oxygen,
/obj/item/tank/internals/oxygen,
/obj/item/clothing/suit/space/eva,
/obj/item/clothing/head/helmet/space/eva,
/obj/item/clothing/mask/breath,
/obj/machinery/door/window/right/directional/east,
/turf/open/floor/iron,
/area/shuttle/tarkon_driver)
"Tp" = (
/obj/structure/rack/shelf,
/obj/item/oxygen_candle,
/obj/item/oxygen_candle,
/obj/item/oxygen_candle,
/obj/machinery/door/window/right/directional/west,
/turf/open/floor/iron,
/area/shuttle/tarkon_driver)
"TS" = (
/obj/structure/chair/comfy/shuttle{
	dir = 4
	},
/turf/open/floor/iron,
/area/shuttle/tarkon_driver)
"Ue" = (
/obj/structure/table/reinforced,
/obj/machinery/cell_charger,
/obj/machinery/light_switch/directional/east,
/obj/effect/turf_decal/tile/dark_blue/half,
/obj/effect/turf_decal/tile/dark_blue/diagonal_edge,
/turf/open/floor/iron,
/area/shuttle/tarkon_driver)
"Ut" = (
/obj/effect/spawner/structure/window/reinforced/shuttle,
/turf/open/floor/mineral/titanium,
/area/shuttle/tarkon_driver)
"Uu" = (
/obj/machinery/door/airlock/titanium/glass,
/obj/effect/mapping_helpers/airlock/access/all/tarkon/general,
/obj/machinery/atmospherics/pipe/smart/manifold4w/supply/hidden/layer4,
/obj/machinery/atmospherics/pipe/smart/manifold4w/scrubbers/hidden/layer2,
/turf/open/floor/catwalk_floor/iron_dark,
/area/shuttle/tarkon_driver)
"Vp" = (
/obj/machinery/atmospherics/pipe/smart/manifold4w/supply/hidden/layer4,
/obj/machinery/computer/mech_bay_power_console{
	dir = 4
	},
/turf/open/floor/iron,
/area/shuttle/tarkon_driver)
"Vt" = (
/obj/machinery/power/apc/auto_name/directional/east,
/obj/structure/cable,
/obj/effect/mapping_helpers/apc/full_charge,
/obj/effect/mapping_helpers/apc/unlocked,
/obj/structure/table/reinforced,
/obj/item/storage/toolbox/emergency,
/turf/open/floor/iron,
/area/shuttle/tarkon_driver)
"VM" = (
/obj/machinery/atmospherics/pipe/smart/manifold4w/scrubbers/hidden/layer2,
/obj/machinery/atmospherics/pipe/smart/manifold4w/supply/hidden/layer4,
/turf/open/floor/catwalk_floor/iron_dark,
/area/shuttle/tarkon_driver)
"Ww" = (
/obj/structure/rack/gunrack,
/obj/machinery/light/directional/north,
/obj/item/gun/ballistic/automatic/m6pdw{
	pixel_x = 4
	},
/obj/item/gun/ballistic/automatic/m6pdw,
/obj/item/gun/ballistic/automatic/m6pdw{
	pixel_x = -4
	},
/obj/structure/rack,
/obj/machinery/door/window/brigdoor/right/directional/west{
	req_access = list("tarkon")
	},
/obj/structure/window/reinforced/spawner/directional/south,
/obj/item/ammo_box/magazine/c35sol_pistol,
/obj/item/ammo_box/magazine/c35sol_pistol,
/obj/item/ammo_box/magazine/c35sol_pistol,
/obj/item/ammo_box/magazine/c35sol_pistol,
/obj/item/ammo_box/magazine/c35sol_pistol,
/obj/item/ammo_box/magazine/c35sol_pistol,
/turf/open/floor/iron,
/area/shuttle/tarkon_driver)
"Xb" = (
/obj/machinery/atmospherics/components/unary/vent_pump/on/layer4{
	dir = 1
	},
/turf/open/floor/iron,
/area/shuttle/tarkon_driver)
"XN" = (
/obj/machinery/atmospherics/pipe/smart/manifold4w/scrubbers/hidden/layer2,
/turf/open/floor/iron,
/area/shuttle/tarkon_driver)
"Ye" = (
/obj/machinery/atmospherics/components/unary/vent_pump/on/layer4,
/obj/effect/turf_decal/tile/dark_blue/half,
/obj/effect/turf_decal/tile/dark_blue/diagonal_edge,
/turf/open/floor/iron,
/area/shuttle/tarkon_driver)
"Zm" = (
/obj/structure/chair/comfy/shuttle{
	dir = 1
	},
/obj/effect/turf_decal/tile/dark_blue/diagonal_edge,
/turf/open/floor/iron,
/area/shuttle/tarkon_driver)
"Zo" = (
/obj/machinery/power/shuttle_engine/propulsion/burst{
	dir = 1
	},
/turf/open/floor/mineral/titanium,
/area/shuttle/tarkon_driver)

(1,1,1) = {"
Zo
LG
LG
JF
JF
JF
JF
Em
Em
Zo
GN
GN
GN
GN
LG
GN
"}
(2,1,1) = {"
Em
Zo
LG
AX
OJ
ob
JF
fy
fy
tV
LG
DF
ef
BH
GN
Cv
"}
(3,1,1) = {"
Em
Em
uk
BP
gu
oz
JF
St
St
IP
LG
Vp
Xb
XN
hH
zL
"}
(4,1,1) = {"
JF
fy
tV
JF
Uu
JF
tV
Ap
TS
TS
LG
rr
sv
XN
LG
GN
"}
(5,1,1) = {"
fy
JS
fE
Fi
gu
Jm
Ut
Gn
fg
Gn
LG
Rn
Gn
ni
st
GN
"}
(6,1,1) = {"
fy
Al
Zm
Kv
gu
gu
nz
gu
gu
gu
Mh
gu
VM
VM
vo
if
"}
(7,1,1) = {"
fy
JY
Zm
Ye
gu
vo
cP
vo
HI
vo
HY
io
vo
Ml
Ow
cS
"}
(8,1,1) = {"
fy
Fp
bF
Ue
gu
BS
Ut
Rg
aP
Rg
LG
zo
Rg
Gl
Jo
GN
"}
(9,1,1) = {"
JF
fy
tV
JF
Uu
JF
tV
Nj
hW
hW
LG
GX
Sd
iF
LG
GN
"}
(10,1,1) = {"
Em
Em
uk
BP
gu
Ny
JF
Tp
Cf
Cn
LG
ik
Xb
jG
hH
zL
"}
(11,1,1) = {"
Em
Zo
LG
Ww
Qe
nn
JF
fy
fy
tV
LG
Pn
Vt
Pn
GN
Cv
"}
(12,1,1) = {"
Zo
LG
LG
JF
JF
JF
JF
Em
Em
Zo
LG
GN
GN
GN
LG
GN
"}
