//MAP CONVERTED BY dmm2tgm.py THIS HEADER COMMENT PREVENTS RECONVERSION, DO NOT REMOVE
"a" = (
/obj/structure/stone_tile/slab/burnt,
/turf/open/lava/smooth/lava_land_surface{
	slowdown = 0
	},
/area/lavaland/surface/outdoors)
"d" = (
/obj/structure/stone_tile/block/burnt{
	dir = 4
	},
/turf/open/lava/smooth/lava_land_surface{
	slowdown = 0
	},
/area/lavaland/surface/outdoors)
"h" = (
/obj/structure/stone_tile/block{
	dir = 4
	},
/turf/open/lava/smooth/lava_land_surface{
	slowdown = 0
	},
/area/lavaland/surface/outdoors)
"l" = (
/obj/structure/stone_tile/slab/cracked,
/turf/open/lava/smooth/lava_land_surface{
	slowdown = 0
	},
/area/lavaland/surface/outdoors)
"o" = (
/obj/structure/stone_tile/block/cracked{
	dir = 8
	},
/turf/open/lava/smooth/lava_land_surface{
	slowdown = 0
	},
/area/lavaland/surface/outdoors)
"p" = (
/obj/structure/stone_tile/block/cracked,
/turf/open/lava/smooth/lava_land_surface{
	slowdown = 0
	},
/area/lavaland/surface/outdoors)
"r" = (
/obj/structure/stone_tile/slab,
/turf/open/lava/smooth/lava_land_surface{
	slowdown = 0
	},
/area/lavaland/surface/outdoors)
"s" = (
/obj/structure/stone_tile/block{
	dir = 8
	},
/turf/open/lava/smooth/lava_land_surface{
	slowdown = 0
	},
/area/lavaland/surface/outdoors)
"t" = (
/obj/structure/stone_tile/block/cracked{
	dir = 1
	},
/turf/open/lava/smooth/lava_land_surface{
	slowdown = 0
	},
/area/lavaland/surface/outdoors)
"u" = (
/obj/structure/stone_tile/block/burnt{
	dir = 1
	},
/turf/open/lava/smooth/lava_land_surface{
	slowdown = 0
	},
/area/lavaland/surface/outdoors)
"v" = (
/obj/structure/stone_tile/block/cracked{
	dir = 4
	},
/obj/structure/stone_tile/cracked{
	dir = 8
	},
/obj/structure/stone_tile{
	dir = 4
	},
/turf/open/lava/smooth/lava_land_surface{
	slowdown = 0
	},
/area/lavaland/surface/outdoors)
"y" = (
/turf/open/misc/asteroid/basalt/lava_land_surface,
/area/lavaland/surface/outdoors)
"B" = (
/obj/structure/stone_tile/cracked{
	dir = 8
	},
/obj/structure/stone_tile/burnt{
	dir = 4
	},
/obj/structure/stone_tile,
/turf/open/lava/smooth/lava_land_surface{
	slowdown = 0
	},
/area/lavaland/surface/outdoors)
"F" = (
/obj/structure/stone_tile/block/burnt,
/turf/open/lava/smooth/lava_land_surface{
	slowdown = 0
	},
/area/lavaland/surface/outdoors)
"G" = (
/turf/template_noop,
/area/template_noop)
"J" = (
/obj/structure/stone_tile/cracked{
	dir = 4
	},
/obj/structure/stone_tile,
/obj/structure/stone_tile/burnt{
	dir = 1
	},
/turf/open/lava/smooth/lava_land_surface{
	slowdown = 0
	},
/area/lavaland/surface/outdoors)
"K" = (
/obj/structure/stone_tile/block/burnt,
/obj/structure/stone_tile/block{
	dir = 1
	},
/turf/open/lava/smooth/lava_land_surface{
	slowdown = 0
	},
/area/lavaland/surface/outdoors)
"M" = (
/obj/structure/stone_tile/cracked{
	dir = 1
	},
/obj/structure/stone_tile,
/obj/structure/stone_tile/cracked{
	dir = 8
	},
/turf/open/lava/smooth/lava_land_surface{
	slowdown = 0
	},
/area/lavaland/surface/outdoors)
"N" = (
/obj/structure/stone_tile/block/cracked{
	dir = 4
	},
/turf/open/lava/smooth/lava_land_surface{
	slowdown = 0
	},
/area/lavaland/surface/outdoors)
"O" = (
/obj/structure/stone_tile/block{
	dir = 1
	},
/turf/open/lava/smooth/lava_land_surface{
	slowdown = 0
	},
/area/lavaland/surface/outdoors)
"P" = (
/obj/structure/stone_tile/block{
	dir = 4
	},
/obj/structure/stone_tile/cracked{
	dir = 8
	},
/turf/open/lava/smooth/lava_land_surface{
	slowdown = 0
	},
/area/lavaland/surface/outdoors)
"T" = (
/obj/structure/stone_tile/block/cracked{
	dir = 1
	},
/obj/structure/stone_tile{
	dir = 8
	},
/obj/structure/stone_tile/burnt,
/turf/open/lava/smooth/lava_land_surface{
	slowdown = 0
	},
/area/lavaland/surface/outdoors)
"U" = (
/obj/structure/stone_tile/block/burnt{
	dir = 8
	},
/turf/open/lava/smooth/lava_land_surface{
	slowdown = 0
	},
/area/lavaland/surface/outdoors)
"V" = (
/obj/structure/ore_vent/ghost_mining/boss,
/turf/open/misc/asteroid/basalt/lava_land_surface,
/area/lavaland/surface/outdoors)
"X" = (
/obj/structure/stone_tile/block,
/turf/open/lava/smooth/lava_land_surface{
	slowdown = 0
	},
/area/lavaland/surface/outdoors)
"Y" = (
/obj/structure/stone_tile{
	dir = 4
	},
/obj/structure/stone_tile{
	dir = 1
	},
/obj/structure/stone_tile/burnt{
	dir = 8
	},
/turf/open/lava/smooth/lava_land_surface{
	slowdown = 0
	},
/area/lavaland/surface/outdoors)

(1,1,1) = {"
G
G
y
y
y
y
y
y
y
G
G
"}
(2,1,1) = {"
G
y
r
a
l
r
a
r
l
y
G
"}
(3,1,1) = {"
y
a
Y
h
N
d
N
h
B
r
y
"}
(4,1,1) = {"
y
r
p
l
r
r
l
r
u
a
y
"}
(5,1,1) = {"
y
l
F
a
M
P
J
a
O
l
y
"}
(6,1,1) = {"
y
r
X
r
K
V
T
a
t
a
y
"}
(7,1,1) = {"
y
a
p
l
B
v
Y
l
u
r
y
"}
(8,1,1) = {"
y
r
F
r
r
l
r
r
O
l
y
"}
(9,1,1) = {"
y
r
J
o
U
s
s
U
M
r
y
"}
(10,1,1) = {"
G
y
a
r
l
a
r
l
a
y
G
"}
(11,1,1) = {"
G
G
y
y
y
y
y
y
y
G
G
"}
