//MAP CONVERTED BY dmm2tgm.py THIS HEADER COMMENT PREVENTS RECONVERSION, DO NOT REMOVE
"a" = (
/turf/open/misc/asteroid/basalt/lava_land_surface,
/area/lavaland/surface/outdoors)
"f" = (
/obj/item/gps/computer/beacon{
	gpstag = "Geological Site"
	},
/turf/open/misc/asteroid/basalt/lava_land_surface,
/area/lavaland/surface/outdoors)
"n" = (
/obj/effect/turf_decal/stripes/line{
	dir = 9
	},
/turf/open/misc/asteroid/basalt/lava_land_surface,
/area/lavaland/surface/outdoors)
"r" = (
/obj/effect/turf_decal/stripes/line{
	dir = 1
	},
/turf/open/misc/asteroid/basalt/lava_land_surface,
/area/lavaland/surface/outdoors)
"x" = (
/turf/template_noop,
/area/template_noop)
"y" = (
/obj/effect/turf_decal/stripes/line{
	dir = 4
	},
/turf/open/misc/asteroid/basalt/lava_land_surface,
/area/lavaland/surface/outdoors)
"C" = (
/mob/living/basic/mining/legion,
/turf/open/misc/asteroid/basalt/lava_land_surface,
/area/lavaland/surface/outdoors)
"G" = (
/obj/effect/turf_decal/stripes/line{
	dir = 5
	},
/turf/open/misc/asteroid/basalt/lava_land_surface,
/area/lavaland/surface/outdoors)
"Q" = (
/mob/living/basic/mining/legion/dwarf,
/turf/open/misc/asteroid/basalt/lava_land_surface,
/area/lavaland/surface/outdoors)
"S" = (
/obj/effect/turf_decal/stripes/line{
	dir = 8
	},
/turf/open/misc/asteroid/basalt/lava_land_surface,
/area/lavaland/surface/outdoors)
"T" = (
/obj/effect/turf_decal/stripes/line{
	dir = 10
	},
/turf/open/misc/asteroid/basalt/lava_land_surface,
/area/lavaland/surface/outdoors)
"U" = (
/obj/effect/turf_decal/stripes/line,
/turf/open/misc/asteroid/basalt/lava_land_surface,
/area/lavaland/surface/outdoors)
"V" = (
/obj/structure/ore_vent/ghost_mining/lavaland/ras,
/turf/open/misc/asteroid/basalt/lava_land_surface,
/area/lavaland/surface/outdoors)
"W" = (
/obj/effect/turf_decal/stripes/line{
	dir = 6
	},
/turf/open/misc/asteroid/basalt/lava_land_surface,
/area/lavaland/surface/outdoors)
"X" = (
/obj/effect/turf_decal/stripes/corner{
	dir = 1
	},
/obj/effect/turf_decal/stripes/corner,
/turf/open/misc/asteroid/basalt/lava_land_surface,
/area/lavaland/surface/outdoors)
"Z" = (
/obj/structure/table/reinforced,
/obj/item/flatpacked_machine/boulder_collector,
/obj/item/flatpacked_machine/boulder_collector,
/turf/open/misc/asteroid/basalt/lava_land_surface,
/area/lavaland/surface/outdoors)

(1,1,1) = {"
x
x
x
x
x
x
n
S
S
S
S
S
T
"}
(2,1,1) = {"
x
x
x
x
x
x
r
a
a
a
a
a
U
"}
(3,1,1) = {"
x
x
x
x
x
x
r
C
a
a
a
a
U
"}
(4,1,1) = {"
x
x
x
x
a
a
r
a
a
V
a
a
U
"}
(5,1,1) = {"
x
x
x
x
a
a
r
a
a
a
a
a
U
"}
(6,1,1) = {"
x
x
a
a
a
Z
r
a
a
a
C
a
U
"}
(7,1,1) = {"
n
S
S
S
S
S
X
y
y
y
y
y
W
"}
(8,1,1) = {"
r
a
a
a
Q
a
U
f
a
a
x
x
x
"}
(9,1,1) = {"
r
a
a
a
a
a
U
a
a
a
x
x
x
"}
(10,1,1) = {"
r
a
a
V
a
a
U
a
x
x
x
x
x
"}
(11,1,1) = {"
r
C
a
a
a
a
U
a
x
x
x
x
x
"}
(12,1,1) = {"
r
a
a
a
a
a
U
x
x
x
x
x
x
"}
(13,1,1) = {"
G
y
y
y
y
y
W
x
x
x
x
x
x
"}
