"a" = (/turf/closed/wall,/area/station/commons/storage/tools)
"d" = (/obj/structure/cable,/obj/machinery/atmospherics/pipe/smart/manifold4w/supply/hidden/layer4,/obj/effect/landmark/event_spawn,/turf/open/floor/iron/large,/area/station/commons/storage/tools)
"i" = (/obj/machinery/atmospherics/pipe/smart/manifold4w/scrubbers/hidden/layer2,/obj/machinery/atmospherics/pipe/smart/manifold4w/supply/hidden/layer4,/obj/structure/cable,/turf/open/floor/iron,/area/station/hallway/primary/starboard)
"n" = (/obj/effect/turf_decal/tile/yellow/anticorner/contrasted{dir = 8},/obj/structure/table,/obj/item/stack/sheet/glass/fifty{pixel_y = 5},/obj/item/stack/rods/fifty{pixel_y = 4},/obj/machinery/firealarm/directional/west,/obj/item/storage/toolbox/emergency{pixel_y = 6},/turf/open/floor/iron,/area/station/commons/storage/tools)
"o" = (/obj/effect/turf_decal/tile/yellow/anticorner/contrasted{dir = 4},/obj/structure/reagent_dispensers/fueltank,/obj/structure/sign/poster/official/safety_eye_protection/directional/north,/obj/item/clothing/head/utility/welding,/turf/open/floor/iron,/area/station/commons/storage/tools)
"r" = (/obj/effect/turf_decal/plaque{icon_state = "L3"},/turf/open/floor/iron,/area/station/hallway/primary/starboard)
"A" = (/obj/effect/turf_decal/tile/yellow/half/contrasted,/obj/structure/cable,/obj/machinery/atmospherics/pipe/smart/manifold4w/supply/hidden/layer4,/obj/machinery/atmospherics/pipe/smart/manifold4w/scrubbers/hidden/layer2,/turf/open/floor/iron,/area/station/commons/storage/tools)
"B" = (/obj/machinery/atmospherics/components/unary/vent_pump/on/layer4{dir = 8},/turf/open/floor/iron/large,/area/station/commons/storage/tools)
"C" = (/obj/effect/turf_decal/tile/yellow/anticorner/contrasted{dir = 1},/obj/structure/closet/toolcloset,/obj/machinery/camera/directional/north,/obj/effect/turf_decal/bot,/obj/item/radio/intercom/directional/west,/turf/open/floor/iron,/area/station/commons/storage/tools)
"G" = (/obj/effect/turf_decal/tile/yellow/anticorner/contrasted,/obj/structure/table,/obj/item/storage/box/lights/mixed{pixel_y = 4},/turf/open/floor/iron,/area/station/commons/storage/tools)
"H" = (/obj/effect/turf_decal/plaque{icon_state = "L5"},/obj/structure/sign/nanotrasen/directional/north,/turf/open/floor/iron,/area/station/hallway/primary/starboard)
"K" = (/obj/effect/turf_decal/tile/yellow/half/contrasted{dir = 1},/obj/structure/closet/toolcloset,/obj/machinery/light/small/directional/north,/obj/effect/turf_decal/bot,/obj/structure/cable,/obj/machinery/power/apc/auto_name/directional/north,/turf/open/floor/iron,/area/station/commons/storage/tools)
"L" = (/obj/effect/turf_decal/tile/yellow/half/contrasted{dir = 1},/obj/machinery/space_heater,/obj/structure/sign/poster/official/build/directional/north,/turf/open/floor/iron,/area/station/commons/storage/tools)
"N" = (/obj/effect/turf_decal/tile/yellow/half/contrasted{dir = 4},/obj/structure/rack,/obj/item/clothing/gloves/color/fyellow,/obj/item/clothing/gloves/color/fyellow,/obj/item/clothing/gloves/color/fyellow,/obj/effect/spawner/random/maintenance,/obj/item/multitool,/obj/item/clothing/suit/hazardvest,/obj/structure/noticeboard/directional/east,/turf/open/floor/iron,/area/station/commons/storage/tools)
"O" = (/obj/machinery/door/airlock/public/glass{name = "Auxiliary Tool Storage"},/obj/structure/cable,/obj/structure/cable,/obj/machinery/atmospherics/pipe/smart/manifold4w/supply/hidden/layer4,/obj/machinery/atmospherics/pipe/smart/manifold4w/scrubbers/hidden/layer2,/turf/open/floor/iron,/area/station/commons/storage/tools)
"P" = (/obj/effect/turf_decal/tile/yellow/half/contrasted{dir = 8},/obj/machinery/airalarm/directional/west,/turf/open/floor/iron,/area/station/commons/storage/tools)
"Q" = (/obj/effect/spawner/structure/window/reinforced,/turf/open/floor/plating,/area/station/commons/storage/tools)
"R" = (/obj/effect/turf_decal/tile/yellow/half/contrasted,/obj/structure/table,/obj/item/stack/sheet/iron/fifty{pixel_y = 5},/turf/open/floor/iron,/area/station/commons/storage/tools)
"S" = (/obj/effect/turf_decal/plaque{icon_state = "L1"},/obj/machinery/light/floor,/turf/open/floor/iron,/area/station/hallway/primary/starboard)
"T" = (/obj/machinery/door/firedoor{dir = 4},/obj/effect/turf_decal/tile/neutral/fourcorners,/obj/effect/turf_decal/stripes/white/line{dir = 4},/obj/effect/turf_decal/stripes/white/line{dir = 8},/turf/open/floor/iron/dark/textured,/area/station/hallway/primary/starboard)
"Y" = (/obj/machinery/atmospherics/components/unary/vent_pump/on/layer4,/turf/open/floor/iron,/area/station/hallway/primary/starboard)

(1,1,1) = {"
aaaaaa
aCKLoa
aPdBNa
anARGa
aQOQaa
TYiSrH
"}
