//MAP CONVERTED BY dmm2tgm.py THIS HEADER COMMENT PREVENTS RECONVERSION, DO NOT REMOVE
"a" = (
/turf/closed/wall/r_wall,
/area/station/command/heads_quarters/nt_rep)
"c" = (
/obj/effect/mapping_helpers/airlock/access/all/cent_com/rep_door,
/obj/machinery/door/airlock/maintenance,
/obj/machinery/door/firedoor,
/obj/structure/disposalpipe/segment{
	dir = 4
	},
/obj/machinery/door/poddoor/shutters/preopen{
	id = "nt_rep_priv"
	},
/turf/open/floor/iron/dark/textured_large,
/area/station/command/heads_quarters/nt_rep)
"d" = (
/obj/machinery/atmospherics/pipe/smart/manifold4w/scrubbers/hidden/layer2,
/obj/structure/disposalpipe/segment{
	dir = 4
	},
/obj/structure/table/wood,
/obj/effect/spawner/random/bureaucracy/paper,
/obj/item/table_clock{
	pixel_y = 16
	},
/turf/open/floor/iron/dark/textured_large,
/area/station/command/heads_quarters/nt_rep)
"e" = (
/obj/effect/spawner/structure/window/reinforced,
/obj/machinery/door/poddoor/shutters/preopen{
	id = "nt_rep_priv"
	},
/turf/open/floor/plating,
/area/station/command/heads_quarters/nt_rep)
"f" = (
/obj/machinery/atmospherics/pipe/smart/manifold4w/scrubbers/hidden/layer2,
/obj/structure/disposalpipe/segment{
	dir = 4
	},
/obj/structure/table/wood,
/obj/effect/spawner/random/bureaucracy/paper,
/turf/open/floor/iron/dark/textured_large,
/area/station/command/heads_quarters/nt_rep)
"g" = (
/obj/machinery/light/warm/dim/directional/south,
/turf/open/floor/iron/dark/textured_large,
/area/station/command/heads_quarters/nt_rep)
"h" = (
/obj/machinery/door/airlock/corporate{
	name = "NT Consultant's Office"
	},
/obj/machinery/door/firedoor,
/obj/effect/mapping_helpers/airlock/access/all/cent_com/rep_door,
/obj/effect/turf_decal/siding/dark,
/turf/open/floor/carpet/green,
/area/station/command/heads_quarters/nt_rep)
"i" = (
/obj/structure/chair/office/tactical{
	dir = 4
	},
/turf/open/floor/carpet/green,
/area/station/command/heads_quarters/nt_rep)
"j" = (
/obj/machinery/door/airlock/corporate{
	name = "NT Consultant's Office"
	},
/obj/structure/cable,
/obj/machinery/atmospherics/pipe/smart/manifold/supply/hidden/layer4,
/obj/machinery/atmospherics/pipe/smart/manifold4w/scrubbers/hidden/layer2,
/obj/machinery/door/firedoor,
/obj/effect/mapping_helpers/airlock/access/all/cent_com/rep_door,
/obj/structure/disposalpipe/junction/flip{
	dir = 8
	},
/obj/effect/landmark/navigate_destination/autoname,
/obj/machinery/door/poddoor/shutters/preopen{
	id = "nt_rep_priv"
	},
/turf/open/floor/iron/dark/smooth_large,
/area/station/command/heads_quarters/nt_rep)
"k" = (
/obj/machinery/atmospherics/pipe/smart/manifold4w/scrubbers/hidden/layer2,
/obj/machinery/holopad,
/obj/structure/disposalpipe/segment{
	dir = 4
	},
/turf/open/floor/iron/dark/textured_large,
/area/station/command/heads_quarters/nt_rep)
"m" = (
/obj/machinery/airalarm/directional/south,
/obj/structure/chair/comfy/beige{
	dir = 1
	},
/turf/open/floor/iron/dark/textured_large,
/area/station/command/heads_quarters/nt_rep)
"n" = (
/obj/structure/cable,
/obj/effect/landmark/start/nanotrasen_consultant,
/turf/open/floor/iron/dark/textured_large,
/area/station/command/heads_quarters/nt_rep)
"o" = (
/obj/item/toy/crayon/white{
	pixel_y = -10;
	pixel_x = 10
	},
/turf/closed/wall/r_wall,
/area/station/command/heads_quarters/nt_rep)
"p" = (
/turf/open/floor/iron/dark,
/area/station/hallway/primary/central)
"q" = (
/obj/machinery/atmospherics/pipe/smart/manifold4w/supply/hidden/layer4,
/obj/machinery/atmospherics/pipe/smart/manifold4w/scrubbers/hidden/layer2,
/obj/structure/cable,
/obj/machinery/time_clock/directional/west,
/obj/structure/disposalpipe/trunk{
	dir = 1
	},
/obj/machinery/disposal/bin,
/obj/effect/turf_decal/bot_white,
/turf/open/floor/iron/dark,
/area/station/hallway/primary/central)
"r" = (
/obj/structure/chair/comfy/beige{
	dir = 1
	},
/turf/open/floor/iron/dark/textured_large,
/area/station/command/heads_quarters/nt_rep)
"s" = (
/obj/structure/dresser,
/turf/open/floor/carpet/green,
/area/station/command/heads_quarters/nt_rep)
"t" = (
/obj/structure/bed/double,
/obj/item/bedsheet/centcom/double,
/obj/machinery/light/small/blacklight/directional/east{
	desc = "A small lighting fixture. Why is this here?"
	},
/obj/effect/decal/cleanable/cum,
/turf/open/floor/carpet/green,
/area/station/command/heads_quarters/nt_rep)
"u" = (
/obj/structure/cable,
/obj/machinery/atmospherics/components/unary/vent_pump/on/layer4,
/turf/open/floor/iron/dark/textured_large,
/area/station/command/heads_quarters/nt_rep)
"v" = (
/obj/machinery/vending/boozeomat/all_access,
/turf/closed/wall/r_wall,
/area/station/command/heads_quarters/nt_rep)
"w" = (
/obj/structure/chair/greyscale{
	dir = 8
	},
/obj/effect/turf_decal/delivery/white,
/turf/open/floor/iron/dark,
/area/station/hallway/primary/central)
"y" = (
/obj/machinery/photocopier,
/turf/open/floor/iron/dark/textured_large,
/area/station/command/heads_quarters/nt_rep)
"A" = (
/obj/machinery/light/warm/dim/directional/west,
/obj/item/kirbyplants/random,
/turf/open/floor/iron/dark/textured_large,
/area/station/command/heads_quarters/nt_rep)
"B" = (
/obj/structure/chalkboard,
/turf/closed/wall/r_wall,
/area/station/command/heads_quarters/nt_rep)
"C" = (
/obj/machinery/power/apc/auto_name/directional/west,
/obj/structure/cable,
/turf/open/floor/iron/dark/textured_large,
/area/station/command/heads_quarters/nt_rep)
"D" = (
/obj/effect/landmark/start/nanotrasen_consultant,
/turf/open/floor/carpet/green,
/area/station/command/heads_quarters/nt_rep)
"E" = (
/obj/structure/table/reinforced,
/obj/machinery/door/window/brigdoor{
	base_state = "rightsecure";
	icon_state = "rightsecure";
	name = "Consultant's Desk";
	req_access = list("cent_general");
	dir = 8
	},
/obj/machinery/door/poddoor/shutters/preopen{
	id = "nt_rep_priv"
	},
/turf/open/floor/plating,
/area/station/command/heads_quarters/nt_rep)
"F" = (
/obj/structure/sign/flag/galfed,
/turf/closed/wall/r_wall,
/area/station/command/heads_quarters/nt_rep)
"H" = (
/obj/structure/table/reinforced,
/obj/structure/sign/calendar/directional/west,
/obj/machinery/fax{
	fax_name = "Nanotrasen Consultant's Office";
	name = "Nanotrasen Consultant's Fax Machine"
	},
/turf/open/floor/carpet/green,
/area/station/command/heads_quarters/nt_rep)
"I" = (
/obj/structure/filingcabinet,
/obj/structure/filingcabinet/medical{
	pixel_x = -10
	},
/obj/structure/filingcabinet/security{
	pixel_x = 10
	},
/obj/effect/turf_decal/siding/dark,
/turf/open/floor/carpet/green,
/area/station/command/heads_quarters/nt_rep)
"J" = (
/obj/structure/chair/comfy/lime{
	dir = 4
	},
/turf/open/floor/carpet/green,
/area/station/command/heads_quarters/nt_rep)
"L" = (
/obj/machinery/atmospherics/pipe/smart/manifold4w/scrubbers/hidden/layer2,
/obj/structure/disposalpipe/segment{
	dir = 4
	},
/turf/open/floor/iron/dark/textured_large,
/area/station/command/heads_quarters/nt_rep)
"M" = (
/obj/structure/table/reinforced,
/obj/item/stamp/centcom{
	pixel_x = -6;
	pixel_y = 8
	},
/obj/item/stamp/denied{
	pixel_x = -6;
	pixel_y = 4
	},
/obj/item/stamp{
	pixel_x = -6
	},
/obj/item/paper_bin{
	pixel_y = 4;
	pixel_x = 6
	},
/obj/item/pen/fountain{
	pixel_x = 6
	},
/obj/machinery/light/warm/dim/directional/west,
/turf/open/floor/carpet/green,
/area/station/command/heads_quarters/nt_rep)
"N" = (
/obj/machinery/atmospherics/pipe/smart/manifold4w/supply/hidden/layer4,
/obj/machinery/atmospherics/pipe/smart/manifold4w/scrubbers/hidden/layer2,
/obj/structure/cable,
/obj/structure/disposalpipe/segment{
	dir = 10
	},
/turf/open/floor/iron/dark,
/area/station/hallway/primary/central)
"O" = (
/obj/structure/cable,
/obj/machinery/atmospherics/pipe/smart/manifold/supply/hidden/layer4,
/obj/machinery/atmospherics/pipe/smart/manifold4w/scrubbers/hidden/layer2,
/obj/structure/disposalpipe/segment{
	dir = 4
	},
/turf/open/floor/iron/dark/textured_large,
/area/station/command/heads_quarters/nt_rep)
"P" = (
/obj/structure/closet/secure_closet/personal/cabinet,
/turf/open/floor/carpet/green,
/area/station/command/heads_quarters/nt_rep)
"Q" = (
/obj/structure/cable,
/turf/open/floor/iron/dark/textured_large,
/area/station/command/heads_quarters/nt_rep)
"S" = (
/obj/structure/disposalpipe/segment,
/turf/closed/wall/r_wall,
/area/station/command/heads_quarters/nt_rep)
"T" = (
/obj/effect/landmark/start/nanotrasen_consultant,
/obj/effect/turf_decal/siding/dark,
/turf/open/floor/carpet/green,
/area/station/command/heads_quarters/nt_rep)
"U" = (
/obj/machinery/vending/cigarette,
/obj/effect/turf_decal/bot_white,
/turf/open/floor/iron/dark,
/area/station/hallway/primary/central)
"V" = (
/obj/effect/turf_decal/bot_white,
/turf/open/floor/iron/dark,
/area/station/hallway/primary/central)
"W" = (
/obj/structure/disposalpipe/segment{
	dir = 4
	},
/turf/open/floor/iron/dark/smooth_large,
/area/station/command/heads_quarters/nt_rep)
"X" = (
/obj/machinery/modular_computer/preset/command,
/obj/machinery/light_switch/directional/east,
/obj/machinery/button/door/directional/east{
	pixel_y = 10;
	id = "nt_rep_priv"
	},
/turf/open/floor/carpet/green,
/area/station/command/heads_quarters/nt_rep)
"Y" = (
/obj/structure/closet/secure_closet/nanotrasen_consultant/station,
/turf/open/floor/carpet/green,
/area/station/command/heads_quarters/nt_rep)
"Z" = (
/obj/machinery/firealarm/directional/south,
/obj/machinery/atmospherics/components/unary/vent_scrubber/on/layer2{
	dir = 1
	},
/turf/open/floor/iron/dark/textured_large,
/area/station/command/heads_quarters/nt_rep)

(1,1,1) = {"
a
a
a
a
a
c
a
a
"}
(2,1,1) = {"
a
Y
J
v
C
W
A
a
"}
(3,1,1) = {"
a
P
D
h
Q
L
Z
a
"}
(4,1,1) = {"
a
s
t
B
n
f
r
a
"}
(5,1,1) = {"
a
a
F
o
n
d
m
a
"}
(6,1,1) = {"
a
H
M
I
Q
k
g
a
"}
(7,1,1) = {"
a
X
i
T
u
O
y
a
"}
(8,1,1) = {"
a
a
E
e
e
j
S
S
"}
(9,1,1) = {"
a
U
w
V
p
N
q
a
"}
