//MAP CONVERTED BY dmm2tgm.py THIS HEADER COMMENT PREVENTS RECONVERSION, DO NOT REMOVE
"aa" = (
/turf/closed/wall/r_wall,
/area/station/command/heads_quarters/nt_rep)
"ab" = (
/obj/machinery/modular_computer/preset/time_clock/directional/west,
/obj/structure/disposalpipe/trunk{
	dir = 1
	},
/obj/machinery/disposal/bin,
/obj/effect/turf_decal/bot_white,
/turf/open/floor/iron/dark,
/area/station/hallway/primary/central)
"ag" = (
/obj/machinery/light/warm/dim/directional/south,
/obj/structure/extinguisher_cabinet/directional/south,
/obj/effect/turf_decal/siding/dark{
	dir = 4
	},
/turf/open/floor/wood,
/area/station/command/heads_quarters/nt_rep)
"aj" = (
/obj/structure/sign/calendar/directional/south,
/turf/open/floor/wood,
/area/station/command/heads_quarters/nt_rep)
"ak" = (
/obj/structure/closet/secure_closet/blueshield,
/obj/structure/window/reinforced/spawner/directional/north,
/obj/structure/window/reinforced/spawner/directional/west,
/obj/effect/turf_decal/delivery/red,
/obj/structure/window/reinforced/spawner/directional/east,
/obj/item/taperecorder{
	name = "Captain's Log"
	},
/obj/item/modular_computer/laptop/preset/security{
	pixel_y = 5
	},
/turf/open/floor/iron/dark/textured,
/area/station/command/heads_quarters/blueshield)
"al" = (
/obj/structure/cable,
/obj/item/kirbyplants/random,
/obj/effect/turf_decal/tile/neutral/opposingcorners,
/turf/open/floor/iron/dark,
/area/station/command/heads_quarters/nt_rep)
"am" = (
/obj/machinery/coffeemaker/impressa{
	pixel_x = 2;
	pixel_y = 6
	},
/obj/item/storage/box/coffeepack,
/obj/structure/table/wood,
/obj/effect/turf_decal/tile/neutral/opposingcorners,
/turf/open/floor/iron/dark,
/area/station/command/heads_quarters/nt_rep)
"an" = (
/obj/structure/cable,
/obj/structure/fireplace,
/obj/effect/landmark/start/nanotrasen_consultant,
/obj/effect/landmark/start/nanotrasen_consultant,
/obj/effect/landmark/start/nanotrasen_consultant,
/obj/effect/landmark/start/nanotrasen_consultant,
/obj/effect/landmark/start/nanotrasen_consultant,
/obj/effect/turf_decal/siding/dark{
	dir = 1
	},
/obj/structure/chair/comfy/brown{
	color = "#439C1E";
	dir = 2
	},
/turf/open/floor/wood,
/area/station/command/heads_quarters/nt_rep)
"ap" = (
/turf/open/floor/iron/dark,
/area/station/hallway/primary/central)
"ar" = (
/obj/machinery/camera/directional/west{
	c_tag = "NT Consultant's Office";
	name = "command camera";
	dir = 5
	},
/obj/effect/landmark/start/blueshield,
/obj/structure/chair/office/tactical{
	dir = 1
	},
/obj/structure/sign/flag/nanotrasen/directional/south,
/turf/open/floor/wood,
/area/station/command/heads_quarters/nt_rep)
"as" = (
/obj/machinery/atmospherics/components/unary/vent_scrubber/on/layer2{
	dir = 1
	},
/obj/structure/noticeboard/directional/south,
/turf/open/floor/wood,
/area/station/command/heads_quarters/nt_rep)
"ax" = (
/obj/structure/cable,
/obj/machinery/atmospherics/pipe/smart/manifold4w/scrubbers/hidden/layer2,
/obj/machinery/door/firedoor,
/obj/structure/disposalpipe/junction/flip{
	dir = 8
	},
/obj/effect/landmark/navigate_destination/autoname,
/obj/effect/mapping_helpers/airlock/unres/delayed{
	dir = 8
	},
/obj/effect/mapping_helpers/airlock/access/any/cent_com/rep_or_captain,
/obj/machinery/atmospherics/pipe/smart/manifold4w/supply/hidden/layer4,
/obj/effect/turf_decal/siding/dark{
	dir = 8
	},
/obj/machinery/door/airlock/corporate{
	id_tag = "consultantdoor";
	name = "Consultant's Office"
	},
/turf/open/floor/iron/dark,
/area/station/command/heads_quarters/nt_rep)
"az" = (
/obj/machinery/atmospherics/pipe/smart/manifold4w/scrubbers/hidden/layer2,
/obj/structure/disposalpipe/segment{
	dir = 4
	},
/obj/effect/turf_decal/siding/dark/corner,
/obj/structure/table/wood/fancy/green,
/obj/effect/spawner/random/entertainment/cigarette_pack,
/turf/open/floor/wood,
/area/station/command/heads_quarters/nt_rep)
"aB" = (
/turf/open/floor/iron,
/area/station/hallway/primary/central)
"aF" = (
/obj/structure/table/wood,
/obj/item/paper_bin{
	pixel_y = 4;
	pixel_x = -5
	},
/obj/item/stamp/granted{
	pixel_y = 12;
	pixel_x = 8
	},
/obj/item/stamp/denied{
	pixel_x = 8;
	pixel_y = 6
	},
/obj/item/stamp/centcom{
	pixel_x = 8
	},
/obj/item/pen/fourcolor{
	pixel_x = -5;
	pixel_y = 5
	},
/obj/effect/turf_decal/siding/dark{
	dir = 8
	},
/obj/machinery/firealarm/directional/west,
/obj/item/pen/fountain{
	pixel_x = -5;
	pixel_y = 5
	},
/obj/machinery/light/warm/dim/directional/west,
/turf/open/floor/carpet/green,
/area/station/command/heads_quarters/nt_rep)
"aG" = (
/obj/effect/mapping_helpers/airlock/access/all/cent_com/rep_door,
/obj/machinery/door/airlock/maintenance,
/obj/structure/disposalpipe/segment{
	dir = 4
	},
/obj/effect/mapping_helpers/airlock/unres/delayed{
	dir = 4
	},
/turf/open/floor/iron/dark/textured_large,
/area/station/command/heads_quarters/nt_rep)
"aK" = (
/obj/machinery/power/apc/auto_name/directional/west,
/obj/structure/cable,
/obj/effect/turf_decal/siding/dark{
	dir = 1
	},
/turf/open/floor/wood,
/area/station/command/heads_quarters/nt_rep)
"aL" = (
/obj/machinery/atmospherics/pipe/smart/manifold4w/scrubbers/hidden/layer2,
/obj/structure/disposalpipe/segment{
	dir = 4
	},
/obj/structure/table/wood/fancy/green,
/obj/item/flashlight/lamp{
	pixel_y = 9
	},
/obj/item/lighter/royal,
/turf/open/floor/wood,
/area/station/command/heads_quarters/nt_rep)
"aN" = (
/obj/machinery/atmospherics/pipe/smart/manifold4w/supply/hidden/layer4,
/obj/machinery/atmospherics/pipe/smart/manifold4w/scrubbers/hidden/layer2,
/obj/structure/cable,
/obj/structure/disposalpipe/segment{
	dir = 10
	},
/turf/open/floor/iron/dark,
/area/station/hallway/primary/central)
"aO" = (
/obj/structure/cable,
/obj/machinery/atmospherics/pipe/smart/manifold4w/scrubbers/hidden/layer2,
/obj/structure/disposalpipe/segment{
	dir = 4
	},
/obj/machinery/atmospherics/pipe/smart/manifold4w/supply/hidden/layer4,
/obj/effect/turf_decal/tile/neutral/opposingcorners,
/turf/open/floor/iron/dark,
/area/station/command/heads_quarters/nt_rep)
"aQ" = (
/obj/structure/cable,
/obj/effect/turf_decal/siding/dark{
	dir = 1
	},
/turf/open/floor/wood,
/area/station/command/heads_quarters/nt_rep)
"aR" = (
/obj/structure/disposalpipe/segment{
	dir = 4
	},
/turf/open/floor/wood,
/area/station/command/heads_quarters/nt_rep)
"aS" = (
/obj/structure/disposalpipe/segment,
/turf/closed/wall/r_wall,
/area/station/command/heads_quarters/nt_rep)
"aV" = (
/obj/machinery/atmospherics/pipe/smart/manifold4w/scrubbers/hidden/layer2,
/obj/structure/disposalpipe/segment{
	dir = 4
	},
/obj/structure/table/wood/fancy/green,
/obj/item/clipboard{
	pixel_x = -4;
	pixel_y = 3
	},
/obj/item/reagent_containers/cup/glass/mug/nanotrasen,
/turf/open/floor/wood,
/area/station/command/heads_quarters/nt_rep)
"aW" = (
/obj/machinery/airalarm/directional/west,
/obj/machinery/light/warm/dim/directional/west,
/turf/open/floor/wood,
/area/station/command/heads_quarters/nt_rep)
"bb" = (
/obj/item/toy/crayon/white{
	pixel_x = 10;
	pixel_y = -8
	},
/turf/closed/wall/r_wall,
/area/station/command/heads_quarters/nt_rep)
"bC" = (
/obj/machinery/photocopier/prebuilt,
/obj/machinery/firealarm/directional/north,
/obj/item/modular_computer/laptop/preset/security{
	pixel_y = 5
	},
/obj/machinery/camera/directional/west{
	c_tag = "NT Consultant's Office";
	name = "command camera";
	dir = 1
	},
/turf/open/floor/iron,
/area/station/command/heads_quarters/blueshield)
"bI" = (
/obj/structure/bed/double{
	dir = 1
	},
/obj/item/bedsheet/centcom/double{
	dir = 1
	},
/obj/structure/sign/poster/official/no_erp/directional/west,
/obj/machinery/light/small/directional/west,
/turf/open/floor/carpet/green,
/area/station/command/heads_quarters/nt_rep)
"dA" = (
/obj/effect/landmark/start/hangover,
/turf/open/floor/iron,
/area/station/hallway/primary/central)
"gQ" = (
/obj/structure/table/reinforced,
/obj/machinery/door/window/brigdoor/left/directional/west{
	name = "Consultant's Desk";
	req_access = list("cent_general");
	unres_sides = 8
	},
/obj/machinery/door/poddoor/shutters/preopen{
	id = "nt_rep_priv"
	},
/obj/machinery/door/window/left/directional/east{
	name = "Reception Window"
	},
/obj/item/phone{
	desc = "Supposedly a direct line to Nanotrasen Central Command. It's not even plugged in.";
	pixel_x = 3;
	pixel_y = 3
	},
/turf/open/floor/plating,
/area/station/command/heads_quarters/nt_rep)
"hO" = (
/obj/structure/sign/nanotrasen/directional/west,
/turf/open/floor/iron,
/area/station/hallway/primary/central)
"kw" = (
/obj/effect/turf_decal/siding/dark{
	dir = 1
	},
/obj/machinery/camera/directional/west{
	c_tag = "NT Consultant's Office";
	name = "command camera";
	dir = 1
	},
/obj/machinery/computer/station_goal,
/obj/effect/turf_decal/bot,
/turf/open/floor/carpet/green,
/area/station/command/heads_quarters/nt_rep)
"lG" = (
/obj/structure/filingcabinet/medical{
	pixel_x = -10
	},
/obj/structure/filingcabinet/employment,
/obj/structure/filingcabinet/security{
	pixel_x = 10
	},
/obj/effect/turf_decal/siding/dark{
	dir = 10
	},
/turf/open/floor/carpet/green,
/area/station/command/heads_quarters/nt_rep)
"nj" = (
/turf/closed/wall/r_wall,
/area/station/command/heads_quarters/blueshield)
"oh" = (
/obj/machinery/atmospherics/components/unary/vent_pump/on/layer4{
	dir = 4
	},
/obj/machinery/atmospherics/pipe/smart/manifold4w/supply/hidden/layer4,
/turf/open/floor/iron,
/area/station/hallway/primary/central)
"os" = (
/obj/structure/dresser,
/obj/structure/secure_safe/directional/north,
/turf/open/floor/carpet/green,
/area/station/command/heads_quarters/nt_rep)
"px" = (
/obj/structure/cable,
/turf/open/floor/iron,
/area/station/hallway/primary/central)
"qS" = (
/obj/structure/safe/abovetilefloor,
/obj/item/storage/fancy/cigarettes/cigars,
/obj/item/storage/fancy/donut_box,
/obj/item/storage/medkit/tactical/blueshield,
/obj/effect/landmark/start/blueshield,
/obj/effect/landmark/start/blueshield,
/obj/effect/landmark/start/blueshield,
/obj/effect/landmark/start/blueshield,
/obj/item/reagent_containers/cup/glass/bottle/navy_rum,
/obj/item/holocigarette/masvedishcigar,
/obj/effect/landmark/start/blueshield,
/obj/item/paperwork/captain{
	pixel_x = -3;
	pixel_y = 4;
	name = "Asset Protection case records";
	desc = "A messily compiled stack of DAP records, containing incident reports, asset recovery briefings and classified paramilitary activities, with substantial portions censored and redacted. You probably shouldn't be reading this, unless you yearn for a one-way trip to Space Guantanamo."
	},
/turf/open/floor/engine,
/area/station/command/heads_quarters/blueshield)
"re" = (
/obj/structure/cable,
/obj/machinery/atmospherics/pipe/smart/manifold4w/supply/hidden/layer4,
/obj/machinery/atmospherics/pipe/smart/manifold4w/scrubbers/hidden/layer2,
/turf/open/floor/iron,
/area/station/hallway/primary/central)
"sk" = (
/obj/machinery/door/airlock/highsecurity{
	name = "Blueshield's Quarters"
	},
/obj/effect/mapping_helpers/airlock/access/all/command/captain,
/turf/open/floor/engine,
/area/station/command/heads_quarters/blueshield)
"sw" = (
/obj/structure/cable,
/obj/machinery/atmospherics/components/unary/vent_pump/on/layer4,
/obj/effect/turf_decal/siding/dark{
	dir = 5
	},
/turf/open/floor/wood,
/area/station/command/heads_quarters/nt_rep)
"tg" = (
/obj/machinery/atmospherics/pipe/smart/manifold4w/scrubbers/hidden/layer2,
/obj/structure/cable,
/obj/machinery/power/apc/auto_name/directional/west,
/obj/machinery/newscaster/directional/south,
/obj/effect/turf_decal/trimline/dark_blue/filled/line,
/turf/open/floor/iron/dark/smooth_edge,
/area/station/command/heads_quarters/blueshield)
"uj" = (
/obj/machinery/modular_computer/preset/command,
/obj/machinery/light_switch/directional/east,
/obj/machinery/button/door/directional/east{
	pixel_y = 10;
	id = "nt_rep_priv"
	},
/obj/machinery/requests_console/auto_name/directional/north,
/obj/effect/mapping_helpers/requests_console/assistance,
/obj/effect/mapping_helpers/requests_console/supplies,
/obj/effect/mapping_helpers/requests_console/information,
/obj/effect/mapping_helpers/requests_console/announcement,
/obj/machinery/button/curtain{
	id = "nt_rep_priv";
	name = "curtain control";
	pixel_x = 35;
	pixel_y = 10;
	req_access = list("theatre");
	dir = 4
	},
/obj/effect/turf_decal/bot,
/turf/open/floor/carpet/green,
/area/station/command/heads_quarters/nt_rep)
"ux" = (
/obj/machinery/computer/crew,
/obj/machinery/light/small/directional/north,
/obj/effect/turf_decal/bot,
/obj/structure/reagent_dispensers/wall/peppertank/directional/north,
/turf/open/floor/engine,
/area/station/command/heads_quarters/blueshield)
"wx" = (
/obj/structure/table/wood,
/obj/item/paper_bin{
	pixel_y = 4;
	pixel_x = -5
	},
/obj/machinery/recharger{
	pixel_x = 7;
	pixel_y = 6
	},
/obj/effect/mapping_helpers/turn_off_lights_with_lightswitch,
/obj/machinery/atmospherics/components/unary/vent_pump/on/layer4,
/obj/effect/turf_decal/trimline/dark_blue/filled/line{
	dir = 4
	},
/obj/item/pen/fourcolor{
	pixel_x = -5;
	pixel_y = 5
	},
/turf/open/floor/iron/dark/smooth_edge{
	dir = 4
	},
/area/station/command/heads_quarters/blueshield)
"xn" = (
/obj/structure/table/wood,
/obj/machinery/fax{
	fax_name = "Nanotrasen Consultant's Office";
	name = "Nanotrasen Consultant's Fax Machine"
	},
/obj/effect/turf_decal/siding/dark{
	dir = 9
	},
/obj/structure/chalkboard{
	pixel_y = 32
	},
/obj/item/radio/intercom/directional/west,
/turf/open/floor/carpet/green,
/area/station/command/heads_quarters/nt_rep)
"xs" = (
/obj/structure/extinguisher_cabinet/directional/west,
/obj/machinery/light/directional/west,
/turf/open/floor/iron,
/area/station/hallway/primary/central)
"zI" = (
/obj/machinery/vending/boozeomat,
/turf/closed/wall/r_wall,
/area/station/command/heads_quarters/nt_rep)
"BZ" = (
/obj/machinery/door/airlock/corporate{
	name = "Blueshield's Office"
	},
/obj/effect/landmark/navigate_destination/autoname,
/obj/effect/mapping_helpers/airlock/access/any/cent_com/rep_or_captain,
/obj/machinery/atmospherics/pipe/smart/manifold4w/scrubbers/hidden/layer2,
/obj/machinery/atmospherics/pipe/smart/manifold4w/supply/hidden/layer4,
/obj/structure/cable,
/obj/machinery/door/firedoor,
/turf/open/floor/iron/dark,
/area/station/command/heads_quarters/blueshield)
"Ci" = (
/obj/structure/chair/office{
	dir = 8
	},
/obj/effect/landmark/start/nanotrasen_consultant,
/obj/machinery/holopad,
/turf/open/floor/iron,
/area/station/command/heads_quarters/blueshield)
"Cq" = (
/obj/machinery/requests_console/auto_name/directional/north,
/obj/effect/mapping_helpers/requests_console/information,
/obj/effect/mapping_helpers/requests_console/supplies,
/obj/effect/mapping_helpers/requests_console/assistance,
/obj/effect/mapping_helpers/requests_console/announcement,
/obj/machinery/modular_computer/preset/command{
	dir = 5
	},
/obj/machinery/light_switch/directional/west,
/obj/machinery/button/door/directional/west{
	pixel_x = -35;
	pixel_y = 4;
	id = "blueshield_priv"
	},
/obj/effect/turf_decal/trimline/dark_blue/filled/line{
	dir = 1
	},
/turf/open/floor/iron/dark/smooth_edge{
	dir = 1
	},
/area/station/command/heads_quarters/blueshield)
"Eg" = (
/obj/machinery/atmospherics/pipe/smart/manifold4w/scrubbers/hidden/layer2,
/obj/machinery/atmospherics/pipe/smart/manifold4w/supply/hidden/layer4,
/obj/structure/cable,
/turf/open/floor/iron,
/area/station/hallway/primary/central)
"Eo" = (
/obj/structure/table/wood,
/obj/machinery/fax{
	name = "Blueshield's Fax Machine";
	fax_name = "Blueshield's Office"
	},
/obj/machinery/light/directional/north,
/obj/item/radio/intercom/directional/north,
/obj/effect/turf_decal/trimline/dark_blue/filled/line{
	dir = 5
	},
/turf/open/floor/iron/dark/smooth_corner{
	dir = 8
	},
/area/station/command/heads_quarters/blueshield)
"Fk" = (
/obj/structure/safe/abovetilefloor,
/obj/item/folder/ancient_paperwork,
/obj/item/lustwish_discount{
	name = "Consultant's LustWish elite card"
	},
/obj/item/reagent_containers/cup/glass/flask{
	pixel_y = -2;
	pixel_x = 2
	},
/obj/item/storage/toolbox/guncase/skyrat/pistol/sec_glock,
/obj/item/reagent_containers/cup/glass/bottle/hcider,
/obj/item/storage/fancy/cigarettes/cigars/cohiba,
/obj/item/storage/box/matches,
/obj/machinery/firealarm/directional/east,
/obj/item/folder/documents,
/obj/item/paperwork{
	desc = "A densely compiled stack of Internal Affairs records, documenting various investigations, audits and disciplinary proceedings, extensively redacted under CENTCOM authority.";
	name = "internal affairs records"
	},
/obj/effect/landmark/start/nanotrasen_consultant,
/turf/open/floor/carpet/green,
/area/station/command/heads_quarters/nt_rep)
"Fm" = (
/obj/structure/cable,
/obj/effect/landmark/start/hangover,
/obj/machinery/atmospherics/pipe/smart/manifold4w/scrubbers/hidden/layer2,
/obj/machinery/atmospherics/pipe/smart/manifold4w/supply/hidden/layer4,
/turf/open/floor/iron,
/area/station/hallway/primary/central)
"Iz" = (
/obj/structure/flora/bush/sparsegrass/style_random,
/obj/structure/flora/bush/flowers_br/style_random,
/obj/structure/window/reinforced/fulltile,
/obj/structure/curtain/cloth/fancy/mechanical{
	icon_state = "bounty-open";
	icon_type = "bounty";
	id = "nt_rep_priv";
	name = "curtain"
	},
/turf/open/misc/snow/actually_safe,
/area/station/command/heads_quarters/nt_rep)
"IB" = (
/obj/structure/cable,
/obj/effect/turf_decal/siding/dark{
	dir = 1
	},
/obj/effect/mapping_helpers/turn_off_lights_with_lightswitch,
/turf/open/floor/wood,
/area/station/command/heads_quarters/nt_rep)
"Jk" = (
/obj/effect/landmark/event_spawn,
/obj/structure/cable,
/obj/machinery/atmospherics/pipe/smart/manifold4w/scrubbers/hidden/layer2,
/obj/machinery/atmospherics/pipe/smart/manifold4w/supply/hidden/layer4,
/turf/open/floor/iron,
/area/station/hallway/primary/central)
"JL" = (
/obj/machinery/atmospherics/pipe/smart/manifold4w/scrubbers/hidden/layer2,
/obj/structure/cable,
/obj/effect/turf_decal/trimline/dark_blue/filled/line{
	dir = 6
	},
/obj/structure/sign/plaques/kiddie/perfect_man{
	pixel_y = -32
	},
/turf/open/floor/iron/dark/smooth_corner{
	dir = 1
	},
/area/station/command/heads_quarters/blueshield)
"KI" = (
/obj/effect/spawner/structure/window/reinforced,
/obj/machinery/door/poddoor/shutters/preopen{
	id = "blueshield_priv"
	},
/turf/open/floor/plating,
/area/station/command/heads_quarters/blueshield)
"KN" = (
/turf/open/floor/carpet/green,
/area/station/command/heads_quarters/nt_rep)
"KT" = (
/obj/structure/cable,
/obj/machinery/atmospherics/pipe/smart/manifold4w/scrubbers/hidden/layer2,
/obj/machinery/atmospherics/pipe/smart/manifold4w/supply/hidden/layer4,
/obj/structure/cable,
/turf/open/floor/iron,
/area/station/hallway/primary/central)
"LI" = (
/obj/machinery/suit_storage_unit/security,
/obj/structure/window/reinforced/spawner/directional/south,
/obj/structure/window/reinforced/spawner/directional/west,
/obj/effect/turf_decal/delivery/red,
/obj/structure/window/reinforced/spawner/directional/east,
/turf/open/floor/iron/dark/textured,
/area/station/command/heads_quarters/blueshield)
"MN" = (
/obj/machinery/atmospherics/pipe/smart/manifold4w/scrubbers/hidden/layer2,
/obj/structure/disposalpipe/segment{
	dir = 4
	},
/obj/machinery/atmospherics/pipe/smart/manifold4w/supply/hidden/layer4,
/obj/effect/turf_decal/siding/dark{
	dir = 4
	},
/turf/open/floor/wood,
/area/station/command/heads_quarters/nt_rep)
"Nh" = (
/obj/machinery/photocopier/prebuilt,
/obj/effect/turf_decal/bot,
/turf/open/floor/carpet/green,
/area/station/command/heads_quarters/nt_rep)
"ND" = (
/obj/machinery/door/firedoor,
/obj/effect/mapping_helpers/airlock/access/all/cent_com/rep_door,
/obj/effect/turf_decal/siding/dark,
/obj/effect/mapping_helpers/airlock/unres/delayed{
	dir = 1
	},
/obj/effect/turf_decal/siding/dark,
/obj/effect/turf_decal/siding/dark{
	dir = 1
	},
/obj/effect/turf_decal/tile/neutral/opposingcorners,
/obj/machinery/door/airlock/corporate{
	name = "Consultant's Quarters"
	},
/turf/open/floor/iron/dark,
/area/station/command/heads_quarters/nt_rep)
"OJ" = (
/obj/structure/closet/secure_closet/nanotrasen_consultant,
/obj/item/clothing/accessory/medal/gold/ordom,
/obj/item/clothing/accessory/medal/silver/bureaucracy,
/obj/item/hand_labeler,
/obj/machinery/newscaster/directional/north,
/obj/item/stack/sheet/mineral/wood/fifty,
/turf/open/floor/carpet/green,
/area/station/command/heads_quarters/nt_rep)
"OY" = (
/obj/effect/turf_decal/bot_white,
/turf/open/floor/iron/dark,
/area/station/hallway/primary/central)
"Qj" = (
/obj/machinery/atmospherics/pipe/smart/manifold4w/scrubbers/hidden/layer2,
/obj/machinery/atmospherics/pipe/smart/manifold4w/supply/hidden/layer4,
/obj/structure/cable,
/obj/machinery/digital_clock/directional/south,
/turf/open/floor/iron,
/area/station/command/heads_quarters/blueshield)
"Qk" = (
/obj/structure/flora/grass/green/style_random,
/obj/structure/flora/bush/flowers_br/style_random,
/obj/structure/window/reinforced/fulltile,
/obj/structure/curtain/cloth/fancy/mechanical{
	icon_state = "bounty-open";
	icon_type = "bounty";
	id = "nt_rep_priv";
	name = "curtain"
	},
/turf/open/misc/snow/actually_safe,
/area/station/command/heads_quarters/nt_rep)
"Qs" = (
/turf/template_noop,
/area/template_noop)
"QJ" = (
/obj/machinery/atmospherics/components/unary/vent_scrubber/on/layer2,
/obj/effect/landmark/start/blueshield,
/obj/structure/chair/comfy/brown{
	dir = 4
	},
/obj/effect/landmark/start/blueshield,
/obj/effect/landmark/start/blueshield,
/obj/effect/landmark/start/blueshield,
/obj/effect/landmark/start/blueshield,
/turf/open/floor/iron/dark/smooth_large,
/area/station/command/heads_quarters/blueshield)
"TI" = (
/obj/item/bedsheet/nanotrasen,
/obj/structure/bed,
/obj/item/toy/plush/lizard_plushie/greyscale{
	name = "Hunts-the-Traitor";
	desc = "The Blueshield's best friend, a little too eager to go after criminals and evil-doers alike. He's grounded forever.";
	greyscale_colors = "#FF0000#000000"
	},
/obj/machinery/camera/directional/west{
	c_tag = "NT Consultant's Office";
	name = "command camera";
	dir = 6
	},
/obj/machinery/light/small/directional/south,
/obj/machinery/vending/wallmed/directional/south,
/turf/open/floor/engine,
/area/station/command/heads_quarters/blueshield)
"TR" = (
/obj/structure/chair/office/tactical{
	dir = 4
	},
/obj/effect/landmark/start/nanotrasen_consultant,
/obj/effect/landmark/start/nanotrasen_consultant,
/obj/effect/landmark/start/nanotrasen_consultant,
/obj/effect/landmark/start/nanotrasen_consultant,
/obj/effect/landmark/start/nanotrasen_consultant,
/turf/open/floor/carpet/green,
/area/station/command/heads_quarters/nt_rep)
"Vq" = (
/obj/structure/cable,
/obj/machinery/atmospherics/pipe/smart/manifold4w/scrubbers/hidden/layer2,
/obj/machinery/atmospherics/pipe/smart/manifold4w/supply/hidden/layer4,
/turf/open/floor/iron,
/area/station/hallway/primary/central)
"Vr" = (
/obj/structure/closet/secure_closet/tac{
	req_access = list("captain")
	},
/obj/structure/window/reinforced/spawner/directional/west,
/obj/effect/turf_decal/delivery/red,
/obj/structure/sign/flag/nanotrasen/directional/west,
/obj/machinery/door/window/brigdoor/right/directional/east{
	req_access = list("captain");
	name = "Blueshield's Armory"
	},
/obj/item/shield/riot,
/obj/item/screwdriver,
/obj/item/gun_maintenance_supplies,
/turf/open/floor/iron/dark/textured,
/area/station/command/heads_quarters/blueshield)
"WE" = (
/obj/machinery/holopad,
/turf/open/floor/carpet/green,
/area/station/command/heads_quarters/nt_rep)
"WI" = (
/obj/machinery/vending/cigarette,
/obj/effect/turf_decal/bot_white,
/turf/open/floor/iron/dark,
/area/station/hallway/primary/central)
"Zr" = (
/obj/structure/chair/greyscale{
	dir = 8
	},
/obj/effect/turf_decal/delivery/white,
/obj/effect/landmark/start/blueshield,
/turf/open/floor/iron/dark,
/area/station/hallway/primary/central)

(1,1,1) = {"
Qs
Qs
Qs
Qs
aa
aa
aa
aa
aa
aG
aa
aa
"}
(2,1,1) = {"
nj
nj
nj
nj
aa
OJ
bI
zI
aK
aR
aW
aa
"}
(3,1,1) = {"
nj
ak
Vr
LI
aa
os
Fk
ND
aQ
aL
as
aa
"}
(4,1,1) = {"
nj
ux
qS
TI
aa
aa
aa
aa
an
aV
ar
aa
"}
(5,1,1) = {"
nj
nj
sk
nj
aa
xn
aF
lG
IB
az
aj
aa
"}
(6,1,1) = {"
nj
Cq
QJ
tg
bb
kw
WE
KN
sw
MN
ag
aa
"}
(7,1,1) = {"
nj
Eo
wx
JL
aa
uj
TR
Nh
al
aO
am
aa
"}
(8,1,1) = {"
nj
bC
Ci
Qj
aa
aa
gQ
Iz
Qk
ax
aS
aS
"}
(9,1,1) = {"
nj
KI
KI
BZ
aa
WI
Zr
OY
ap
aN
ab
aa
"}
(10,1,1) = {"
hO
aB
aB
Eg
xs
aB
aB
oh
dA
Vq
aB
aB
"}
(11,1,1) = {"
px
px
px
KT
Fm
Vq
Vq
re
re
re
Jk
Vq
"}
