//MAP CONVERTED BY dmm2tgm.py THIS HEADER COMMENT PREVENTS RECONVERSION, DO NOT REMOVE
"a" = (
/obj/effect/turf_decal/tile/purple{
	dir = 1
	},
/obj/effect/turf_decal/tile/purple,
/obj/machinery/atmospherics/components/unary/vent_scrubber/on/layer2{
	dir = 1
	},
/turf/open/floor/iron,
/area/station/service/barber)
"c" = (
/obj/structure/chair/comfy/barber_chair{
	dir = 8
	},
/obj/effect/turf_decal/tile/purple{
	dir = 1
	},
/obj/effect/turf_decal/tile/purple,
/obj/effect/turf_decal/tile/purple,
/obj/machinery/atmospherics/pipe/smart/manifold4w/scrubbers/hidden/layer2,
/obj/machinery/atmospherics/pipe/smart/manifold4w/supply/hidden/layer4,
/obj/structure/cable,
/obj/structure/disposalpipe/segment,
/obj/effect/landmark/start/hangover,
/turf/open/floor/iron,
/area/station/service/barber)
"j" = (
/turf/template_noop,
/area/template_noop)
"k" = (
/obj/effect/spawner/structure/window,
/obj/structure/curtain/cloth/fancy/mechanical{
	id = "barbershopcurtains"
	},
/turf/open/floor/plating,
/area/station/service/barber)
"n" = (
/obj/structure/chair/office/light{
	dir = 4
	},
/obj/effect/turf_decal/tile/purple{
	dir = 1
	},
/obj/effect/turf_decal/tile/purple,
/obj/machinery/atmospherics/pipe/smart/manifold4w/supply/hidden/layer4,
/turf/open/floor/iron,
/area/station/service/barber)
"p" = (
/obj/effect/turf_decal/tile/purple{
	dir = 1
	},
/obj/effect/turf_decal/tile/purple,
/obj/machinery/atmospherics/pipe/smart/manifold4w/scrubbers/hidden/layer2,
/turf/open/floor/iron,
/area/station/service/barber)
"q" = (
/obj/structure/chair/comfy/barber_chair{
	dir = 8
	},
/obj/effect/turf_decal/tile/purple{
	dir = 1
	},
/obj/effect/turf_decal/tile/purple{
	dir = 1
	},
/obj/effect/turf_decal/tile/purple,
/obj/structure/cable,
/obj/machinery/airalarm/directional/north,
/obj/structure/disposalpipe/segment,
/turf/open/floor/iron,
/area/station/service/barber)
"r" = (
/obj/item/radio/intercom/directional/west,
/obj/effect/turf_decal/tile/purple{
	dir = 1
	},
/obj/effect/turf_decal/tile/purple,
/obj/item/reagent_containers/dropper,
/obj/structure/table/reinforced/rglass,
/turf/open/floor/iron,
/area/station/service/barber)
"v" = (
/obj/structure/mirror/directional/west,
/obj/effect/turf_decal/tile/purple{
	dir = 1
	},
/obj/effect/turf_decal/tile/purple,
/obj/structure/table/reinforced/rglass,
/turf/open/floor/iron,
/area/station/service/barber)
"w" = (
/obj/structure/disposalpipe/junction{
	dir = 4
	},
/obj/structure/cable,
/turf/open/floor/plating,
/area/station/maintenance/starboard/fore)
"x" = (
/obj/effect/turf_decal/tile/purple{
	dir = 1
	},
/obj/effect/turf_decal/tile/purple,
/obj/machinery/disposal/bin,
/obj/machinery/firealarm/directional/west,
/obj/structure/disposalpipe/trunk{
	dir = 4
	},
/turf/open/floor/iron,
/area/station/service/barber)
"y" = (
/obj/structure/mirror/directional/west,
/obj/effect/turf_decal/tile/purple{
	dir = 1
	},
/obj/effect/turf_decal/tile/purple,
/obj/item/hairbrush/comb{
	pixel_y = 10
	},
/obj/item/reagent_containers/spray/quantum_hair_dye{
	pixel_x = 6
	},
/obj/item/reagent_containers/spray/barbers_aid{
	pixel_x = -6
	},
/obj/item/razor,
/obj/structure/table/reinforced/rglass,
/turf/open/floor/iron,
/area/station/service/barber)
"E" = (
/obj/effect/turf_decal/tile/purple{
	dir = 1
	},
/obj/effect/turf_decal/tile/purple,
/obj/machinery/button/curtain{
	id = "barbershopcurtains";
	pixel_x = 25;
	pixel_y = 24
	},
/obj/machinery/atmospherics/components/unary/vent_pump/on/layer4,
/obj/structure/cable,
/obj/machinery/power/apc/auto_name/directional/north,
/turf/open/floor/iron,
/area/station/service/barber)
"H" = (
/obj/structure/disposalpipe/segment,
/turf/closed/wall,
/area/station/service/barber)
"I" = (
/turf/closed/wall,
/area/station/service/barber)
"K" = (
/obj/machinery/atmospherics/pipe/smart/manifold4w/scrubbers/hidden/layer2,
/obj/machinery/atmospherics/pipe/smart/manifold4w/supply/hidden/layer4,
/obj/structure/cable,
/obj/machinery/door/airlock/public{
	name = "Massage Parlour"
	},
/obj/effect/turf_decal/tile/purple{
	dir = 1
	},
/obj/effect/turf_decal/tile/purple,
/turf/open/floor/iron,
/area/station/service/barber)
"L" = (
/obj/structure/sign/barber{
	pixel_y = 18
	},
/turf/open/floor/iron,
/area/station/hallway/primary/starboard)
"M" = (
/obj/machinery/atmospherics/pipe/smart/manifold4w/scrubbers/hidden/layer2,
/obj/machinery/atmospherics/pipe/smart/manifold4w/supply/hidden/layer4,
/obj/structure/cable,
/turf/open/floor/iron,
/area/station/hallway/primary/starboard)
"N" = (
/obj/machinery/vending/barbervend,
/obj/effect/turf_decal/tile/purple{
	dir = 1
	},
/obj/effect/turf_decal/tile/purple,
/turf/open/floor/iron,
/area/station/service/barber)
"P" = (
/obj/effect/turf_decal/tile/purple{
	dir = 1
	},
/obj/effect/turf_decal/tile/purple,
/obj/machinery/atmospherics/pipe/smart/manifold4w/scrubbers/hidden/layer2,
/obj/machinery/atmospherics/pipe/smart/manifold4w/supply/hidden/layer4,
/obj/structure/cable,
/obj/structure/disposalpipe/segment{
	dir = 9
	},
/turf/open/floor/iron,
/area/station/service/barber)
"Q" = (
/obj/structure/table/glass,
/obj/item/lipstick/random,
/obj/item/hairbrush,
/obj/effect/turf_decal/tile/purple{
	dir = 1
	},
/obj/effect/turf_decal/tile/purple,
/turf/open/floor/iron,
/area/station/service/barber)
"S" = (
/obj/effect/turf_decal/tile/purple{
	dir = 1
	},
/obj/effect/turf_decal/tile/purple,
/obj/machinery/atmospherics/pipe/smart/manifold4w/supply/hidden/layer4,
/obj/structure/cable,
/obj/structure/disposalpipe/segment,
/turf/open/floor/iron,
/area/station/service/barber)
"W" = (
/obj/structure/bed/pod,
/obj/structure/window/spawner/directional/south,
/obj/effect/landmark/start/hangover,
/obj/effect/turf_decal/tile/purple{
	dir = 1
	},
/obj/effect/turf_decal/tile/purple,
/turf/open/floor/iron,
/area/station/service/barber)
"X" = (
/obj/structure/closet/secure_closet/barber,
/obj/effect/turf_decal/tile/purple{
	dir = 1
	},
/obj/effect/turf_decal/tile/purple,
/obj/machinery/light/directional/east,
/turf/open/floor/iron,
/area/station/service/barber)

(1,1,1) = {"
j
I
I
I
I
I
I
j
"}
(2,1,1) = {"
j
I
y
r
v
x
k
j
"}
(3,1,1) = {"
w
H
q
S
c
P
K
M
"}
(4,1,1) = {"
j
I
E
n
p
a
k
L
"}
(5,1,1) = {"
j
I
Q
W
X
N
I
j
"}
(6,1,1) = {"
j
I
I
I
I
I
I
j
"}
