//MAP CONVERTED BY dmm2tgm.py THIS HEADER COMMENT PREVENTS RECONVERSION, DO NOT REMOVE
"a" = (
/turf/closed/wall/r_wall,
/area/station/command/heads_quarters/nt_rep)
"c" = (
/obj/machinery/door/firedoor,
/obj/machinery/door/airlock/maintenance,
/obj/effect/mapping_helpers/airlock/access/all/cent_com/rep_door,
/obj/structure/disposalpipe/segment{
	dir = 4
	},
/turf/open/floor/iron/dark/smooth_large,
/area/station/command/heads_quarters/nt_rep)
"d" = (
/obj/machinery/door/airlock/corporate{
	name = "NT Consultant's Office"
	},
/obj/structure/cable,
/obj/machinery/atmospherics/pipe/smart/manifold/supply/hidden/layer4,
/obj/machinery/atmospherics/pipe/smart/manifold4w/scrubbers/hidden/layer2,
/obj/machinery/door/firedoor,
/obj/effect/mapping_helpers/airlock/access/all/cent_com/rep_door,
/obj/structure/disposalpipe/junction/flip{
	dir = 8
	},
/turf/open/floor/iron/dark/smooth_large,
/area/station/command/heads_quarters/nt_rep)
"e" = (
/obj/effect/turf_decal/bot,
/obj/structure/chair/stool/directional{
	dir = 8
	},
/turf/open/floor/iron/dark,
/area/station/hallway/primary/central)
"f" = (
/obj/effect/spawner/random/bureaucracy/paper,
/obj/item/toy/crayon/white{
	pixel_y = 10;
	pixel_x = 10
	},
/obj/structure/table/wood,
/obj/machinery/atmospherics/pipe/smart/manifold4w/scrubbers/hidden/layer2,
/obj/structure/disposalpipe/segment{
	dir = 4
	},
/turf/open/floor/iron/dark/textured_large,
/area/station/command/heads_quarters/nt_rep)
"g" = (
/obj/machinery/light/warm/dim/directional/south,
/turf/open/floor/iron/dark/textured_large,
/area/station/command/heads_quarters/nt_rep)
"h" = (
/obj/structure/table/wood,
/obj/machinery/fax{
	fax_name = "Nanotrasen Consultant's Office";
	name = "Nanotrasen Consultant's Fax Machine"
	},
/turf/open/floor/iron/dark/textured_large,
/area/station/command/heads_quarters/nt_rep)
"i" = (
/obj/structure/table/reinforced,
/obj/machinery/door/window/brigdoor{
	base_state = "rightsecure";
	icon_state = "rightsecure";
	name = "Consultant's Desk";
	dir = 4;
	req_access = list("cent_general")
	},
/obj/item/table_clock{
	pixel_y = 16
	},
/obj/machinery/door/poddoor/preopen{
	id = "nt_rep_priv";
	name = "Privacy Shutter"
	},
/turf/open/floor/plating,
/area/station/command/heads_quarters/nt_rep)
"k" = (
/obj/machinery/atmospherics/pipe/smart/manifold4w/scrubbers/hidden/layer2,
/obj/machinery/holopad,
/obj/structure/disposalpipe/segment{
	dir = 4
	},
/obj/effect/landmark/navigate_destination/autoname,
/turf/open/floor/iron/dark/textured_large,
/area/station/command/heads_quarters/nt_rep)
"n" = (
/obj/structure/cable,
/obj/effect/landmark/start/nanotrasen_consultant,
/turf/open/floor/iron/dark/textured_large,
/area/station/command/heads_quarters/nt_rep)
"o" = (
/obj/machinery/vending/boozeomat/all_access,
/turf/open/floor/carpet/executive,
/area/station/command/heads_quarters/nt_rep)
"p" = (
/turf/open/floor/iron/dark,
/area/station/hallway/primary/central)
"q" = (
/obj/machinery/atmospherics/pipe/smart/manifold4w/supply/hidden/layer4,
/obj/machinery/atmospherics/pipe/smart/manifold4w/scrubbers/hidden/layer2,
/obj/structure/cable,
/obj/machinery/time_clock/directional/west,
/obj/structure/disposalpipe/trunk{
	dir = 1
	},
/obj/machinery/disposal/bin,
/turf/open/floor/iron/dark,
/area/station/hallway/primary/central)
"r" = (
/obj/structure/chair/comfy/beige{
	dir = 1
	},
/turf/open/floor/iron/dark/textured_large,
/area/station/command/heads_quarters/nt_rep)
"t" = (
/obj/effect/turf_decal/bot,
/obj/machinery/vending/cigarette,
/turf/open/floor/iron/dark,
/area/station/hallway/primary/central)
"u" = (
/obj/machinery/light_switch/directional/east,
/obj/structure/cable,
/obj/machinery/atmospherics/components/unary/vent_pump/on/layer4,
/turf/open/floor/iron/dark/textured_large,
/area/station/command/heads_quarters/nt_rep)
"v" = (
/obj/machinery/door/airlock/corporate{
	name = "NT Consultant's Office"
	},
/obj/machinery/door/firedoor,
/obj/effect/mapping_helpers/airlock/access/all/cent_com/rep_door,
/turf/open/floor/carpet/executive,
/area/station/command/heads_quarters/nt_rep)
"w" = (
/obj/effect/spawner/random/bureaucracy/paper,
/obj/structure/table/wood,
/obj/machinery/atmospherics/pipe/smart/manifold4w/scrubbers/hidden/layer2,
/obj/structure/disposalpipe/segment{
	dir = 4
	},
/turf/open/floor/iron/dark/textured_large,
/area/station/command/heads_quarters/nt_rep)
"y" = (
/obj/structure/sign/flag/nanotrasen/directional/west,
/turf/template_noop,
/area/template_noop)
"A" = (
/obj/item/kirbyplants/random,
/obj/machinery/firealarm/directional/south,
/obj/machinery/light/warm/dim/directional/west,
/turf/open/floor/iron/dark/textured_large,
/area/station/command/heads_quarters/nt_rep)
"B" = (
/obj/structure/chalkboard,
/turf/closed/wall/r_wall,
/area/station/command/heads_quarters/nt_rep)
"C" = (
/obj/machinery/power/apc/auto_name/directional/west,
/obj/structure/cable,
/obj/machinery/atmospherics/components/unary/vent_scrubber/on/layer2,
/turf/open/floor/iron/dark/textured_large,
/area/station/command/heads_quarters/nt_rep)
"D" = (
/obj/structure/bed/double,
/obj/item/bedsheet/centcom/double,
/obj/machinery/light/small/blacklight/directional/east{
	desc = "A small lighting fixture. Why is this here?"
	},
/obj/effect/decal/cleanable/cum,
/turf/open/floor/carpet/executive,
/area/station/command/heads_quarters/nt_rep)
"E" = (
/obj/effect/turf_decal/delivery,
/obj/structure/chair/stool/directional{
	dir = 8
	},
/turf/open/floor/iron/dark,
/area/station/hallway/primary/central)
"F" = (
/obj/structure/sign/flag/galfed,
/turf/closed/wall/r_wall,
/area/station/command/heads_quarters/nt_rep)
"H" = (
/obj/machinery/modular_computer/preset/command,
/turf/open/floor/carpet/executive,
/area/station/command/heads_quarters/nt_rep)
"I" = (
/obj/machinery/airalarm/directional/east{
	pixel_y = -5
	},
/obj/machinery/button/door/directional/east{
	pixel_y = 10;
	id = "nt_rep_priv"
	},
/obj/effect/landmark/start/nanotrasen_consultant,
/turf/open/floor/carpet/executive,
/area/station/command/heads_quarters/nt_rep)
"J" = (
/obj/effect/landmark/start/nanotrasen_consultant,
/turf/open/floor/carpet/executive,
/area/station/command/heads_quarters/nt_rep)
"L" = (
/obj/machinery/atmospherics/pipe/smart/manifold4w/scrubbers/hidden/layer2,
/obj/structure/disposalpipe/segment{
	dir = 4
	},
/turf/open/floor/iron/dark/textured_large,
/area/station/command/heads_quarters/nt_rep)
"M" = (
/obj/structure/chair/office/tactical{
	dir = 4
	},
/turf/open/floor/carpet/executive,
/area/station/command/heads_quarters/nt_rep)
"N" = (
/obj/machinery/atmospherics/pipe/smart/manifold4w/supply/hidden/layer4,
/obj/machinery/atmospherics/pipe/smart/manifold4w/scrubbers/hidden/layer2,
/obj/structure/cable,
/obj/structure/disposalpipe/segment{
	dir = 10
	},
/turf/open/floor/iron/dark,
/area/station/hallway/primary/central)
"O" = (
/obj/structure/cable,
/obj/machinery/atmospherics/pipe/smart/manifold/supply/hidden/layer4,
/obj/machinery/atmospherics/pipe/smart/manifold4w/scrubbers/hidden/layer2,
/obj/structure/disposalpipe/segment{
	dir = 4
	},
/turf/open/floor/iron/dark/textured_large,
/area/station/command/heads_quarters/nt_rep)
"P" = (
/obj/structure/closet/secure_closet/nanotrasen_consultant/station,
/turf/open/floor/carpet/executive,
/area/station/command/heads_quarters/nt_rep)
"Q" = (
/obj/structure/cable,
/turf/open/floor/iron/dark/textured_large,
/area/station/command/heads_quarters/nt_rep)
"S" = (
/obj/structure/disposalpipe/segment,
/turf/closed/wall/r_wall,
/area/station/command/heads_quarters/nt_rep)
"T" = (
/turf/closed/wall/r_wall,
/area/station/hallway/primary/central)
"U" = (
/turf/template_noop,
/area/template_noop)
"X" = (
/obj/structure/table/reinforced,
/obj/item/stamp/centcom{
	pixel_x = -6;
	pixel_y = 8
	},
/obj/item/stamp/denied{
	pixel_x = -6;
	pixel_y = 4
	},
/obj/item/stamp{
	pixel_x = -6
	},
/obj/item/paper_bin{
	pixel_y = 4;
	pixel_x = 6
	},
/obj/item/pen/fountain{
	pixel_x = 6
	},
/obj/machinery/light/warm/dim/directional/west,
/turf/open/floor/carpet/executive,
/area/station/command/heads_quarters/nt_rep)
"Y" = (
/obj/structure/filingcabinet/chestdrawer,
/turf/open/floor/carpet/executive,
/area/station/command/heads_quarters/nt_rep)
"Z" = (
/obj/machinery/photocopier,
/obj/structure/table/reinforced,
/obj/structure/sign/calendar/directional/west,
/turf/open/floor/carpet/executive,
/area/station/command/heads_quarters/nt_rep)

(1,1,1) = {"
a
a
a
a
a
c
a
a
"}
(2,1,1) = {"
a
Y
J
v
C
L
A
a
"}
(3,1,1) = {"
a
P
D
B
n
w
r
a
"}
(4,1,1) = {"
a
a
F
a
n
f
r
a
"}
(5,1,1) = {"
a
Z
X
o
Q
k
g
a
"}
(6,1,1) = {"
a
H
M
I
u
O
h
a
"}
(7,1,1) = {"
a
a
i
a
a
d
S
S
"}
(8,1,1) = {"
T
t
E
e
p
N
q
T
"}
(9,1,1) = {"
U
U
U
U
U
U
U
y
"}
