//MAP CONVERTED BY dmm2tgm.py THIS HEADER COMMENT PREVENTS RECONVERSION, DO NOT REMOVE
"a" = (
/obj/structure/table,
/obj/effect/turf_decal/tile/red/anticorner/contrasted{
	dir = 1
	},
/turf/open/floor/iron,
/area/station/security/checkpoint/supply)
"b" = (
/obj/machinery/airalarm/directional/east,
/obj/structure/table,
/obj/item/book/manual/wiki/security_space_law,
/obj/effect/turf_decal/tile/red/anticorner/contrasted{
	dir = 4
	},
/turf/open/floor/iron,
/area/station/security/checkpoint/supply)
"f" = (
/obj/structure/reagent_dispensers/wall/peppertank/directional/east,
/obj/machinery/newscaster/directional/south,
/obj/machinery/camera/directional/south{
	c_tag = "Security Post - Cargo"
	},
/obj/machinery/computer/security/mining{
	dir = 8
	},
/obj/effect/turf_decal/tile/red/anticorner/contrasted,
/turf/open/floor/iron,
/area/station/security/checkpoint/supply)
"h" = (
/obj/machinery/atmospherics/pipe/smart/manifold4w/scrubbers/hidden/layer2,
/obj/machinery/atmospherics/components/unary/vent_pump/on/layer4{
	dir = 8
	},
/obj/structure/cable,
/obj/effect/turf_decal/tile/red/half/contrasted{
	dir = 8
	},
/obj/effect/landmark/start/customs_agent,
/turf/open/floor/iron,
/area/station/security/checkpoint/supply)
"i" = (
/obj/machinery/atmospherics/components/unary/vent_scrubber/on/layer2{
	dir = 1
	},
/obj/effect/turf_decal/tile/red/half/contrasted,
/obj/item/radio/intercom/directional/south,
/turf/open/floor/iron,
/area/station/security/checkpoint/supply)
"m" = (
/obj/machinery/vending/wardrobe/sec_wardrobe,
/obj/machinery/power/apc/auto_name/directional/south,
/obj/structure/cable,
/obj/effect/turf_decal/tile/red/half/contrasted,
/turf/open/floor/iron,
/area/station/security/checkpoint/supply)
"p" = (
/obj/machinery/light_switch/directional/south,
/obj/structure/closet/secure_closet/security/cargo,
/obj/effect/turf_decal/tile/red/anticorner/contrasted{
	dir = 8
	},
/turf/open/floor/iron,
/area/station/security/checkpoint/supply)
"r" = (
/obj/machinery/door/airlock/security/glass{
	name = "Security Office"
	},
/obj/machinery/atmospherics/pipe/smart/manifold4w/scrubbers/hidden/layer2,
/obj/machinery/atmospherics/pipe/smart/manifold4w/supply/hidden/layer4,
/obj/structure/cable,
/obj/effect/mapping_helpers/airlock/access/all/supply/customs,
/turf/open/floor/iron,
/area/station/security/checkpoint/supply)
"s" = (
/turf/closed/wall,
/area/station/maintenance/port/aft)
"A" = (
/turf/closed/wall,
/area/station/cargo/miningdock)
"F" = (
/obj/item/screwdriver{
	pixel_y = 10
	},
/obj/item/radio/off,
/obj/machinery/atmospherics/pipe/smart/manifold4w/scrubbers/hidden/layer2,
/obj/structure/cable,
/turf/open/floor/iron,
/area/station/security/checkpoint/supply)
"I" = (
/turf/closed/wall,
/area/station/security/checkpoint/supply)
"N" = (
/obj/item/paper_bin{
	pixel_x = 1;
	pixel_y = 9
	},
/obj/item/pen,
/obj/structure/table,
/obj/effect/turf_decal/tile/red/half/contrasted{
	dir = 1
	},
/turf/open/floor/iron,
/area/station/security/checkpoint/supply)
"R" = (
/obj/effect/spawner/structure/window/reinforced,
/turf/open/floor/plating,
/area/station/security/checkpoint/supply)
"T" = (
/obj/structure/chair/office{
	dir = 1
	},
/obj/machinery/atmospherics/pipe/smart/manifold4w/scrubbers/hidden/layer2,
/obj/effect/landmark/start/customs_agent,
/turf/open/floor/iron,
/area/station/security/checkpoint/supply)
"X" = (
/obj/machinery/computer/records/security{
	dir = 8
	},
/obj/effect/turf_decal/tile/red/half/contrasted{
	dir = 4
	},
/obj/machinery/light/directional/east,
/obj/effect/mapping_helpers/requests_console/assistance,
/obj/effect/mapping_helpers/requests_console/information,
/obj/machinery/requests_console/directional/east{
	department = "Security";
	name = "Security Requests Console"
	},
/turf/open/floor/iron,
/area/station/security/checkpoint/supply)
"Z" = (
/obj/machinery/recharger{
	pixel_y = 4
	},
/obj/structure/table,
/obj/effect/turf_decal/tile/red/half/contrasted{
	dir = 1
	},
/turf/open/floor/iron,
/area/station/security/checkpoint/supply)

(1,1,1) = {"
I
R
r
I
A
"}
(2,1,1) = {"
R
a
h
p
s
"}
(3,1,1) = {"
R
N
F
m
s
"}
(4,1,1) = {"
R
Z
T
i
s
"}
(5,1,1) = {"
R
b
X
f
s
"}
(6,1,1) = {"
I
I
I
I
s
"}
