//MAP CONVERTED BY dmm2tgm.py THIS HEADER COMMENT PREVENTS RECONVERSION, DO NOT REMOVE
"aa" = (
/turf/closed/wall/r_wall,
/area/station/command/heads_quarters/nt_rep)
"ab" = (
/obj/machinery/atmospherics/pipe/smart/manifold4w/supply/hidden/layer4,
/obj/machinery/atmospherics/pipe/smart/manifold4w/scrubbers/hidden/layer2,
/obj/structure/cable,
/obj/machinery/time_clock/directional/west,
/obj/structure/disposalpipe/trunk{
	dir = 1
	},
/obj/machinery/disposal/bin,
/obj/effect/turf_decal/bot_white,
/turf/open/floor/iron/dark,
/area/station/hallway/primary/central)
"ag" = (
/obj/machinery/light/warm/dim/directional/south,
/obj/effect/turf_decal/siding/wood{
	dir = 1
	},
/turf/open/floor/wood/tile,
/area/station/command/heads_quarters/nt_rep)
"aj" = (
/obj/machinery/airalarm/directional/south,
/obj/structure/chair/comfy/black{
	dir = 1
	},
/obj/effect/turf_decal/siding/wood/corner{
	dir = 4
	},
/turf/open/floor/wood/tile,
/area/station/command/heads_quarters/nt_rep)
"ak" = (
/obj/machinery/atmospherics/pipe/smart/manifold4w/scrubbers/hidden/layer2,
/obj/machinery/holopad,
/obj/structure/disposalpipe/segment{
	dir = 4
	},
/obj/effect/turf_decal/bot,
/turf/open/floor/iron/dark/textured_large,
/area/station/command/heads_quarters/nt_rep)
"al" = (
/obj/structure/cable,
/obj/machinery/atmospherics/components/unary/vent_pump/on/layer4,
/obj/effect/turf_decal/siding/wood/corner{
	dir = 8
	},
/turf/open/floor/wood/tile,
/area/station/command/heads_quarters/nt_rep)
"am" = (
/obj/machinery/photocopier,
/obj/effect/turf_decal/siding/wood/corner{
	dir = 1
	},
/obj/machinery/light_switch/directional/south,
/turf/open/floor/wood/tile,
/area/station/command/heads_quarters/nt_rep)
"an" = (
/obj/structure/cable,
/obj/effect/landmark/start/nanotrasen_consultant,
/turf/open/floor/wood/tile,
/area/station/command/heads_quarters/nt_rep)
"ap" = (
/obj/structure/cable,
/turf/open/floor/wood/tile,
/area/station/command/heads_quarters/nt_rep)
"ar" = (
/obj/structure/chair/comfy/black{
	dir = 1
	},
/turf/open/floor/wood/tile,
/area/station/command/heads_quarters/nt_rep)
"as" = (
/obj/machinery/firealarm/directional/south,
/obj/machinery/atmospherics/components/unary/vent_scrubber/on/layer2{
	dir = 1
	},
/turf/open/floor/wood/tile,
/area/station/command/heads_quarters/nt_rep)
"ax" = (
/obj/machinery/door/airlock/corporate{
	name = "Nanotrasen Consultant's Office"
	},
/obj/structure/cable,
/obj/machinery/atmospherics/pipe/smart/manifold/supply/hidden/layer4,
/obj/machinery/atmospherics/pipe/smart/manifold4w/scrubbers/hidden/layer2,
/obj/machinery/door/firedoor,
/obj/effect/mapping_helpers/airlock/access/all/cent_com/rep_door,
/obj/structure/disposalpipe/junction/flip{
	dir = 8
	},
/obj/effect/landmark/navigate_destination/autoname,
/obj/effect/mapping_helpers/airlock/unres{
	dir = 8
	},
/obj/effect/turf_decal/siding/wood{
	dir = 8
	},
/turf/open/floor/iron/dark/textured_large,
/area/station/command/heads_quarters/nt_rep)
"az" = (
/obj/machinery/atmospherics/pipe/smart/manifold4w/scrubbers/hidden/layer2,
/obj/structure/disposalpipe/segment{
	dir = 4
	},
/obj/structure/table/wood,
/obj/item/table_clock{
	pixel_y = 16;
	pixel_x = -7
	},
/obj/item/storage/fancy/cigarettes/cigars/cohiba{
	pixel_x = 4;
	pixel_y = 3
	},
/obj/item/storage/fancy/cigarettes/cigars/cohiba{
	pixel_x = 4;
	pixel_y = 7
	},
/obj/item/lighter{
	pixel_x = 5
	},
/obj/effect/turf_decal/siding/wood{
	dir = 4
	},
/turf/open/floor/wood/tile,
/area/station/command/heads_quarters/nt_rep)
"aB" = (
/obj/structure/chalkboard,
/turf/closed/wall/r_wall,
/area/station/command/heads_quarters/nt_rep)
"aF" = (
/obj/structure/cable,
/obj/effect/landmark/start/nanotrasen_consultant,
/obj/effect/turf_decal/siding/wood/corner,
/turf/open/floor/wood/tile,
/area/station/command/heads_quarters/nt_rep)
"aG" = (
/obj/effect/mapping_helpers/airlock/access/all/cent_com/rep_door,
/obj/machinery/door/airlock/maintenance,
/obj/machinery/door/firedoor,
/obj/structure/disposalpipe/segment{
	dir = 4
	},
/turf/open/floor/iron/dark/textured_large,
/area/station/command/heads_quarters/nt_rep)
"aK" = (
/obj/machinery/power/apc/auto_name/directional/west,
/obj/structure/cable,
/obj/structure/bed/dogbed{
	name = "Lisa's bed"
	},
/mob/living/basic/pet/dog/corgi/lisa,
/turf/open/floor/wood/tile,
/area/station/command/heads_quarters/nt_rep)
"aL" = (
/obj/machinery/atmospherics/pipe/smart/manifold4w/scrubbers/hidden/layer2,
/obj/structure/disposalpipe/segment{
	dir = 4
	},
/turf/open/floor/wood/tile,
/area/station/command/heads_quarters/nt_rep)
"aN" = (
/obj/machinery/atmospherics/pipe/smart/manifold4w/supply/hidden/layer4,
/obj/machinery/atmospherics/pipe/smart/manifold4w/scrubbers/hidden/layer2,
/obj/structure/cable,
/obj/structure/disposalpipe/segment{
	dir = 10
	},
/turf/open/floor/iron/dark,
/area/station/hallway/primary/central)
"aO" = (
/obj/structure/cable,
/obj/machinery/atmospherics/pipe/smart/manifold/supply/hidden/layer4,
/obj/machinery/atmospherics/pipe/smart/manifold4w/scrubbers/hidden/layer2,
/obj/structure/disposalpipe/segment{
	dir = 4
	},
/obj/effect/turf_decal/siding/wood{
	dir = 8
	},
/turf/open/floor/wood/tile,
/area/station/command/heads_quarters/nt_rep)
"aQ" = (
/obj/structure/cable,
/obj/effect/turf_decal/siding/wood,
/turf/open/floor/wood/tile,
/area/station/command/heads_quarters/nt_rep)
"aR" = (
/obj/structure/disposalpipe/segment{
	dir = 4
	},
/turf/open/floor/wood/tile,
/area/station/command/heads_quarters/nt_rep)
"aS" = (
/obj/structure/disposalpipe/segment,
/turf/closed/wall/r_wall,
/area/station/command/heads_quarters/nt_rep)
"aV" = (
/obj/machinery/atmospherics/pipe/smart/manifold4w/scrubbers/hidden/layer2,
/obj/structure/disposalpipe/segment{
	dir = 4
	},
/obj/structure/table/wood,
/obj/item/folder/blue{
	pixel_y = -2;
	pixel_x = -2
	},
/obj/item/pen/fourcolor{
	pixel_y = -2;
	pixel_x = -5
	},
/obj/item/paper{
	pixel_x = 12;
	pixel_y = -2
	},
/obj/item/paper{
	pixel_x = 15
	},
/obj/item/storage/briefcase/central_command{
	pixel_y = 14;
	pixel_x = -2
	},
/turf/open/floor/wood/tile,
/area/station/command/heads_quarters/nt_rep)
"aW" = (
/obj/machinery/light/warm/dim/directional/west,
/obj/item/kirbyplants/random,
/turf/open/floor/wood/tile,
/area/station/command/heads_quarters/nt_rep)
"bC" = (
/obj/structure/bed/double,
/obj/item/bedsheet/centcom/double,
/turf/open/floor/carpet/green,
/area/station/command/heads_quarters/nt_rep)
"bI" = (
/obj/structure/chair/comfy/brown{
	color = "#66b266";
	dir = 4
	},
/turf/open/floor/carpet/green,
/area/station/command/heads_quarters/nt_rep)
"gQ" = (
/obj/structure/table/reinforced,
/obj/machinery/door/window/brigdoor/left/directional/west{
	name = "Nanotrasen Consultant's Desk";
	req_access = list("cent_general");
	unres_sides = 8
	},
/obj/machinery/door/window/right/directional/east{
	name = "Nanotrasen Consultant's Desk"
	},
/obj/machinery/door/poddoor/shutters/preopen{
	id = "nt_rep_priv";
	name = "Privacy Shutters"
	},
/obj/machinery/door/firedoor,
/turf/open/floor/iron/dark/textured_large,
/area/station/command/heads_quarters/nt_rep)
"kw" = (
/obj/structure/table/reinforced,
/obj/structure/sign/calendar/directional/west,
/obj/machinery/fax{
	fax_name = "Nanotrasen Consultant's Office";
	name = "Nanotrasen Consultant's Fax Machine"
	},
/turf/open/floor/carpet/green,
/area/station/command/heads_quarters/nt_rep)
"lG" = (
/obj/item/toy/crayon/white{
	pixel_y = -10;
	pixel_x = 10
	},
/turf/closed/wall/r_wall,
/area/station/command/heads_quarters/nt_rep)
"os" = (
/obj/structure/closet/secure_closet/personal/cabinet,
/obj/item/clothing/under/rank/centcom/officer,
/obj/item/clothing/under/rank/centcom/officer_skirt,
/obj/item/clothing/under/rank/centcom/intern,
/obj/item/clothing/under/rank/centcom/commander,
/obj/item/clothing/under/rank/centcom/centcom_skirt,
/obj/item/clothing/head/hats/centcom_cap,
/obj/item/clothing/suit/hooded/wintercoat/centcom/nt_consultant,
/obj/item/clothing/head/hats/centhat,
/obj/item/radio/headset/heads/nanotrasen_consultant/alt,
/obj/item/clothing/glasses/sunglasses,
/obj/item/clothing/suit/armor/centcom_formal/nt_consultant,
/obj/item/clothing/suit/armor/centcom_formal,
/obj/machinery/light/small/blacklight/directional/north,
/turf/open/floor/carpet/green,
/area/station/command/heads_quarters/nt_rep)
"uj" = (
/obj/machinery/modular_computer/preset/command,
/obj/machinery/requests_console/directional/north{
	name = "Nanotrasen Consultant's Requests Console";
	department = "Nanotrasen Consultant"
	},
/turf/open/floor/carpet/green,
/area/station/command/heads_quarters/nt_rep)
"zI" = (
/obj/machinery/vending/boozeomat/all_access,
/turf/closed/wall/r_wall,
/area/station/command/heads_quarters/nt_rep)
"Fk" = (
/obj/effect/landmark/start/nanotrasen_consultant,
/turf/open/floor/carpet/green,
/area/station/command/heads_quarters/nt_rep)
"KN" = (
/obj/structure/filingcabinet/medical{
	pixel_x = -10;
	icon_state = "employmentcabinet"
	},
/obj/structure/filingcabinet/security{
	pixel_x = 10;
	icon_state = "employmentcabinet"
	},
/obj/effect/turf_decal/siding/wood,
/obj/structure/filingcabinet/employment,
/turf/open/floor/carpet/green,
/area/station/command/heads_quarters/nt_rep)
"KT" = (
/obj/structure/dresser,
/obj/item/statuebust{
	pixel_y = 22
	},
/turf/open/floor/carpet/green,
/area/station/command/heads_quarters/nt_rep)
"Nh" = (
/obj/effect/landmark/start/nanotrasen_consultant,
/obj/effect/turf_decal/siding/wood,
/turf/open/floor/carpet/green,
/area/station/command/heads_quarters/nt_rep)
"ND" = (
/obj/machinery/door/airlock/corporate{
	name = "Nanotrasen Consultant's Quarters"
	},
/obj/machinery/door/firedoor,
/obj/effect/mapping_helpers/airlock/access/all/cent_com/rep_door,
/obj/effect/mapping_helpers/airlock/unres{
	dir = 1
	},
/obj/effect/turf_decal/siding/wood,
/turf/open/floor/carpet/green,
/area/station/command/heads_quarters/nt_rep)
"OJ" = (
/obj/structure/closet/secure_closet/nanotrasen_consultant,
/obj/item/clothing/accessory/medal/silver/bureaucracy,
/obj/item/clothing/accessory/medal/gold/nanotrasen_consultant,
/obj/item/clothing/accessory/medal/gold/ordom,
/turf/open/floor/carpet/green,
/area/station/command/heads_quarters/nt_rep)
"OY" = (
/obj/effect/turf_decal/bot_white,
/turf/open/floor/iron/dark,
/area/station/hallway/primary/central)
"Qk" = (
/obj/effect/spawner/structure/window/reinforced,
/obj/machinery/door/poddoor/shutters/preopen{
	id = "nt_rep_priv";
	name = "Privacy Shutters"
	},
/obj/structure/cable,
/turf/open/floor/plating,
/area/station/command/heads_quarters/nt_rep)
"TR" = (
/obj/structure/chair/office/tactical{
	dir = 4
	},
/obj/machinery/button/door/directional/east{
	pixel_y = 24;
	id = "nt_rep_priv";
	name = "Privacy Shutters Control"
	},
/turf/open/floor/carpet/green,
/area/station/command/heads_quarters/nt_rep)
"WE" = (
/obj/structure/table/reinforced,
/obj/item/stamp/centcom{
	pixel_x = -8;
	pixel_y = 8
	},
/obj/item/stamp/denied{
	pixel_x = -8;
	pixel_y = 4
	},
/obj/item/stamp{
	pixel_x = -8
	},
/obj/item/paper_bin{
	pixel_y = 4;
	pixel_x = 4
	},
/obj/item/pen/fountain{
	pixel_x = 4;
	pixel_y = 4
	},
/obj/machinery/light/warm/dim/directional/west,
/obj/structure/sign/flag/nanotrasen/directional/west,
/turf/open/floor/carpet/green,
/area/station/command/heads_quarters/nt_rep)
"WI" = (
/obj/machinery/vending/cigarette,
/obj/effect/turf_decal/bot_white,
/turf/open/floor/iron/dark,
/area/station/hallway/primary/central)
"Zr" = (
/obj/effect/turf_decal/delivery/white,
/turf/open/floor/iron/dark,
/area/station/hallway/primary/central)

(1,1,1) = {"
aa
aa
aa
aa
aa
aG
aa
aa
"}
(2,1,1) = {"
aa
OJ
bI
zI
aK
aR
aW
aa
"}
(3,1,1) = {"
aa
os
Fk
ND
ap
aL
as
aa
"}
(4,1,1) = {"
aa
KT
bC
aB
an
aV
ar
aa
"}
(5,1,1) = {"
aa
aa
aa
lG
aF
az
aj
aa
"}
(6,1,1) = {"
aa
kw
WE
KN
aQ
ak
ag
aa
"}
(7,1,1) = {"
aa
uj
TR
Nh
al
aO
am
aa
"}
(8,1,1) = {"
aa
aa
gQ
Qk
Qk
ax
aS
aS
"}
(9,1,1) = {"
aa
WI
Zr
OY
OY
aN
ab
aa
"}
