//MAP CONVERTED BY dmm2tgm.py THIS HEADER COMMENT PREVENTS RECONVERSION, DO NOT REMOVE
"bN" = (
/obj/structure/cable,
/obj/effect/turf_decal/siding/dark{
	dir = 1
	},
/obj/effect/mapping_helpers/turn_off_lights_with_lightswitch,
/obj/effect/landmark/start/nanotrasen_consultant,
/turf/open/floor/wood,
/area/station/command/heads_quarters/nt_rep)
"cs" = (
/obj/effect/turf_decal/trimline/dark_blue/filled/line,
/obj/machinery/atmospherics/pipe/smart/manifold4w/supply/hidden/layer4,
/obj/machinery/atmospherics/pipe/smart/manifold4w/scrubbers/hidden/layer2,
/obj/machinery/atmospherics/pipe/smart/manifold4w/supply/hidden/layer4,
/obj/effect/landmark/start/blueshield,
/obj/structure/cable,
/obj/machinery/power/apc/auto_name/directional/south,
/turf/open/floor/iron/dark/smooth_edge,
/area/station/command/heads_quarters/blueshield)
"cw" = (
/obj/effect/turf_decal/tile/dark_blue/diagonal_centre,
/obj/machinery/atmospherics/pipe/smart/manifold4w/scrubbers/hidden/layer2,
/obj/machinery/atmospherics/pipe/smart/manifold4w/supply/hidden/layer4,
/obj/effect/landmark/start/blueshield,
/turf/open/floor/iron/dark/diagonal,
/area/station/command/heads_quarters/blueshield)
"cR" = (
/obj/structure/table/wood,
/obj/machinery/fax{
	fax_name = "Nanotrasen Consultant's Office";
	name = "Nanotrasen Consultant's Fax Machine"
	},
/obj/effect/turf_decal/siding/dark{
	dir = 9
	},
/obj/structure/chalkboard{
	pixel_y = 32
	},
/obj/item/radio/intercom/directional/west,
/turf/open/floor/carpet/green,
/area/station/command/heads_quarters/nt_rep)
"dB" = (
/obj/machinery/atmospherics/pipe/smart/manifold4w/scrubbers/hidden/layer2,
/obj/structure/disposalpipe/segment{
	dir = 4
	},
/obj/machinery/atmospherics/pipe/smart/manifold4w/supply/hidden/layer4,
/obj/effect/turf_decal/siding/dark{
	dir = 4
	},
/turf/open/floor/wood,
/area/station/command/heads_quarters/nt_rep)
"dO" = (
/obj/structure/chair/greyscale{
	dir = 8
	},
/obj/effect/turf_decal/delivery/white,
/obj/effect/landmark/start/blueshield,
/turf/open/floor/iron/dark,
/area/station/hallway/primary/central)
"dS" = (
/obj/machinery/atmospherics/pipe/smart/manifold4w/scrubbers/hidden/layer2,
/obj/machinery/atmospherics/pipe/smart/manifold4w/supply/hidden/layer4,
/obj/structure/cable,
/obj/machinery/digital_clock/directional/south,
/obj/machinery/light_switch/directional/south{
	pixel_x = 6
	},
/turf/open/floor/iron,
/area/station/command/heads_quarters/blueshield)
"dW" = (
/obj/effect/landmark/start/nanotrasen_consultant,
/turf/open/floor/carpet/green,
/area/station/command/heads_quarters/nt_rep)
"ex" = (
/obj/machinery/modular_computer/preset/time_clock/directional/west,
/obj/structure/disposalpipe/trunk{
	dir = 1
	},
/obj/machinery/disposal/bin,
/obj/effect/turf_decal/bot_white,
/turf/open/floor/iron/dark,
/area/station/hallway/primary/central)
"eM" = (
/obj/machinery/photocopier/prebuilt,
/obj/effect/turf_decal/bot,
/obj/item/toy/plush/goatplushie{
	pixel_y = 11
	},
/turf/open/floor/carpet/green,
/area/station/command/heads_quarters/nt_rep)
"eN" = (
/obj/structure/closet/secure_closet/blueshield,
/obj/effect/turf_decal/delivery/red,
/obj/item/taperecorder{
	name = "Captain's Log"
	},
/obj/item/modular_computer/laptop/preset/security{
	pixel_y = 5
	},
/obj/item/clothing/gloves/tackler/combat/insulated/blueshield,
/obj/effect/turf_decal/siding/thinplating_new/dark,
/obj/structure/reagent_dispensers/wall/peppertank/directional/north,
/obj/machinery/atmospherics/components/unary/vent_scrubber/on/layer2,
/obj/item/sign/flag/nanotrasen,
/obj/machinery/light/small/blacklight/directional/north,
/turf/open/floor/iron/dark/small,
/area/station/command/heads_quarters/blueshield)
"fy" = (
/turf/open/floor/iron,
/area/station/hallway/primary/central)
"gq" = (
/obj/effect/turf_decal/tile/dark_blue/diagonal_centre,
/obj/machinery/atmospherics/pipe/smart/manifold4w/supply/hidden/layer4,
/obj/machinery/atmospherics/pipe/smart/manifold4w/scrubbers/hidden/layer2,
/obj/effect/landmark/start/blueshield,
/turf/open/floor/iron/dark/diagonal,
/area/station/command/heads_quarters/blueshield)
"gu" = (
/obj/machinery/computer/crew,
/obj/structure/sign/clock/directional/north,
/obj/effect/turf_decal/siding/dark{
	dir = 10
	},
/turf/open/floor/iron/dark/textured,
/area/station/command/heads_quarters/blueshield)
"gG" = (
/obj/machinery/atmospherics/pipe/smart/manifold4w/scrubbers/hidden/layer2,
/obj/machinery/atmospherics/pipe/smart/manifold4w/supply/hidden/layer4,
/obj/effect/landmark/start/blueshield,
/turf/open/floor/iron/dark/smooth_large,
/area/station/command/heads_quarters/blueshield)
"gP" = (
/obj/structure/cable,
/obj/machinery/atmospherics/pipe/smart/manifold4w/supply/hidden/layer4,
/obj/machinery/atmospherics/pipe/smart/manifold4w/scrubbers/hidden/layer2,
/turf/open/floor/iron,
/area/station/hallway/primary/central)
"hl" = (
/obj/machinery/camera/directional/north{
	c_tag = "Blueshield's Office - Quarters"
	},
/obj/effect/turf_decal/trimline/dark_blue/filled/line{
	dir = 1
	},
/obj/effect/turf_decal/bot,
/obj/machinery/modular_computer/preset/command,
/obj/effect/mapping_helpers/requests_console/information,
/obj/effect/mapping_helpers/requests_console/supplies,
/obj/effect/mapping_helpers/requests_console/assistance,
/obj/effect/mapping_helpers/requests_console/announcement,
/obj/machinery/requests_console/auto_name/directional/north,
/turf/open/floor/iron/dark/smooth_edge{
	dir = 1
	},
/area/station/command/heads_quarters/blueshield)
"hn" = (
/obj/machinery/coffeemaker/impressa{
	pixel_x = 2;
	pixel_y = 6
	},
/obj/item/storage/box/coffeepack,
/obj/structure/table/wood,
/obj/effect/turf_decal/tile/neutral/opposingcorners,
/turf/open/floor/iron/dark,
/area/station/command/heads_quarters/nt_rep)
"ia" = (
/obj/effect/mapping_helpers/airlock/access/all/cent_com/rep_door,
/obj/effect/turf_decal/siding/dark,
/obj/effect/mapping_helpers/airlock/unres/delayed{
	dir = 1
	},
/obj/effect/turf_decal/siding/dark,
/obj/effect/turf_decal/siding/dark{
	dir = 1
	},
/obj/machinery/door/airlock/corporate{
	name = "Consultant's Quarters"
	},
/turf/open/floor/carpet/royalblack,
/area/station/command/heads_quarters/nt_rep)
"ij" = (
/obj/structure/sign/calendar/directional/south,
/turf/open/floor/wood,
/area/station/command/heads_quarters/nt_rep)
"iK" = (
/obj/structure/extinguisher_cabinet/directional/west,
/obj/machinery/light/directional/west,
/turf/open/floor/iron,
/area/station/hallway/primary/central)
"jm" = (
/obj/machinery/atmospherics/pipe/smart/manifold4w/scrubbers/hidden/layer2,
/obj/structure/disposalpipe/segment{
	dir = 4
	},
/obj/structure/table/wood/fancy/green,
/obj/effect/spawner/random/entertainment/cigarette_pack,
/turf/open/floor/wood,
/area/station/command/heads_quarters/nt_rep)
"kd" = (
/obj/structure/chair/office{
	dir = 8
	},
/obj/effect/landmark/start/nanotrasen_consultant,
/obj/machinery/holopad,
/turf/open/floor/iron,
/area/station/command/heads_quarters/blueshield)
"li" = (
/obj/structure/table/reinforced,
/obj/machinery/door/window/brigdoor/left/directional/west{
	name = "Consultant's Desk";
	req_access = list("cent_general");
	unres_sides = 8
	},
/obj/machinery/door/poddoor/shutters/preopen{
	id = "nt_rep_priv"
	},
/obj/machinery/door/window/left/directional/east{
	name = "Reception Window"
	},
/obj/item/phone{
	desc = "Supposedly a direct line to Nanotrasen Central Command. It's not even plugged in.";
	pixel_x = 3;
	pixel_y = 3
	},
/turf/open/floor/plating,
/area/station/command/heads_quarters/nt_rep)
"lB" = (
/obj/effect/turf_decal/bot_white,
/turf/open/floor/iron/dark,
/area/station/hallway/primary/central)
"ne" = (
/obj/structure/cable,
/obj/machinery/atmospherics/components/unary/vent_pump/on/layer4,
/obj/effect/turf_decal/siding/dark{
	dir = 5
	},
/turf/open/floor/wood,
/area/station/command/heads_quarters/nt_rep)
"nj" = (
/obj/machinery/door/airlock/highsecurity{
	name = "Blueshield's Armory"
	},
/obj/effect/mapping_helpers/airlock/access/all/command/captain,
/obj/machinery/atmospherics/pipe/smart/manifold4w/scrubbers/hidden/layer2,
/obj/machinery/atmospherics/pipe/smart/manifold4w/supply/hidden/layer4,
/turf/open/floor/iron/dark/diagonal,
/area/station/command/heads_quarters/blueshield)
"pk" = (
/obj/machinery/atmospherics/pipe/smart/manifold4w/scrubbers/hidden/layer2,
/obj/structure/disposalpipe/segment{
	dir = 4
	},
/obj/structure/table/wood/fancy/green,
/obj/item/flashlight/lamp{
	pixel_y = 9
	},
/obj/item/lighter/royal,
/turf/open/floor/wood,
/area/station/command/heads_quarters/nt_rep)
"pt" = (
/obj/effect/landmark/start/blueshield,
/obj/effect/mapping_helpers/turn_off_lights_with_lightswitch,
/obj/structure/chair/office{
	dir = 4
	},
/obj/machinery/atmospherics/components/unary/vent_scrubber/on/layer2,
/turf/open/floor/iron/dark/smooth_large,
/area/station/command/heads_quarters/blueshield)
"pP" = (
/obj/structure/table/wood,
/obj/item/paper_bin{
	pixel_y = 4;
	pixel_x = -5
	},
/obj/item/pen/fourcolor{
	pixel_x = -5;
	pixel_y = 5
	},
/obj/machinery/recharger{
	pixel_x = 7;
	pixel_y = 6
	},
/obj/effect/turf_decal/trimline/dark_blue/filled/line{
	dir = 4
	},
/obj/machinery/atmospherics/components/unary/vent_scrubber/on/layer2,
/turf/open/floor/iron/dark/smooth_large,
/area/station/command/heads_quarters/blueshield)
"rp" = (
/obj/machinery/modular_computer/preset/command,
/obj/machinery/light_switch/directional/east,
/obj/machinery/button/door/directional/east{
	pixel_y = 10;
	id = "nt_rep_priv"
	},
/obj/machinery/requests_console/auto_name/directional/north,
/obj/effect/mapping_helpers/requests_console/assistance,
/obj/effect/mapping_helpers/requests_console/supplies,
/obj/effect/mapping_helpers/requests_console/information,
/obj/effect/mapping_helpers/requests_console/announcement,
/obj/machinery/button/curtain{
	id = "nt_rep_priv";
	name = "curtain control";
	pixel_x = 35;
	pixel_y = 10;
	req_access = list("theatre");
	dir = 4
	},
/obj/effect/turf_decal/bot,
/turf/open/floor/carpet/green,
/area/station/command/heads_quarters/nt_rep)
"rt" = (
/obj/machinery/holopad,
/obj/effect/landmark/start/nanotrasen_consultant,
/turf/open/floor/carpet/green,
/area/station/command/heads_quarters/nt_rep)
"rQ" = (
/obj/effect/turf_decal/trimline/dark_blue/filled/line{
	dir = 6
	},
/obj/machinery/atmospherics/pipe/smart/manifold4w/supply/hidden/layer4,
/obj/machinery/atmospherics/pipe/smart/manifold4w/scrubbers/hidden/layer2,
/obj/structure/cable,
/obj/machinery/light/directional/south,
/turf/open/floor/iron/dark/smooth_corner{
	dir = 1
	},
/area/station/command/heads_quarters/blueshield)
"sc" = (
/obj/structure/flora/bush/sparsegrass/style_random,
/obj/structure/flora/bush/flowers_br/style_random,
/obj/structure/window/reinforced/fulltile,
/obj/structure/curtain/cloth/fancy/mechanical{
	icon_state = "bounty-open";
	icon_type = "bounty";
	id = "nt_rep_priv";
	name = "curtain"
	},
/turf/open/misc/snow/actually_safe,
/area/station/command/heads_quarters/nt_rep)
"sP" = (
/obj/effect/turf_decal/siding/dark{
	dir = 1
	},
/obj/machinery/camera/directional/west{
	c_tag = "Consultant's Office";
	name = "command camera";
	dir = 1
	},
/obj/machinery/computer/station_goal,
/obj/effect/turf_decal/bot,
/turf/open/floor/carpet/green,
/area/station/command/heads_quarters/nt_rep)
"un" = (
/obj/machinery/camera/directional/west{
	c_tag = "Consultant's Office";
	name = "command camera";
	dir = 5
	},
/obj/effect/landmark/start/blueshield,
/obj/structure/sign/flag/nanotrasen/directional/south,
/obj/structure/chair/plastic{
	dir = 1
	},
/turf/open/floor/wood,
/area/station/command/heads_quarters/nt_rep)
"uw" = (
/turf/closed/wall/r_wall,
/area/station/command/heads_quarters/nt_rep)
"uK" = (
/turf/open/floor/iron,
/area/station/command/heads_quarters/blueshield)
"vs" = (
/obj/structure/sign/nanotrasen/directional/west,
/turf/open/floor/iron,
/area/station/hallway/primary/central)
"vE" = (
/obj/item/toy/crayon/white{
	pixel_x = 10;
	pixel_y = -8
	},
/turf/closed/wall/r_wall,
/area/station/command/heads_quarters/nt_rep)
"wm" = (
/obj/structure/disposalpipe/segment{
	dir = 4
	},
/turf/open/floor/wood,
/area/station/command/heads_quarters/nt_rep)
"wt" = (
/obj/machinery/navbeacon{
	codes_txt = "patrol;next_patrol=QM";
	location = "CHW"
	},
/obj/structure/cable,
/obj/machinery/atmospherics/pipe/smart/manifold4w/scrubbers/hidden/layer2,
/obj/machinery/atmospherics/pipe/smart/manifold4w/supply/hidden/layer4,
/turf/open/floor/iron,
/area/station/hallway/primary/central)
"wy" = (
/turf/open/floor/iron,
/area/station/hallway/primary/port)
"ye" = (
/obj/structure/table/wood,
/obj/machinery/fax{
	name = "Blueshield's Fax Machine";
	fax_name = "Blueshield's Office"
	},
/obj/machinery/light/directional/north,
/obj/item/radio/intercom/directional/north,
/obj/effect/turf_decal/trimline/dark_blue/filled/line{
	dir = 5
	},
/turf/open/floor/iron/dark/smooth_corner{
	dir = 8
	},
/area/station/command/heads_quarters/blueshield)
"yO" = (
/obj/structure/cable,
/obj/machinery/atmospherics/pipe/smart/manifold4w/scrubbers/hidden/layer2,
/obj/machinery/door/firedoor,
/obj/structure/disposalpipe/junction/flip{
	dir = 8
	},
/obj/effect/landmark/navigate_destination/autoname,
/obj/effect/mapping_helpers/airlock/unres/delayed{
	dir = 8
	},
/obj/effect/mapping_helpers/airlock/access/any/cent_com/rep_or_captain,
/obj/machinery/atmospherics/pipe/smart/manifold4w/supply/hidden/layer4,
/obj/effect/turf_decal/siding/dark{
	dir = 8
	},
/obj/machinery/door/airlock/corporate{
	id_tag = "consultantdoor";
	name = "Consultant's Office"
	},
/turf/open/floor/iron/dark,
/area/station/command/heads_quarters/nt_rep)
"zc" = (
/turf/template_noop,
/area/template_noop)
"zO" = (
/obj/structure/bed/double{
	dir = 1
	},
/obj/item/bedsheet/centcom/double{
	dir = 1
	},
/obj/structure/sign/poster/official/no_erp/directional/west,
/obj/machinery/light/small/directional/west,
/turf/open/floor/carpet/royalblack,
/area/station/command/heads_quarters/nt_rep)
"zW" = (
/obj/structure/cable,
/obj/effect/landmark/start/hangover,
/obj/machinery/atmospherics/pipe/smart/manifold4w/scrubbers/hidden/layer2,
/obj/machinery/atmospherics/pipe/smart/manifold4w/supply/hidden/layer4,
/turf/open/floor/iron,
/area/station/hallway/primary/central)
"BK" = (
/obj/machinery/light/warm/dim/directional/south,
/obj/structure/extinguisher_cabinet/directional/south,
/obj/effect/turf_decal/siding/dark{
	dir = 4
	},
/turf/open/floor/wood,
/area/station/command/heads_quarters/nt_rep)
"Cj" = (
/obj/structure/safe/abovetilefloor,
/obj/item/storage/fancy/cigarettes/cigars,
/obj/item/storage/fancy/donut_box,
/obj/item/reagent_containers/cup/glass/bottle/navy_rum,
/obj/item/holocigarette/masvedishcigar,
/obj/item/paperwork/captain{
	pixel_x = -3;
	pixel_y = 4;
	name = "Asset Protection case records";
	desc = "A messily compiled stack of DAP records, containing incident reports, asset recovery briefings and classified paramilitary activities, with substantial portions censored and redacted. You probably shouldn't be reading this, unless you yearn for a one-way trip to Space Guantanamo."
	},
/obj/effect/turf_decal/tile/dark_blue/diagonal_centre,
/obj/item/toy/plush/lizard_plushie/greyscale{
	name = "Hunts-the-Traitor";
	desc = "The Blueshield's best friend, a little too eager to go after criminals and evil-doers alike. He's grounded forever.";
	greyscale_colors = "#FF0000#000000"
	},
/obj/machinery/status_display/ai/directional/west,
/obj/machinery/atmospherics/pipe/smart/manifold4w/supply/hidden/layer4,
/obj/effect/landmark/start/blueshield,
/obj/machinery/camera/directional/west{
	c_tag = "Blueshield's Armory"
	},
/turf/open/floor/iron/dark/diagonal,
/area/station/command/heads_quarters/blueshield)
"CV" = (
/obj/structure/cable,
/obj/machinery/atmospherics/pipe/smart/manifold4w/scrubbers/hidden/layer2,
/obj/machinery/atmospherics/pipe/smart/manifold4w/supply/hidden/layer4,
/turf/open/floor/iron,
/area/station/hallway/primary/central)
"DQ" = (
/obj/machinery/atmospherics/pipe/smart/manifold4w/supply/hidden/layer4,
/obj/machinery/atmospherics/pipe/smart/manifold4w/scrubbers/hidden/layer2,
/obj/structure/cable,
/obj/structure/disposalpipe/segment{
	dir = 10
	},
/turf/open/floor/iron/dark,
/area/station/hallway/primary/central)
"Er" = (
/obj/effect/turf_decal/delivery/red,
/obj/effect/turf_decal/siding/thinplating_new/dark,
/obj/machinery/newscaster/directional/north,
/obj/structure/table/wood/fancy/blue,
/obj/machinery/computer/security/wooden_tv{
	pixel_y = 10
	},
/obj/item/book/manual/wiki/security_space_law{
	pixel_y = 3;
	pixel_x = 7
	},
/obj/machinery/light_switch/directional/east,
/turf/open/floor/iron/dark/small,
/area/station/command/heads_quarters/blueshield)
"Fk" = (
/obj/structure/flora/grass/green/style_random,
/obj/structure/flora/bush/flowers_br/style_random,
/obj/structure/window/reinforced/fulltile,
/obj/structure/curtain/cloth/fancy/mechanical{
	icon_state = "bounty-open";
	icon_type = "bounty";
	id = "nt_rep_priv";
	name = "curtain"
	},
/turf/open/misc/snow/actually_safe,
/area/station/command/heads_quarters/nt_rep)
"FK" = (
/obj/effect/turf_decal/trimline/dark_blue/filled/line,
/obj/machinery/atmospherics/pipe/smart/manifold4w/scrubbers/hidden/layer2,
/obj/machinery/atmospherics/pipe/smart/manifold4w/supply/hidden/layer4,
/obj/structure/sign/poster/official/corporate_perks_vacation/directional/south,
/obj/effect/landmark/start/blueshield,
/turf/open/floor/iron/dark/smooth_edge,
/area/station/command/heads_quarters/blueshield)
"FN" = (
/obj/effect/landmark/event_spawn,
/obj/structure/cable,
/obj/machinery/atmospherics/pipe/smart/manifold4w/scrubbers/hidden/layer2,
/obj/machinery/atmospherics/pipe/smart/manifold4w/supply/hidden/layer4,
/turf/open/floor/iron,
/area/station/hallway/primary/central)
"Ge" = (
/obj/effect/turf_decal/delivery/red,
/obj/effect/turf_decal/siding/thinplating_new/dark{
	dir = 1
	},
/obj/structure/sign/flag/terragov/directional/south,
/obj/machinery/suit_storage_unit/security,
/turf/open/floor/iron/dark/small,
/area/station/command/heads_quarters/blueshield)
"Gf" = (
/obj/machinery/vending/boozeomat,
/turf/closed/wall/r_wall,
/area/station/command/heads_quarters/nt_rep)
"Gv" = (
/obj/structure/safe/abovetilefloor,
/obj/item/folder/ancient_paperwork,
/obj/item/lustwish_discount{
	name = "Consultant's LustWish elite card"
	},
/obj/item/reagent_containers/cup/glass/flask{
	pixel_y = -2;
	pixel_x = 2
	},
/obj/item/storage/toolbox/guncase/skyrat/pistol/sec_glock,
/obj/item/reagent_containers/cup/glass/bottle/hcider,
/obj/item/storage/fancy/cigarettes/cigars/cohiba,
/obj/item/storage/box/matches,
/obj/item/folder/documents,
/obj/item/paperwork{
	desc = "A densely compiled stack of Internal Affairs records, documenting various investigations, audits and disciplinary proceedings, extensively redacted under CENTCOM authority.";
	name = "internal affairs records"
	},
/obj/effect/landmark/start/nanotrasen_consultant,
/turf/open/floor/carpet/royalblack,
/area/station/command/heads_quarters/nt_rep)
"Gz" = (
/obj/machinery/door/airlock/corporate{
	name = "Blueshield's Office"
	},
/obj/effect/landmark/navigate_destination/autoname,
/obj/effect/mapping_helpers/airlock/access/any/cent_com/rep_or_captain,
/obj/machinery/atmospherics/pipe/smart/manifold4w/scrubbers/hidden/layer2,
/obj/machinery/atmospherics/pipe/smart/manifold4w/supply/hidden/layer4,
/obj/structure/cable,
/obj/machinery/door/firedoor,
/turf/open/floor/iron/dark,
/area/station/command/heads_quarters/blueshield)
"GF" = (
/obj/machinery/airalarm/directional/north,
/obj/machinery/computer/records/security,
/obj/effect/turf_decal/siding/dark{
	dir = 6
	},
/turf/open/floor/iron/dark/textured,
/area/station/command/heads_quarters/blueshield)
"GK" = (
/obj/effect/turf_decal/delivery/red,
/obj/effect/turf_decal/siding/thinplating_new/dark{
	dir = 1
	},
/obj/structure/sign/plaques/kiddie/perfect_man{
	pixel_x = -32
	},
/obj/structure/sign/flag/nanotrasen/directional/south,
/obj/machinery/ammo_workbench,
/turf/open/floor/iron/dark/small,
/area/station/command/heads_quarters/blueshield)
"IN" = (
/obj/machinery/computer/records/medical,
/obj/machinery/firealarm/directional/north,
/obj/effect/turf_decal/siding/dark,
/turf/open/floor/iron/dark/textured,
/area/station/command/heads_quarters/blueshield)
"IY" = (
/obj/machinery/vending/cigarette,
/obj/effect/turf_decal/bot_white,
/turf/open/floor/iron/dark,
/area/station/hallway/primary/central)
"Jx" = (
/obj/structure/cable,
/obj/machinery/atmospherics/pipe/smart/manifold4w/supply/hidden/layer4,
/obj/machinery/atmospherics/pipe/smart/manifold4w/scrubbers/hidden/layer2,
/obj/machinery/atmospherics/pipe/smart/manifold4w/supply/hidden/layer4,
/turf/open/floor/iron,
/area/station/hallway/primary/central)
"Kc" = (
/obj/structure/table/wood,
/obj/item/paper_bin{
	pixel_y = 4;
	pixel_x = -5
	},
/obj/item/stamp/granted{
	pixel_y = 12;
	pixel_x = 8
	},
/obj/item/stamp/denied{
	pixel_x = 8;
	pixel_y = 6
	},
/obj/item/stamp/centcom{
	pixel_x = 8
	},
/obj/item/pen/fourcolor{
	pixel_x = -5;
	pixel_y = 5
	},
/obj/effect/turf_decal/siding/dark{
	dir = 8
	},
/obj/machinery/firealarm/directional/west,
/obj/item/pen/fountain{
	pixel_x = -5;
	pixel_y = 5
	},
/obj/machinery/light/warm/dim/directional/west,
/turf/open/floor/carpet/green,
/area/station/command/heads_quarters/nt_rep)
"LD" = (
/obj/structure/cable,
/obj/effect/turf_decal/siding/dark{
	dir = 1
	},
/obj/effect/landmark/start/nanotrasen_consultant,
/turf/open/floor/wood,
/area/station/command/heads_quarters/nt_rep)
"LE" = (
/obj/machinery/atmospherics/components/unary/vent_pump/on/layer4{
	dir = 4
	},
/turf/open/floor/iron,
/area/station/hallway/primary/central)
"LO" = (
/obj/structure/chair/office/tactical{
	dir = 4
	},
/obj/effect/landmark/start/nanotrasen_consultant,
/turf/open/floor/carpet/green,
/area/station/command/heads_quarters/nt_rep)
"LX" = (
/obj/machinery/atmospherics/components/unary/vent_pump/on/layer4,
/turf/open/floor/iron,
/area/station/command/heads_quarters/blueshield)
"Nv" = (
/turf/closed/wall/r_wall,
/area/station/command/heads_quarters/blueshield)
"NK" = (
/obj/machinery/airalarm/directional/west,
/obj/machinery/light/warm/dim/directional/west,
/turf/open/floor/wood,
/area/station/command/heads_quarters/nt_rep)
"NL" = (
/obj/structure/dresser,
/obj/structure/secure_safe/directional/north,
/obj/item/sign/flag/nanotrasen{
	pixel_y = 11
	},
/turf/open/floor/carpet/royalblack,
/area/station/command/heads_quarters/nt_rep)
"Of" = (
/obj/structure/filingcabinet/medical{
	pixel_x = -10
	},
/obj/structure/filingcabinet/employment,
/obj/structure/filingcabinet/security{
	pixel_x = 10
	},
/obj/effect/turf_decal/siding/dark{
	dir = 10
	},
/turf/open/floor/carpet/green,
/area/station/command/heads_quarters/nt_rep)
"Qd" = (
/obj/structure/rack/shelf,
/obj/effect/turf_decal/delivery/red,
/obj/effect/turf_decal/siding/thinplating_new/dark{
	dir = 1
	},
/obj/structure/sign/poster/official/obey/directional/south,
/obj/machinery/light/small/blacklight/directional/south,
/obj/item/storage/medkit/fire,
/obj/item/storage/medkit/tactical/blueshield,
/turf/open/floor/iron/dark/small,
/area/station/command/heads_quarters/blueshield)
"Qh" = (
/obj/machinery/atmospherics/pipe/smart/manifold4w/scrubbers/hidden/layer2,
/obj/structure/cable,
/obj/machinery/newscaster/directional/south,
/obj/machinery/atmospherics/pipe/smart/manifold4w/supply/hidden/layer4,
/obj/machinery/atmospherics/pipe/smart/manifold4w/scrubbers/hidden/layer2,
/turf/open/floor/iron,
/area/station/command/heads_quarters/blueshield)
"Qi" = (
/obj/machinery/power/apc/auto_name/directional/west,
/obj/structure/cable,
/obj/effect/turf_decal/siding/dark{
	dir = 1
	},
/turf/open/floor/wood,
/area/station/command/heads_quarters/nt_rep)
"Qk" = (
/obj/effect/landmark/start/hangover,
/turf/open/floor/iron,
/area/station/hallway/primary/central)
"QT" = (
/obj/effect/spawner/structure/window/reinforced,
/obj/machinery/door/poddoor/shutters/preopen{
	id = "blueshield_priv"
	},
/obj/structure/cable,
/turf/open/floor/plating,
/area/station/command/heads_quarters/blueshield)
"Rb" = (
/obj/structure/disposalpipe/segment,
/turf/closed/wall/r_wall,
/area/station/command/heads_quarters/nt_rep)
"Rr" = (
/obj/machinery/atmospherics/pipe/smart/manifold4w/scrubbers/hidden/layer2,
/obj/structure/cable,
/obj/machinery/atmospherics/pipe/smart/manifold4w/supply/hidden/layer4,
/obj/machinery/light_switch/directional/south,
/turf/open/floor/iron,
/area/station/command/heads_quarters/blueshield)
"RP" = (
/obj/structure/cable,
/obj/machinery/atmospherics/pipe/smart/manifold4w/scrubbers/hidden/layer2,
/obj/structure/disposalpipe/segment{
	dir = 4
	},
/obj/machinery/atmospherics/pipe/smart/manifold4w/supply/hidden/layer4,
/obj/effect/turf_decal/tile/neutral/opposingcorners,
/turf/open/floor/iron/dark,
/area/station/command/heads_quarters/nt_rep)
"RZ" = (
/obj/structure/cable,
/obj/item/kirbyplants/random,
/obj/effect/turf_decal/tile/neutral/opposingcorners,
/turf/open/floor/iron/dark,
/area/station/command/heads_quarters/nt_rep)
"Tf" = (
/obj/structure/cable,
/obj/structure/fireplace,
/obj/effect/turf_decal/siding/dark{
	dir = 1
	},
/obj/structure/chair/comfy/brown{
	color = "#439C1E";
	dir = 2
	},
/obj/effect/landmark/start/nanotrasen_consultant,
/turf/open/floor/wood,
/area/station/command/heads_quarters/nt_rep)
"Ts" = (
/turf/open/floor/iron/dark,
/area/station/hallway/primary/central)
"UA" = (
/obj/machinery/atmospherics/pipe/smart/manifold4w/scrubbers/hidden/layer2,
/obj/structure/disposalpipe/segment{
	dir = 4
	},
/obj/effect/turf_decal/siding/dark/corner,
/obj/structure/table/wood/fancy/green,
/obj/item/clipboard{
	pixel_x = -4;
	pixel_y = 3
	},
/obj/item/reagent_containers/cup/glass/mug/nanotrasen,
/turf/open/floor/wood,
/area/station/command/heads_quarters/nt_rep)
"UD" = (
/obj/structure/closet/secure_closet/tac{
	req_access = list("captain")
	},
/obj/item/shield/riot,
/obj/item/gun_maintenance_supplies,
/obj/item/screwdriver,
/obj/effect/turf_decal/delivery/red,
/obj/item/clothing/head/helmet/toggleable/riot{
	pixel_y = 6
	},
/obj/item/clothing/suit/armor/riot,
/obj/item/storage/toolbox/ammobox/wt550m9,
/obj/effect/turf_decal/siding/thinplating_new/dark,
/obj/structure/plaque/static_plaque/golden{
	pixel_x = -32
	},
/obj/machinery/vending/wallmed/directional/north,
/obj/machinery/atmospherics/components/unary/vent_pump/on/layer4,
/turf/open/floor/iron/dark/small,
/area/station/command/heads_quarters/blueshield)
"VM" = (
/obj/effect/turf_decal/trimline/dark_blue/filled/line{
	dir = 1
	},
/obj/machinery/photocopier/prebuilt,
/obj/effect/turf_decal/bot,
/obj/machinery/button/door/directional/west{
	pixel_x = 5;
	pixel_y = 25;
	id = "blueshield_priv"
	},
/obj/machinery/light_switch/directional/north{
	pixel_x = -5;
	pixel_y = 25
	},
/obj/item/toy/plush/skyrat/fox/mia{
	desc = "A cute, marketable version of one of the DAP's mascots, Vigilant the fox. She has a blue collar with a shield-shaped tag that reads DAP. Holding her makes you feel protected.";
	name = "Vigilant plushie";
	pixel_y = 6
	},
/obj/machinery/camera/directional/west{
	c_tag = "Blueshield's Office"
	},
/turf/open/floor/iron/dark/smooth_edge{
	dir = 1
	},
/area/station/command/heads_quarters/blueshield)
"Xg" = (
/obj/machinery/atmospherics/components/unary/vent_scrubber/on/layer2{
	dir = 1
	},
/obj/structure/noticeboard/directional/south,
/turf/open/floor/wood,
/area/station/command/heads_quarters/nt_rep)
"XD" = (
/obj/effect/mapping_helpers/airlock/access/all/cent_com/rep_door,
/obj/machinery/door/airlock/maintenance,
/obj/structure/disposalpipe/segment{
	dir = 4
	},
/obj/effect/mapping_helpers/airlock/unres/delayed{
	dir = 4
	},
/obj/machinery/door/poddoor/shutters/preopen{
	id = "nt_rep_priv"
	},
/turf/open/floor/iron/dark/textured_large,
/area/station/command/heads_quarters/nt_rep)
"Yq" = (
/obj/structure/closet/secure_closet/nanotrasen_consultant,
/obj/item/clothing/accessory/medal/gold/ordom,
/obj/item/clothing/accessory/medal/silver/bureaucracy,
/obj/item/hand_labeler,
/obj/machinery/newscaster/directional/north,
/obj/item/stack/sheet/mineral/wood/fifty,
/obj/item/clothing/accessory/pocketprotector,
/turf/open/floor/carpet/royalblack,
/area/station/command/heads_quarters/nt_rep)
"ZQ" = (
/obj/machinery/atmospherics/pipe/smart/manifold4w/scrubbers/hidden/layer2,
/obj/machinery/atmospherics/pipe/smart/manifold4w/supply/hidden/layer4,
/obj/structure/cable,
/turf/open/floor/iron,
/area/station/hallway/primary/central)

(1,1,1) = {"
zc
Nv
Nv
Nv
Nv
uw
zc
zc
zc
zc
zc
zc
zc
"}
(2,1,1) = {"
zc
Nv
UD
Cj
GK
uw
zc
zc
zc
zc
zc
zc
zc
"}
(3,1,1) = {"
wy
Nv
eN
gq
Qd
uw
zc
zc
zc
zc
zc
zc
zc
"}
(4,1,1) = {"
zc
Nv
Er
cw
Ge
uw
uw
uw
uw
uw
XD
uw
uw
"}
(5,1,1) = {"
zc
Nv
Nv
nj
Nv
uw
Yq
zO
Gf
Qi
wm
NK
uw
"}
(6,1,1) = {"
zc
Nv
VM
gG
FK
uw
NL
Gv
ia
LD
pk
Xg
uw
"}
(7,1,1) = {"
zc
Nv
hl
pt
cs
uw
uw
uw
uw
Tf
jm
un
uw
"}
(8,1,1) = {"
zc
Nv
ye
pP
rQ
uw
cR
Kc
Of
bN
UA
ij
uw
"}
(9,1,1) = {"
zc
Nv
gu
kd
Qh
vE
sP
rt
dW
ne
dB
BK
uw
"}
(10,1,1) = {"
wy
Nv
IN
LX
Rr
uw
rp
LO
eM
RZ
RP
hn
uw
"}
(11,1,1) = {"
zc
Nv
GF
uK
dS
uw
uw
li
sc
Fk
yO
Rb
Rb
"}
(12,1,1) = {"
zc
Nv
QT
QT
Gz
uw
IY
dO
lB
Ts
DQ
ex
uw
"}
(13,1,1) = {"
zc
vs
fy
fy
ZQ
iK
fy
LE
fy
Qk
CV
fy
fy
"}
(14,1,1) = {"
wt
CV
CV
CV
CV
zW
CV
CV
Jx
gP
gP
FN
CV
"}
