//MAP CONVERTED BY dmm2tgm.py THIS HEADER COMMENT PREVENTS RECONVERSION, DO NOT REMOVE
"a" = (
/obj/machinery/light/small/directional/south,
/turf/open/floor/iron/dark/textured,
/area/station/security/armory)
"b" = (
/obj/machinery/camera/directional/north{
	c_tag = "Armory - Internal - Lower"
	},
/obj/structure/rack,
/obj/effect/turf_decal/tile/red/half/contrasted,
/obj/machinery/light/small/directional/north,
/obj/item/storage/toolbox/drone,
/turf/open/floor/iron/dark/textured,
/area/station/security/armory)
"f" = (
/obj/machinery/atmospherics/components/unary/vent_pump/on/layer4{
	dir = 8
	},
/turf/open/floor/iron/dark/textured,
/area/station/security/armory)
"h" = (
/turf/open/floor/iron/dark/textured,
/area/station/security/armory)
"l" = (
/obj/effect/turf_decal/tile/red/half/contrasted,
/obj/structure/closet/secure_closet/armory_kiboko,
/turf/open/floor/iron/dark/textured,
/area/station/security/armory)
"p" = (
/obj/machinery/atmospherics/components/unary/vent_scrubber/on/layer2,
/obj/machinery/power/apc/auto_name/directional/west,
/obj/structure/cable,
/turf/open/floor/iron/dark/textured,
/area/station/security/armory)
"t" = (
/obj/structure/rack,
/obj/item/gun/energy/ionrifle,
/obj/item/gun/energy/temperature/security,
/obj/item/clothing/suit/hooded/ablative,
/obj/effect/turf_decal/tile/red/half/contrasted{
	dir = 8
	},
/turf/open/floor/iron/dark/textured,
/area/station/security/armory)
"u" = (
/obj/structure/stairs/east,
/turf/open/floor/iron/dark/textured,
/area/station/security/armory)
"v" = (
/obj/machinery/door/window/brigdoor/left/directional/north{
	name = "Secure Weapons Storage";
	req_access = list("armory")
	},
/turf/open/floor/iron/dark/textured,
/area/station/security/armory)
"w" = (
/obj/machinery/atmospherics/pipe/smart/manifold4w/supply/hidden/layer4,
/turf/open/floor/iron/dark/textured,
/area/station/security/armory)
"A" = (
/obj/structure/rack,
/obj/structure/window/reinforced/spawner/directional/north,
/obj/effect/turf_decal/tile/red/half/contrasted{
	dir = 8
	},
/obj/effect/spawner/random/armory/rubbershot,
/turf/open/floor/iron/dark/textured,
/area/station/security/armory)
"B" = (
/mob/living/simple_animal/bot/secbot/beepsky/armsky,
/turf/open/floor/iron/dark/textured,
/area/station/security/armory)
"C" = (
/obj/structure/rack,
/obj/effect/turf_decal/tile/red/half/contrasted,
/obj/effect/spawner/random/armory/bulletproof_armor,
/obj/effect/spawner/random/armory/bulletproof_helmet,
/turf/open/floor/iron/dark/textured,
/area/station/security/armory)
"D" = (
/turf/closed/wall,
/area/station/security/armory)
"F" = (
/obj/structure/rack,
/obj/effect/turf_decal/tile/red/half/contrasted,
/obj/effect/spawner/random/armory/disablers,
/turf/open/floor/iron/dark/textured,
/area/station/security/armory)
"I" = (
/obj/structure/rack,
/obj/machinery/light/small/directional/north,
/obj/effect/turf_decal/tile/red/half/contrasted,
/obj/effect/spawner/random/armory/riot_armor,
/obj/effect/spawner/random/armory/riot_helmet,
/obj/effect/spawner/random/armory/riot_shield,
/turf/open/floor/iron/dark/textured,
/area/station/security/armory)
"J" = (
/obj/structure/rack,
/obj/structure/window/reinforced/spawner/directional/north,
/obj/effect/turf_decal/tile/red/anticorner/contrasted{
	dir = 4
	},
/obj/effect/spawner/armory_spawn/shotguns,
/turf/open/floor/iron/dark/textured,
/area/station/security/armory)
"N" = (
/obj/machinery/recharge_station,
/obj/effect/turf_decal/tile/red/anticorner/contrasted{
	dir = 1
	},
/turf/open/floor/iron/dark/textured,
/area/station/security/armory)
"P" = (
/obj/machinery/atmospherics/pipe/smart/manifold4w/scrubbers/hidden/layer2,
/obj/machinery/atmospherics/pipe/smart/manifold4w/supply/hidden/layer4,
/obj/structure/cable,
/turf/open/floor/iron/dark/textured,
/area/station/security/armory)
"R" = (
/obj/machinery/recharger,
/obj/structure/table,
/obj/effect/turf_decal/tile/red/half/contrasted,
/obj/machinery/airalarm/directional/north,
/turf/open/floor/iron/dark/textured,
/area/station/security/armory)
"W" = (
/obj/structure/rack,
/obj/effect/turf_decal/tile/red/half/contrasted{
	dir = 4
	},
/obj/effect/spawner/armory_spawn/smg,
/turf/open/floor/iron/dark/textured,
/area/station/security/armory)

(1,1,1) = {"
C
p
P
P
P
"}
(2,1,1) = {"
I
h
w
D
u
"}
(3,1,1) = {"
R
B
w
D
D
"}
(4,1,1) = {"
F
h
w
J
W
"}
(5,1,1) = {"
b
h
f
v
a
"}
(6,1,1) = {"
l
h
N
A
t
"}
