//MAP CONVERTED BY dmm2tgm.py THIS HEADER COMMENT PREVENTS RECONVERSION, DO NOT REMOVE
"a" = (
/obj/machinery/computer/records/security{
	dir = 1
	},
/obj/machinery/requests_console/directional/south{
	department = "Security";
	name = "Security Requests Console"
	},
/obj/effect/mapping_helpers/requests_console/information,
/obj/effect/mapping_helpers/requests_console/assistance,
/obj/effect/turf_decal/tile/red/half/contrasted,
/turf/open/floor/iron/dark,
/area/station/security/checkpoint/science)
"f" = (
/obj/structure/chair/office{
	dir = 4
	},
/obj/effect/landmark/start/science_guard,
/turf/open/floor/iron/dark,
/area/station/security/checkpoint/science)
"g" = (
/turf/closed/wall,
/area/station/command/heads_quarters/rd)
"h" = (
/obj/structure/cable,
/turf/open/floor/iron/dark,
/area/station/security/checkpoint/science)
"k" = (
/turf/closed/wall,
/area/station/security/checkpoint/science)
"n" = (
/obj/structure/table,
/obj/machinery/computer/security/telescreen/research,
/obj/effect/turf_decal/tile/red/half/contrasted{
	dir = 1
	},
/turf/open/floor/iron/dark,
/area/station/security/checkpoint/science)
"o" = (
/obj/structure/table,
/obj/item/paper_bin{
	pixel_x = 1;
	pixel_y = 9
	},
/obj/item/pen,
/obj/item/radio/intercom/directional/south,
/obj/effect/turf_decal/tile/red/anticorner/contrasted,
/turf/open/floor/iron/dark,
/area/station/security/checkpoint/science)
"u" = (
/obj/structure/table,
/obj/machinery/recharger{
	pixel_y = 4
	},
/obj/item/screwdriver{
	pixel_y = 10
	},
/obj/effect/turf_decal/tile/red/anticorner/contrasted{
	dir = 4
	},
/turf/open/floor/iron/dark,
/area/station/security/checkpoint/science)
"v" = (
/turf/closed/wall/r_wall,
/area/station/science/server)
"y" = (
/obj/structure/cable,
/obj/machinery/atmospherics/pipe/smart/manifold4w/scrubbers/hidden/layer2,
/obj/effect/landmark/event_spawn,
/turf/open/floor/iron/dark,
/area/station/security/checkpoint/science)
"z" = (
/obj/structure/table,
/obj/item/book/manual/wiki/security_space_law,
/obj/item/radio/off,
/obj/effect/turf_decal/tile/red/half/contrasted{
	dir = 4
	},
/turf/open/floor/iron/dark,
/area/station/security/checkpoint/science)
"A" = (
/obj/machinery/light_switch/directional/north{
	pixel_x = 4
	},
/obj/machinery/atmospherics/components/unary/vent_pump/on/layer4{
	dir = 4
	},
/obj/machinery/button/door/directional/north{
	id = "Biohazard";
	name = "Biohazard Shutter Control";
	pixel_x = -6;
	req_access = list("research")
	},
/obj/effect/turf_decal/tile/red/half/contrasted{
	dir = 1
	},
/obj/effect/landmark/start/science_guard,
/turf/open/floor/iron/dark,
/area/station/security/checkpoint/science)
"C" = (
/obj/structure/reagent_dispensers/wall/peppertank/directional/west,
/obj/machinery/airalarm/directional/north,
/obj/structure/closet/secure_closet/security/science,
/obj/effect/turf_decal/tile/red/anticorner/contrasted{
	dir = 1
	},
/turf/open/floor/iron/dark,
/area/station/security/checkpoint/science)
"E" = (
/obj/structure/cable,
/obj/machinery/atmospherics/pipe/smart/manifold4w/scrubbers/hidden/layer2,
/obj/machinery/atmospherics/pipe/smart/manifold4w/supply/hidden/layer4,
/obj/effect/turf_decal/tile/red/half/contrasted{
	dir = 1
	},
/turf/open/floor/iron/dark,
/area/station/security/checkpoint/science)
"I" = (
/obj/structure/filingcabinet,
/obj/structure/sign/poster/official/space_cops/directional/west,
/obj/effect/turf_decal/tile/red/anticorner/contrasted{
	dir = 8
	},
/turf/open/floor/iron/dark,
/area/station/security/checkpoint/science)
"J" = (
/turf/closed/wall/r_wall,
/area/station/command/heads_quarters/rd)
"M" = (
/obj/effect/spawner/structure/window/reinforced,
/turf/open/floor/plating,
/area/station/security/checkpoint/science)
"N" = (
/obj/machinery/camera/directional/west{
	c_tag = "Security Post - Science";
	network = list("ss13","rd")
	},
/obj/machinery/newscaster/directional/west,
/obj/machinery/light/directional/west,
/obj/machinery/vending/wardrobe/sec_wardrobe,
/obj/effect/turf_decal/tile/red/half/contrasted{
	dir = 8
	},
/turf/open/floor/iron/dark,
/area/station/security/checkpoint/science)
"S" = (
/obj/structure/cable,
/obj/machinery/atmospherics/components/unary/vent_scrubber/on/layer2{
	dir = 4
	},
/obj/machinery/power/apc/auto_name/directional/south,
/obj/effect/turf_decal/tile/red/half/contrasted,
/turf/open/floor/iron/dark,
/area/station/security/checkpoint/science)
"X" = (
/obj/machinery/door/airlock/security/glass{
	name = "Security Office"
	},
/obj/structure/cable,
/obj/machinery/atmospherics/pipe/smart/manifold4w/scrubbers/hidden/layer2,
/obj/machinery/atmospherics/pipe/smart/manifold4w/supply/hidden/layer4,
/obj/effect/mapping_helpers/airlock/access/all/science/sci_guard,
/turf/open/floor/iron/white,
/area/station/security/checkpoint/science)
"Z" = (
/obj/machinery/atmospherics/pipe/smart/manifold4w/scrubbers/hidden/layer2,
/obj/effect/turf_decal/tile/red/half/contrasted,
/turf/open/floor/iron/dark,
/area/station/security/checkpoint/science)

(1,1,1) = {"
v
v
v
v
J
"}
(2,1,1) = {"
k
C
N
I
g
"}
(3,1,1) = {"
k
A
h
S
g
"}
(4,1,1) = {"
X
E
y
Z
g
"}
(5,1,1) = {"
M
n
f
a
g
"}
(6,1,1) = {"
M
u
z
o
g
"}
(7,1,1) = {"
M
M
M
M
g
"}
