//MAP CONVERTED BY dmm2tgm.py THIS HEADER COMMENT PREVENTS RECONVERSION, DO NOT REMOVE
"a" = (
/obj/machinery/atmospherics/components/unary/vent_scrubber/on/layer2{
	dir = 4
	},
/obj/effect/turf_decal/trimline/red/filled/line{
	dir = 10
	},
/turf/open/floor/iron/dark/smooth_large,
/area/station/security/checkpoint/medical)
"c" = (
/obj/structure/table/reinforced,
/obj/item/screwdriver{
	pixel_y = 10
	},
/obj/item/radio/off,
/obj/item/radio/intercom/directional/north,
/obj/machinery/airalarm/directional/east,
/obj/effect/turf_decal/tile/red/full,
/turf/open/floor/iron/dark/smooth_large,
/area/station/security/checkpoint/medical)
"g" = (
/turf/closed/wall,
/area/station/security/checkpoint/medical)
"j" = (
/obj/structure/table/reinforced,
/obj/structure/reagent_dispensers/wall/peppertank/directional/east,
/obj/effect/turf_decal/tile/red/full,
/turf/open/floor/iron/dark/smooth_large,
/area/station/security/checkpoint/medical)
"n" = (
/obj/machinery/atmospherics/components/unary/vent_pump/on/layer4{
	dir = 4
	},
/obj/effect/turf_decal/trimline/red/filled/line{
	dir = 9
	},
/obj/effect/landmark/start/orderly,
/turf/open/floor/iron/dark/smooth_large,
/area/station/security/checkpoint/medical)
"q" = (
/obj/structure/cable,
/obj/machinery/atmospherics/pipe/smart/manifold4w/scrubbers/hidden/layer2,
/obj/machinery/atmospherics/pipe/smart/manifold4w/supply/hidden/layer4,
/obj/effect/turf_decal/tile/red/full,
/obj/effect/landmark/start/orderly,
/turf/open/floor/iron/dark/smooth_large,
/area/station/security/checkpoint/medical)
"u" = (
/obj/structure/table/reinforced,
/obj/machinery/door/window/brigdoor/right/directional/east{
	req_access = list("brig_entrance")
	},
/obj/machinery/door/poddoor/shutters/preopen{
	dir = 8;
	id = "medsecprivacy";
	name = "Privacy Shutters"
	},
/obj/machinery/door/firedoor,
/turf/open/floor/plating,
/area/station/security/checkpoint/medical)
"v" = (
/obj/machinery/door/airlock/security/glass{
	name = "Medbay Security Post"
	},
/obj/machinery/door/firedoor,
/obj/structure/cable,
/obj/machinery/atmospherics/pipe/smart/manifold4w/scrubbers/hidden/layer2,
/obj/machinery/atmospherics/pipe/smart/manifold4w/supply/hidden/layer4,
/obj/effect/turf_decal/tile/red/full,
/obj/effect/mapping_helpers/airlock/access/all/medical/orderly,
/turf/open/floor/iron/dark/smooth_large,
/area/station/security/checkpoint/medical)
"y" = (
/obj/structure/table/reinforced,
/obj/machinery/recharger{
	pixel_y = 4
	},
/obj/machinery/light/directional/east,
/obj/machinery/requests_console/directional/east{
	department = "Security";
	name = "Security Requests Console"
	},
/obj/effect/mapping_helpers/requests_console/information,
/obj/effect/mapping_helpers/requests_console/assistance,
/obj/effect/turf_decal/tile/red/full,
/turf/open/floor/iron/dark/smooth_large,
/area/station/security/checkpoint/medical)
"C" = (
/obj/effect/spawner/structure/window/reinforced,
/obj/structure/cable,
/obj/machinery/door/poddoor/shutters/preopen{
	dir = 8;
	id = "medsecprivacy";
	name = "Privacy Shutters"
	},
/turf/open/floor/plating,
/area/station/security/checkpoint/medical)
"G" = (
/obj/machinery/computer/records/security{
	dir = 1
	},
/obj/structure/cable,
/obj/machinery/button/door/directional/south{
	id = "MedbayFoyer";
	name = "Medbay Doors Control";
	normaldoorcontrol = 1;
	pixel_x = 5;
	pixel_y = -26
	},
/obj/effect/turf_decal/tile/red/full,
/obj/machinery/light_switch/directional/south{
	pixel_x = -6
	},
/turf/open/floor/iron/dark/smooth_large,
/area/station/security/checkpoint/medical)
"I" = (
/obj/machinery/computer/records/medical,
/obj/structure/cable,
/obj/machinery/button/door/directional/north{
	id = "medsecprivacy";
	name = "Privacy Shutters Control";
	req_access = list("security")
	},
/obj/effect/turf_decal/tile/red/full,
/turf/open/floor/iron/dark/smooth_large,
/area/station/security/checkpoint/medical)
"L" = (
/obj/machinery/atmospherics/pipe/smart/manifold4w/supply/hidden/layer4,
/obj/structure/cable,
/obj/effect/turf_decal/trimline/red/filled/line{
	dir = 5
	},
/obj/effect/landmark/event_spawn,
/turf/open/floor/iron/dark/smooth_large,
/area/station/security/checkpoint/medical)
"M" = (
/obj/structure/table/reinforced,
/obj/machinery/door/window/brigdoor/left/directional/east{
	req_access = list("brig_entrance")
	},
/obj/machinery/door/poddoor/shutters/preopen{
	dir = 8;
	id = "medsecprivacy";
	name = "Privacy Shutters"
	},
/obj/machinery/door/firedoor,
/turf/open/floor/plating,
/area/station/security/checkpoint/medical)
"P" = (
/obj/structure/closet/secure_closet/security/med,
/obj/structure/cable,
/obj/machinery/power/apc/auto_name/directional/east,
/obj/effect/turf_decal/tile/red/full,
/obj/machinery/firealarm/directional/south,
/turf/open/floor/iron/dark/smooth_large,
/area/station/security/checkpoint/medical)
"Q" = (
/obj/machinery/atmospherics/pipe/smart/manifold4w/scrubbers/hidden/layer2,
/obj/machinery/atmospherics/pipe/smart/manifold4w/supply/hidden/layer4,
/obj/structure/cable,
/obj/effect/turf_decal/trimline/red/filled/line{
	dir = 4
	},
/obj/effect/turf_decal/trimline/red/filled/corner{
	dir = 8
	},
/obj/machinery/holopad,
/obj/machinery/computer/security/telescreen/med_sec/directional/east,
/turf/open/floor/iron/dark/smooth_large,
/area/station/security/checkpoint/medical)
"X" = (
/obj/structure/table/reinforced,
/obj/item/book/manual/wiki/security_space_law{
	pixel_x = 3;
	pixel_y = 4
	},
/obj/machinery/newscaster/directional/north,
/obj/structure/cable,
/obj/effect/turf_decal/tile/red/full,
/obj/machinery/camera/directional/north{
	c_tag = "Security Post - Medbay";
	network = list("ss13","medbay")
	},
/turf/open/floor/iron/dark/smooth_large,
/area/station/security/checkpoint/medical)

(1,1,1) = {"
g
C
M
u
C
g
"}
(2,1,1) = {"
g
I
n
a
G
g
"}
(3,1,1) = {"
g
X
L
Q
q
v
"}
(4,1,1) = {"
g
c
y
j
P
g
"}
(5,1,1) = {"
g
g
g
g
g
g
"}
