//MAP CONVERTED BY dmm2tgm.py THIS HEADER COMMENT PREVENTS RECONVERSION, DO NOT REMOVE
"a" = (
/turf/template_noop,
/area/template_noop)
"b" = (
/obj/effect/turf_decal/tile/purple{
	dir = 1
	},
/obj/effect/turf_decal/tile/purple,
/obj/machinery/atmospherics/components/unary/vent_scrubber/on/layer2{
	dir = 1
	},
/obj/effect/landmark/start/barber,
/turf/open/floor/iron,
/area/station/service/barber)
"c" = (
/obj/effect/turf_decal/tile/purple{
	dir = 1
	},
/obj/effect/turf_decal/tile/purple,
/obj/machinery/disposal/bin,
/obj/machinery/firealarm/directional/west,
/obj/structure/disposalpipe/trunk{
	dir = 4
	},
/turf/open/floor/iron,
/area/station/service/barber)
"d" = (
/obj/machinery/atmospherics/pipe/smart/manifold4w/scrubbers/hidden/layer2,
/obj/machinery/atmospherics/pipe/smart/manifold4w/supply/hidden/layer4,
/obj/structure/cable,
/turf/open/floor/iron,
/area/station/hallway/primary/starboard)
"f" = (
/obj/structure/mirror/directional/west,
/obj/effect/turf_decal/tile/purple{
	dir = 1
	},
/obj/effect/turf_decal/tile/purple,
/obj/structure/table/reinforced/rglass,
/turf/open/floor/iron,
/area/station/service/barber)
"i" = (
/obj/machinery/atmospherics/pipe/smart/manifold4w/scrubbers/hidden/layer2,
/obj/machinery/atmospherics/pipe/smart/manifold4w/supply/hidden/layer4,
/obj/structure/cable,
/obj/machinery/door/airlock/public{
	name = "Massage Parlour"
	},
/obj/effect/turf_decal/tile/purple{
	dir = 1
	},
/obj/effect/turf_decal/tile/purple,
/obj/effect/landmark/navigate_destination/autoname,
/turf/open/floor/iron,
/area/station/service/barber)
"j" = (
/obj/structure/table/glass,
/obj/item/lipstick/random,
/obj/item/hairbrush,
/obj/effect/turf_decal/tile/purple{
	dir = 1
	},
/obj/effect/turf_decal/tile/purple,
/turf/open/floor/iron,
/area/station/service/barber)
"l" = (
/obj/structure/chair/comfy/barber_chair{
	dir = 8
	},
/obj/effect/turf_decal/tile/purple{
	dir = 1
	},
/obj/effect/turf_decal/tile/purple{
	dir = 1
	},
/obj/effect/turf_decal/tile/purple,
/obj/structure/cable,
/obj/machinery/airalarm/directional/north,
/obj/structure/disposalpipe/segment,
/turf/open/floor/iron,
/area/station/service/barber)
"m" = (
/obj/effect/turf_decal/tile/purple{
	dir = 1
	},
/obj/effect/turf_decal/tile/purple,
/obj/machinery/atmospherics/pipe/smart/manifold4w/scrubbers/hidden/layer2,
/turf/open/floor/iron,
/area/station/service/barber)
"o" = (
/obj/item/radio/intercom/directional/west,
/obj/effect/turf_decal/tile/purple{
	dir = 1
	},
/obj/effect/turf_decal/tile/purple,
/obj/item/reagent_containers/dropper,
/obj/structure/table/reinforced/rglass,
/turf/open/floor/iron,
/area/station/service/barber)
"q" = (
/obj/effect/turf_decal/tile/purple{
	dir = 1
	},
/obj/effect/turf_decal/tile/purple,
/obj/machinery/button/curtain{
	id = "barbershopcurtains";
	pixel_x = 25;
	pixel_y = 24
	},
/obj/machinery/atmospherics/components/unary/vent_pump/on/layer4,
/obj/structure/cable,
/obj/machinery/power/apc/auto_name/directional/north,
/turf/open/floor/iron,
/area/station/service/barber)
"w" = (
/turf/closed/wall,
/area/station/service/barber)
"x" = (
/obj/effect/spawner/structure/window,
/obj/structure/curtain/cloth/fancy/mechanical{
	id = "barbershopcurtains"
	},
/turf/open/floor/plating,
/area/station/service/barber)
"y" = (
/obj/effect/turf_decal/tile/purple{
	dir = 1
	},
/obj/effect/turf_decal/tile/purple,
/obj/machinery/atmospherics/pipe/smart/manifold4w/scrubbers/hidden/layer2,
/obj/machinery/atmospherics/pipe/smart/manifold4w/supply/hidden/layer4,
/obj/structure/cable,
/obj/structure/disposalpipe/segment{
	dir = 9
	},
/turf/open/floor/iron,
/area/station/service/barber)
"B" = (
/obj/structure/disposalpipe/junction{
	dir = 4
	},
/obj/structure/cable,
/turf/open/floor/plating,
/area/station/maintenance/starboard/fore)
"C" = (
/obj/structure/bed/pod,
/obj/structure/window/spawner/directional/south,
/obj/effect/landmark/start/hangover,
/obj/effect/turf_decal/tile/purple{
	dir = 1
	},
/obj/effect/turf_decal/tile/purple,
/turf/open/floor/iron,
/area/station/service/barber)
"I" = (
/obj/structure/chair/office/light{
	dir = 4
	},
/obj/effect/turf_decal/tile/purple{
	dir = 1
	},
/obj/effect/turf_decal/tile/purple,
/obj/machinery/atmospherics/pipe/smart/manifold4w/supply/hidden/layer4,
/obj/effect/landmark/start/barber,
/turf/open/floor/iron,
/area/station/service/barber)
"K" = (
/obj/effect/turf_decal/tile/purple{
	dir = 1
	},
/obj/effect/turf_decal/tile/purple,
/obj/machinery/atmospherics/pipe/smart/manifold4w/supply/hidden/layer4,
/obj/structure/cable,
/obj/structure/disposalpipe/segment,
/obj/effect/landmark/navigate_destination/autoname,
/turf/open/floor/iron,
/area/station/service/barber)
"L" = (
/obj/structure/closet/secure_closet/barber,
/obj/effect/turf_decal/tile/purple{
	dir = 1
	},
/obj/effect/turf_decal/tile/purple,
/obj/machinery/light/directional/east,
/turf/open/floor/iron,
/area/station/service/barber)
"N" = (
/obj/structure/chair/comfy/barber_chair{
	dir = 8
	},
/obj/effect/turf_decal/tile/purple{
	dir = 1
	},
/obj/effect/turf_decal/tile/purple,
/obj/effect/turf_decal/tile/purple,
/obj/machinery/atmospherics/pipe/smart/manifold4w/scrubbers/hidden/layer2,
/obj/machinery/atmospherics/pipe/smart/manifold4w/supply/hidden/layer4,
/obj/structure/cable,
/obj/structure/disposalpipe/segment,
/obj/effect/landmark/start/hangover,
/turf/open/floor/iron,
/area/station/service/barber)
"S" = (
/obj/structure/disposalpipe/segment,
/turf/closed/wall,
/area/station/service/barber)
"U" = (
/obj/structure/sign/barber/directional/north,
/turf/open/floor/iron,
/area/station/hallway/primary/starboard)
"V" = (
/obj/machinery/vending/barbervend,
/obj/effect/turf_decal/tile/purple{
	dir = 1
	},
/obj/effect/turf_decal/tile/purple,
/turf/open/floor/iron,
/area/station/service/barber)
"W" = (
/obj/structure/mirror/directional/west,
/obj/effect/turf_decal/tile/purple{
	dir = 1
	},
/obj/effect/turf_decal/tile/purple,
/obj/item/hairbrush/comb{
	pixel_y = 10
	},
/obj/item/reagent_containers/spray/quantum_hair_dye{
	pixel_x = 6
	},
/obj/item/reagent_containers/spray/barbers_aid{
	pixel_x = -6
	},
/obj/item/razor,
/obj/structure/table/reinforced/rglass,
/turf/open/floor/iron,
/area/station/service/barber)

(1,1,1) = {"
a
w
w
w
w
w
w
a
"}
(2,1,1) = {"
a
w
W
o
f
c
x
a
"}
(3,1,1) = {"
B
S
l
K
N
y
i
d
"}
(4,1,1) = {"
a
w
q
I
m
b
x
U
"}
(5,1,1) = {"
a
w
j
C
L
V
w
a
"}
(6,1,1) = {"
a
w
w
w
w
w
w
a
"}
