//MAP CONVERTED BY dmm2tgm.py THIS HEADER COMMENT PREVENTS RECONVERSION, DO NOT REMOVE
"a" = (
/obj/structure/cable,
/obj/effect/turf_decal/tile/red/half/contrasted{
	dir = 8
	},
/turf/open/floor/iron/dark,
/area/station/security/checkpoint/engineering)
"b" = (
/obj/machinery/atmospherics/pipe/smart/manifold4w/scrubbers/visible,
/turf/closed/wall/r_wall,
/area/station/security/checkpoint/engineering)
"c" = (
/obj/structure/filingcabinet,
/obj/machinery/airalarm/directional/north,
/obj/structure/cable,
/obj/effect/turf_decal/tile/red/half/contrasted{
	dir = 8
	},
/turf/open/floor/iron/dark,
/area/station/security/checkpoint/engineering)
"d" = (
/obj/structure/table,
/obj/item/paper_bin{
	pixel_x = 1;
	pixel_y = 9
	},
/obj/item/pen,
/obj/item/radio/off,
/obj/effect/turf_decal/tile/red/half/contrasted,
/turf/open/floor/iron/dark,
/area/station/security/checkpoint/engineering)
"e" = (
/obj/structure/chair/office,
/obj/machinery/atmospherics/components/unary/vent_scrubber/on/layer2{
	dir = 1
	},
/turf/open/floor/iron/dark/smooth_large,
/area/station/security/checkpoint/engineering)
"h" = (
/obj/machinery/computer/records/security{
	dir = 1
	},
/obj/structure/cable,
/obj/item/radio/intercom/directional/east,
/obj/effect/turf_decal/tile/red/anticorner/contrasted,
/turf/open/floor/iron/dark,
/area/station/security/checkpoint/engineering)
"n" = (
/obj/structure/cable,
/obj/effect/turf_decal/tile/red/half/contrasted{
	dir = 4
	},
/obj/effect/landmark/start/engineering_guard,
/turf/open/floor/iron/dark,
/area/station/security/checkpoint/engineering)
"o" = (
/obj/machinery/meter,
/obj/machinery/atmospherics/pipe/smart/manifold4w/scrubbers/visible,
/turf/closed/wall/r_wall,
/area/station/security/checkpoint/engineering)
"q" = (
/obj/machinery/vending/wardrobe/sec_wardrobe,
/obj/structure/cable,
/obj/effect/turf_decal/tile/red/opposingcorners,
/obj/machinery/light/directional/north,
/turf/open/floor/iron/dark,
/area/station/security/checkpoint/engineering)
"s" = (
/obj/machinery/door/airlock/security/glass{
	name = "Security Office"
	},
/obj/machinery/atmospherics/pipe/smart/manifold4w/supply/hidden/layer4,
/obj/machinery/atmospherics/pipe/smart/manifold4w/scrubbers/hidden/layer2,
/obj/structure/cable,
/obj/effect/mapping_helpers/airlock/access/all/engineering/engie_guard,
/turf/open/floor/iron/dark,
/area/station/security/checkpoint/engineering)
"y" = (
/obj/structure/reagent_dispensers/wall/peppertank/directional/south,
/obj/structure/table,
/obj/machinery/recharger{
	pixel_y = 4
	},
/obj/item/screwdriver{
	pixel_y = 10
	},
/obj/machinery/power/apc/auto_name/directional/west,
/obj/structure/cable,
/obj/effect/turf_decal/tile/red/anticorner/contrasted{
	dir = 8
	},
/turf/open/floor/iron/dark,
/area/station/security/checkpoint/engineering)
"z" = (
/obj/effect/spawner/structure/window/reinforced,
/obj/structure/cable,
/turf/open/floor/plating,
/area/station/security/checkpoint/engineering)
"B" = (
/obj/structure/cable,
/obj/machinery/atmospherics/pipe/smart/manifold4w/supply/hidden/layer4,
/obj/machinery/atmospherics/pipe/smart/manifold4w/scrubbers/hidden/layer2,
/obj/effect/landmark/start/engineering_guard,
/turf/open/floor/iron/dark,
/area/station/security/checkpoint/engineering)
"E" = (
/turf/closed/wall/r_wall,
/area/station/security/checkpoint/engineering)
"H" = (
/turf/closed/wall/r_wall,
/area/station/engineering/lobby)
"J" = (
/obj/machinery/atmospherics/pipe/smart/manifold4w/scrubbers/hidden/layer2,
/obj/machinery/atmospherics/components/unary/vent_pump/on/layer4{
	dir = 4
	},
/turf/open/floor/iron/dark/smooth_large,
/area/station/security/checkpoint/engineering)
"M" = (
/obj/structure/cable,
/obj/machinery/atmospherics/pipe/smart/manifold4w/scrubbers/hidden/layer2,
/obj/machinery/holopad,
/obj/effect/turf_decal/bot,
/obj/effect/landmark/event_spawn,
/turf/open/floor/iron/dark/smooth_large,
/area/station/security/checkpoint/engineering)
"N" = (
/obj/machinery/camera/directional/east{
	c_tag = "Security Post - Engineering"
	},
/obj/structure/cable,
/obj/effect/turf_decal/tile/red,
/obj/machinery/computer/security/telescreen/engine/directional/east,
/turf/open/floor/iron/dark,
/area/station/security/checkpoint/engineering)
"R" = (
/obj/effect/spawner/structure/window/reinforced,
/obj/structure/cable,
/turf/open/floor/plating,
/area/station/engineering/lobby)
"V" = (
/obj/structure/closet/secure_closet/security/engine,
/obj/machinery/requests_console/directional/north{
	department = "Security";
	name = "Security Requests Console"
	},
/obj/effect/mapping_helpers/requests_console/information,
/obj/effect/mapping_helpers/requests_console/assistance,
/obj/item/book/manual/wiki/security_space_law,
/obj/machinery/newscaster/directional/west,
/obj/effect/turf_decal/tile/red/opposingcorners,
/turf/open/floor/iron/dark,
/area/station/security/checkpoint/engineering)
"W" = (
/turf/template_noop,
/area/template_noop)

(1,1,1) = {"
W
W
E
z
z
E
H
"}
(2,1,1) = {"
o
b
E
c
a
y
H
"}
(3,1,1) = {"
E
V
J
M
e
d
R
"}
(4,1,1) = {"
E
q
B
N
n
h
R
"}
(5,1,1) = {"
E
z
s
E
z
H
H
"}
