//MAP CONVERTED BY dmm2tgm.py THIS HEADER COMMENT PREVENTS RECONVERSION, DO NOT REMOVE
"bN" = (
/obj/structure/cable,
/obj/effect/turf_decal/siding/dark{
	dir = 1
	},
/obj/effect/mapping_helpers/turn_off_lights_with_lightswitch,
/obj/effect/landmark/start/nanotrasen_consultant,
/turf/open/floor/wood,
/area/station/command/heads_quarters/nt_rep)
"cs" = (
/obj/machinery/atmospherics/pipe/smart/manifold4w/scrubbers/hidden/layer2,
/obj/structure/cable,
/obj/effect/turf_decal/trimline/dark_blue/filled/line{
	dir = 6
	},
/obj/effect/landmark/start/blueshield,
/turf/open/floor/iron/dark/smooth_corner{
	dir = 1
	},
/area/station/command/heads_quarters/blueshield)
"cw" = (
/obj/structure/safe/abovetilefloor,
/obj/item/storage/fancy/cigarettes/cigars,
/obj/item/storage/fancy/donut_box,
/obj/item/storage/medkit/tactical/blueshield,
/obj/item/reagent_containers/cup/glass/bottle/navy_rum,
/obj/item/holocigarette/masvedishcigar,
/obj/item/paperwork/captain{
	pixel_x = -3;
	pixel_y = 4;
	name = "Asset Protection case records";
	desc = "A messily compiled stack of DAP records, containing incident reports, asset recovery briefings and classified paramilitary activities, with substantial portions censored and redacted. You probably shouldn't be reading this, unless you yearn for a one-way trip to Space Guantanamo."
	},
/obj/item/toy/plush/horse,
/obj/effect/landmark/start/blueshield,
/turf/open/floor/iron/dark/textured,
/area/station/command/heads_quarters/blueshield)
"cR" = (
/obj/structure/table/wood,
/obj/machinery/fax{
	fax_name = "Nanotrasen Consultant's Office";
	name = "Nanotrasen Consultant's Fax Machine"
	},
/obj/effect/turf_decal/siding/dark{
	dir = 9
	},
/obj/structure/chalkboard{
	pixel_y = 32
	},
/obj/item/radio/intercom/directional/west,
/turf/open/floor/carpet/green,
/area/station/command/heads_quarters/nt_rep)
"dB" = (
/obj/machinery/atmospherics/pipe/smart/manifold4w/scrubbers/hidden/layer2,
/obj/structure/disposalpipe/segment{
	dir = 4
	},
/obj/machinery/atmospherics/pipe/smart/manifold4w/supply/hidden/layer4,
/obj/effect/turf_decal/siding/dark{
	dir = 4
	},
/turf/open/floor/wood,
/area/station/command/heads_quarters/nt_rep)
"dO" = (
/obj/structure/chair/greyscale{
	dir = 8
	},
/obj/effect/turf_decal/delivery/white,
/obj/effect/landmark/start/blueshield,
/turf/open/floor/iron/dark,
/area/station/hallway/primary/central)
"dW" = (
/obj/effect/landmark/start/nanotrasen_consultant,
/turf/open/floor/carpet/green,
/area/station/command/heads_quarters/nt_rep)
"ex" = (
/obj/machinery/modular_computer/preset/time_clock/directional/west,
/obj/structure/disposalpipe/trunk{
	dir = 1
	},
/obj/machinery/disposal/bin,
/obj/effect/turf_decal/bot_white,
/turf/open/floor/iron/dark,
/area/station/hallway/primary/central)
"eM" = (
/obj/machinery/photocopier/prebuilt,
/obj/effect/turf_decal/bot,
/obj/item/toy/plush/goatplushie{
	pixel_y = 11
	},
/turf/open/floor/carpet/green,
/area/station/command/heads_quarters/nt_rep)
"eN" = (
/obj/structure/closet/secure_closet/blueshield,
/obj/structure/window/reinforced/spawner/directional/north,
/obj/structure/window/reinforced/spawner/directional/west,
/obj/effect/turf_decal/delivery/red,
/obj/structure/window/reinforced/spawner/directional/east,
/obj/item/taperecorder{
	name = "Captain's Log"
	},
/obj/item/modular_computer/laptop/preset/security{
	pixel_y = 5
	},
/obj/item/clothing/gloves/tackler/combat/insulated/blueshield,
/turf/open/floor/engine,
/area/station/command/heads_quarters/blueshield)
"fy" = (
/turf/open/floor/iron,
/area/station/hallway/primary/central)
"gq" = (
/obj/structure/closet/secure_closet/tac{
	req_access = list("captain")
	},
/obj/structure/window/reinforced/spawner/directional/west,
/obj/effect/turf_decal/delivery/red,
/obj/structure/sign/flag/nanotrasen/directional/west,
/obj/machinery/door/window/brigdoor/right/directional/east{
	req_access = list("captain");
	name = "Blueshield's Armory"
	},
/obj/item/shield/riot,
/obj/item/screwdriver,
/obj/item/gun_maintenance_supplies,
/obj/item/shield/riot,
/obj/item/storage/toolbox/ammobox/wt550m9,
/turf/open/floor/engine,
/area/station/command/heads_quarters/blueshield)
"gG" = (
/obj/machinery/atmospherics/components/unary/vent_scrubber/on/layer2,
/obj/structure/chair/comfy/brown{
	dir = 4
	},
/obj/effect/landmark/start/blueshield,
/turf/open/floor/iron/dark/smooth_large,
/area/station/command/heads_quarters/blueshield)
"gP" = (
/obj/structure/cable,
/obj/machinery/atmospherics/pipe/smart/manifold4w/supply/hidden/layer4,
/obj/machinery/atmospherics/pipe/smart/manifold4w/scrubbers/hidden/layer2,
/turf/open/floor/iron,
/area/station/hallway/primary/central)
"hn" = (
/obj/machinery/coffeemaker/impressa{
	pixel_x = 2;
	pixel_y = 6
	},
/obj/item/storage/box/coffeepack,
/obj/structure/table/wood,
/obj/effect/turf_decal/tile/neutral/opposingcorners,
/turf/open/floor/iron/dark,
/area/station/command/heads_quarters/nt_rep)
"ia" = (
/obj/effect/mapping_helpers/airlock/access/all/cent_com/rep_door,
/obj/effect/turf_decal/siding/dark,
/obj/effect/mapping_helpers/airlock/unres/delayed{
	dir = 1
	},
/obj/effect/turf_decal/siding/dark,
/obj/effect/turf_decal/siding/dark{
	dir = 1
	},
/obj/machinery/door/airlock/corporate{
	name = "Consultant's Quarters"
	},
/turf/open/floor/carpet/royalblack,
/area/station/command/heads_quarters/nt_rep)
"ij" = (
/obj/structure/sign/calendar/directional/south,
/turf/open/floor/wood,
/area/station/command/heads_quarters/nt_rep)
"iK" = (
/obj/structure/extinguisher_cabinet/directional/west,
/obj/machinery/light/directional/west,
/turf/open/floor/iron,
/area/station/hallway/primary/central)
"jm" = (
/obj/machinery/atmospherics/pipe/smart/manifold4w/scrubbers/hidden/layer2,
/obj/structure/disposalpipe/segment{
	dir = 4
	},
/obj/structure/table/wood/fancy/green,
/obj/effect/spawner/random/entertainment/cigarette_pack,
/turf/open/floor/wood,
/area/station/command/heads_quarters/nt_rep)
"kd" = (
/obj/effect/spawner/structure/window/reinforced,
/obj/machinery/door/poddoor/shutters/preopen{
	id = "blueshield_priv"
	},
/turf/open/floor/plating,
/area/station/command/heads_quarters/blueshield)
"li" = (
/obj/structure/table/reinforced,
/obj/machinery/door/window/brigdoor/left/directional/west{
	name = "Consultant's Desk";
	req_access = list("cent_general");
	unres_sides = 8
	},
/obj/machinery/door/poddoor/shutters/preopen{
	id = "nt_rep_priv"
	},
/obj/machinery/door/window/left/directional/east{
	name = "Reception Window"
	},
/obj/item/phone{
	desc = "Supposedly a direct line to Nanotrasen Central Command. It's not even plugged in.";
	pixel_x = 3;
	pixel_y = 3
	},
/turf/open/floor/plating,
/area/station/command/heads_quarters/nt_rep)
"lB" = (
/obj/effect/turf_decal/bot_white,
/turf/open/floor/iron/dark,
/area/station/hallway/primary/central)
"ne" = (
/obj/structure/cable,
/obj/machinery/atmospherics/components/unary/vent_pump/on/layer4,
/obj/effect/turf_decal/siding/dark{
	dir = 5
	},
/turf/open/floor/wood,
/area/station/command/heads_quarters/nt_rep)
"nj" = (
/obj/machinery/door/airlock/highsecurity{
	name = "Blueshield's Quarters"
	},
/obj/effect/mapping_helpers/airlock/access/all/command/captain,
/turf/open/floor/engine,
/area/station/command/heads_quarters/blueshield)
"pk" = (
/obj/machinery/atmospherics/pipe/smart/manifold4w/scrubbers/hidden/layer2,
/obj/structure/disposalpipe/segment{
	dir = 4
	},
/obj/structure/table/wood/fancy/green,
/obj/item/flashlight/lamp{
	pixel_y = 9
	},
/obj/item/lighter/royal,
/turf/open/floor/wood,
/area/station/command/heads_quarters/nt_rep)
"pt" = (
/obj/structure/table/wood,
/obj/item/paper_bin{
	pixel_y = 4;
	pixel_x = -5
	},
/obj/machinery/recharger{
	pixel_x = 7;
	pixel_y = 6
	},
/obj/effect/mapping_helpers/turn_off_lights_with_lightswitch,
/obj/machinery/atmospherics/components/unary/vent_pump/on/layer4,
/obj/effect/turf_decal/trimline/dark_blue/filled/line{
	dir = 4
	},
/obj/item/pen/fourcolor{
	pixel_x = -5;
	pixel_y = 5
	},
/turf/open/floor/iron/dark/smooth_edge{
	dir = 4
	},
/area/station/command/heads_quarters/blueshield)
"pP" = (
/obj/structure/chair/office{
	dir = 8
	},
/obj/machinery/holopad,
/obj/effect/landmark/start/nanotrasen_consultant,
/turf/open/floor/iron,
/area/station/command/heads_quarters/blueshield)
"rp" = (
/obj/machinery/modular_computer/preset/command,
/obj/machinery/light_switch/directional/east,
/obj/machinery/button/door/directional/east{
	pixel_y = 10;
	id = "nt_rep_priv"
	},
/obj/machinery/requests_console/auto_name/directional/north,
/obj/effect/mapping_helpers/requests_console/assistance,
/obj/effect/mapping_helpers/requests_console/supplies,
/obj/effect/mapping_helpers/requests_console/information,
/obj/effect/mapping_helpers/requests_console/announcement,
/obj/machinery/button/curtain{
	id = "nt_rep_priv";
	name = "curtain control";
	pixel_x = 35;
	pixel_y = 10;
	req_access = list("theatre");
	dir = 4
	},
/obj/effect/turf_decal/bot,
/turf/open/floor/carpet/green,
/area/station/command/heads_quarters/nt_rep)
"rt" = (
/obj/machinery/holopad,
/obj/effect/landmark/start/nanotrasen_consultant,
/turf/open/floor/carpet/green,
/area/station/command/heads_quarters/nt_rep)
"rQ" = (
/obj/machinery/atmospherics/pipe/smart/manifold4w/scrubbers/hidden/layer2,
/obj/machinery/atmospherics/pipe/smart/manifold4w/supply/hidden/layer4,
/obj/structure/cable,
/obj/machinery/digital_clock/directional/south,
/obj/effect/landmark/start/blueshield,
/turf/open/floor/iron,
/area/station/command/heads_quarters/blueshield)
"sc" = (
/obj/structure/flora/bush/sparsegrass/style_random,
/obj/structure/flora/bush/flowers_br/style_random,
/obj/structure/window/reinforced/fulltile,
/obj/structure/curtain/cloth/fancy/mechanical{
	icon_state = "bounty-open";
	icon_type = "bounty";
	id = "nt_rep_priv";
	name = "curtain"
	},
/turf/open/misc/snow/actually_safe,
/area/station/command/heads_quarters/nt_rep)
"sP" = (
/obj/effect/turf_decal/siding/dark{
	dir = 1
	},
/obj/machinery/camera/directional/west{
	c_tag = "Consultant's Office";
	name = "command camera";
	dir = 1
	},
/obj/machinery/computer/station_goal,
/obj/effect/turf_decal/bot,
/turf/open/floor/carpet/green,
/area/station/command/heads_quarters/nt_rep)
"un" = (
/obj/machinery/camera/directional/west{
	c_tag = "Consultant's Office";
	name = "command camera";
	dir = 5
	},
/obj/effect/landmark/start/blueshield,
/obj/structure/sign/flag/nanotrasen/directional/south,
/obj/structure/chair/plastic{
	dir = 1
	},
/turf/open/floor/wood,
/area/station/command/heads_quarters/nt_rep)
"uw" = (
/turf/closed/wall/r_wall,
/area/station/command/heads_quarters/nt_rep)
"uK" = (
/obj/structure/cable,
/turf/open/floor/iron,
/area/station/hallway/primary/central)
"vs" = (
/obj/structure/sign/nanotrasen/directional/west,
/turf/open/floor/iron,
/area/station/hallway/primary/central)
"vE" = (
/obj/item/toy/crayon/white{
	pixel_x = 10;
	pixel_y = -8
	},
/turf/closed/wall/r_wall,
/area/station/command/heads_quarters/nt_rep)
"wm" = (
/obj/structure/disposalpipe/segment{
	dir = 4
	},
/turf/open/floor/wood,
/area/station/command/heads_quarters/nt_rep)
"ye" = (
/obj/structure/table/wood,
/obj/machinery/fax{
	name = "Blueshield's Fax Machine";
	fax_name = "Blueshield's Office"
	},
/obj/machinery/light/directional/north,
/obj/item/radio/intercom/directional/north,
/obj/effect/turf_decal/trimline/dark_blue/filled/line{
	dir = 5
	},
/turf/open/floor/iron/dark/smooth_corner{
	dir = 8
	},
/area/station/command/heads_quarters/blueshield)
"yO" = (
/obj/structure/cable,
/obj/machinery/atmospherics/pipe/smart/manifold4w/scrubbers/hidden/layer2,
/obj/machinery/door/firedoor,
/obj/structure/disposalpipe/junction/flip{
	dir = 8
	},
/obj/effect/landmark/navigate_destination/autoname,
/obj/effect/mapping_helpers/airlock/unres/delayed{
	dir = 8
	},
/obj/effect/mapping_helpers/airlock/access/any/cent_com/rep_or_captain,
/obj/machinery/atmospherics/pipe/smart/manifold4w/supply/hidden/layer4,
/obj/effect/turf_decal/siding/dark{
	dir = 8
	},
/obj/machinery/door/airlock/corporate{
	id_tag = "consultantdoor";
	name = "Consultant's Office"
	},
/turf/open/floor/iron/dark,
/area/station/command/heads_quarters/nt_rep)
"zc" = (
/turf/template_noop,
/area/template_noop)
"zO" = (
/obj/structure/bed/double{
	dir = 1
	},
/obj/item/bedsheet/centcom/double{
	dir = 1
	},
/obj/structure/sign/poster/official/no_erp/directional/west,
/obj/machinery/light/small/directional/west,
/turf/open/floor/carpet/royalblack,
/area/station/command/heads_quarters/nt_rep)
"zW" = (
/obj/structure/cable,
/obj/effect/landmark/start/hangover,
/obj/machinery/atmospherics/pipe/smart/manifold4w/scrubbers/hidden/layer2,
/obj/machinery/atmospherics/pipe/smart/manifold4w/supply/hidden/layer4,
/turf/open/floor/iron,
/area/station/hallway/primary/central)
"BK" = (
/obj/machinery/light/warm/dim/directional/south,
/obj/structure/extinguisher_cabinet/directional/south,
/obj/effect/turf_decal/siding/dark{
	dir = 4
	},
/turf/open/floor/wood,
/area/station/command/heads_quarters/nt_rep)
"Cj" = (
/obj/machinery/photocopier/prebuilt,
/obj/machinery/firealarm/directional/north,
/turf/open/floor/iron,
/area/station/command/heads_quarters/blueshield)
"CV" = (
/obj/structure/cable,
/obj/machinery/atmospherics/pipe/smart/manifold4w/scrubbers/hidden/layer2,
/obj/machinery/atmospherics/pipe/smart/manifold4w/supply/hidden/layer4,
/turf/open/floor/iron,
/area/station/hallway/primary/central)
"DQ" = (
/obj/machinery/atmospherics/pipe/smart/manifold4w/supply/hidden/layer4,
/obj/machinery/atmospherics/pipe/smart/manifold4w/scrubbers/hidden/layer2,
/obj/structure/cable,
/obj/structure/disposalpipe/segment{
	dir = 10
	},
/turf/open/floor/iron/dark,
/area/station/hallway/primary/central)
"Er" = (
/obj/machinery/computer/crew,
/obj/machinery/light/small/directional/north,
/obj/effect/turf_decal/bot,
/obj/structure/reagent_dispensers/wall/peppertank/directional/north,
/obj/machinery/camera/directional/north{
	c_tag = "Blueshield's Office - Quarters"
	},
/turf/open/floor/iron/dark/textured,
/area/station/command/heads_quarters/blueshield)
"Fk" = (
/obj/structure/flora/grass/green/style_random,
/obj/structure/flora/bush/flowers_br/style_random,
/obj/structure/window/reinforced/fulltile,
/obj/structure/curtain/cloth/fancy/mechanical{
	icon_state = "bounty-open";
	icon_type = "bounty";
	id = "nt_rep_priv";
	name = "curtain"
	},
/turf/open/misc/snow/actually_safe,
/area/station/command/heads_quarters/nt_rep)
"FK" = (
/obj/machinery/atmospherics/pipe/smart/manifold4w/scrubbers/hidden/layer2,
/obj/structure/cable,
/obj/machinery/power/apc/auto_name/directional/west,
/obj/machinery/newscaster/directional/south,
/obj/effect/turf_decal/trimline/dark_blue/filled/line,
/obj/machinery/camera/directional/west{
	c_tag = "Blueshield's Office"
	},
/obj/effect/landmark/start/blueshield,
/turf/open/floor/iron/dark/smooth_edge,
/area/station/command/heads_quarters/blueshield)
"FN" = (
/obj/effect/landmark/event_spawn,
/obj/structure/cable,
/obj/machinery/atmospherics/pipe/smart/manifold4w/scrubbers/hidden/layer2,
/obj/machinery/atmospherics/pipe/smart/manifold4w/supply/hidden/layer4,
/turf/open/floor/iron,
/area/station/hallway/primary/central)
"Ge" = (
/obj/item/bedsheet/nanotrasen,
/obj/structure/bed,
/obj/item/toy/plush/lizard_plushie/greyscale{
	name = "Hunts-the-Traitor";
	desc = "The Blueshield's best friend, a little too eager to go after criminals and evil-doers alike. He's grounded forever.";
	greyscale_colors = "#FF0000#000000"
	},
/obj/machinery/light/small/directional/south,
/obj/machinery/vending/wallmed/directional/south,
/turf/open/floor/iron/dark/textured,
/area/station/command/heads_quarters/blueshield)
"Gf" = (
/obj/machinery/vending/boozeomat,
/turf/closed/wall/r_wall,
/area/station/command/heads_quarters/nt_rep)
"Gv" = (
/obj/structure/safe/abovetilefloor,
/obj/item/folder/ancient_paperwork,
/obj/item/lustwish_discount{
	name = "Consultant's LustWish elite card"
	},
/obj/item/reagent_containers/cup/glass/flask{
	pixel_y = -2;
	pixel_x = 2
	},
/obj/item/storage/toolbox/guncase/skyrat/pistol/sec_glock,
/obj/item/reagent_containers/cup/glass/bottle/hcider,
/obj/item/storage/fancy/cigarettes/cigars/cohiba,
/obj/item/storage/box/matches,
/obj/item/folder/documents,
/obj/item/paperwork{
	desc = "A densely compiled stack of Internal Affairs records, documenting various investigations, audits and disciplinary proceedings, extensively redacted under CENTCOM authority.";
	name = "internal affairs records"
	},
/obj/effect/landmark/start/nanotrasen_consultant,
/turf/open/floor/carpet/royalblack,
/area/station/command/heads_quarters/nt_rep)
"Gz" = (
/obj/machinery/door/airlock/corporate{
	name = "Blueshield's Office"
	},
/obj/effect/landmark/navigate_destination/autoname,
/obj/effect/mapping_helpers/airlock/access/any/cent_com/rep_or_captain,
/obj/machinery/atmospherics/pipe/smart/manifold4w/scrubbers/hidden/layer2,
/obj/machinery/atmospherics/pipe/smart/manifold4w/supply/hidden/layer4,
/obj/structure/cable,
/obj/machinery/door/firedoor,
/turf/open/floor/iron/dark,
/area/station/command/heads_quarters/blueshield)
"IY" = (
/obj/machinery/vending/cigarette,
/obj/effect/turf_decal/bot_white,
/turf/open/floor/iron/dark,
/area/station/hallway/primary/central)
"Kc" = (
/obj/structure/table/wood,
/obj/item/paper_bin{
	pixel_y = 4;
	pixel_x = -5
	},
/obj/item/stamp/granted{
	pixel_y = 12;
	pixel_x = 8
	},
/obj/item/stamp/denied{
	pixel_x = 8;
	pixel_y = 6
	},
/obj/item/stamp/centcom{
	pixel_x = 8
	},
/obj/item/pen/fourcolor{
	pixel_x = -5;
	pixel_y = 5
	},
/obj/effect/turf_decal/siding/dark{
	dir = 8
	},
/obj/machinery/firealarm/directional/west,
/obj/item/pen/fountain{
	pixel_x = -5;
	pixel_y = 5
	},
/obj/machinery/light/warm/dim/directional/west,
/turf/open/floor/carpet/green,
/area/station/command/heads_quarters/nt_rep)
"LD" = (
/obj/structure/cable,
/obj/effect/turf_decal/siding/dark{
	dir = 1
	},
/obj/effect/landmark/start/nanotrasen_consultant,
/turf/open/floor/wood,
/area/station/command/heads_quarters/nt_rep)
"LE" = (
/obj/machinery/atmospherics/components/unary/vent_pump/on/layer4{
	dir = 4
	},
/turf/open/floor/iron,
/area/station/hallway/primary/central)
"LO" = (
/obj/structure/chair/office/tactical{
	dir = 4
	},
/obj/effect/landmark/start/nanotrasen_consultant,
/turf/open/floor/carpet/green,
/area/station/command/heads_quarters/nt_rep)
"Nv" = (
/turf/closed/wall/r_wall,
/area/station/command/heads_quarters/blueshield)
"NK" = (
/obj/machinery/airalarm/directional/west,
/obj/machinery/light/warm/dim/directional/west,
/turf/open/floor/wood,
/area/station/command/heads_quarters/nt_rep)
"NL" = (
/obj/structure/dresser,
/obj/structure/secure_safe/directional/north,
/obj/item/sign/flag/nanotrasen{
	pixel_y = 11
	},
/turf/open/floor/carpet/royalblack,
/area/station/command/heads_quarters/nt_rep)
"Of" = (
/obj/structure/filingcabinet/medical{
	pixel_x = -10
	},
/obj/structure/filingcabinet/employment,
/obj/structure/filingcabinet/security{
	pixel_x = 10
	},
/obj/effect/turf_decal/siding/dark{
	dir = 10
	},
/turf/open/floor/carpet/green,
/area/station/command/heads_quarters/nt_rep)
"Qd" = (
/obj/machinery/suit_storage_unit/security,
/obj/structure/window/reinforced/spawner/directional/south,
/obj/structure/window/reinforced/spawner/directional/west,
/obj/effect/turf_decal/delivery/red,
/obj/structure/window/reinforced/spawner/directional/east,
/turf/open/floor/engine,
/area/station/command/heads_quarters/blueshield)
"Qi" = (
/obj/machinery/power/apc/auto_name/directional/west,
/obj/structure/cable,
/obj/effect/turf_decal/siding/dark{
	dir = 1
	},
/turf/open/floor/wood,
/area/station/command/heads_quarters/nt_rep)
"Qk" = (
/obj/effect/landmark/start/hangover,
/turf/open/floor/iron,
/area/station/hallway/primary/central)
"Rb" = (
/obj/structure/disposalpipe/segment,
/turf/closed/wall/r_wall,
/area/station/command/heads_quarters/nt_rep)
"RP" = (
/obj/structure/cable,
/obj/machinery/atmospherics/pipe/smart/manifold4w/scrubbers/hidden/layer2,
/obj/structure/disposalpipe/segment{
	dir = 4
	},
/obj/machinery/atmospherics/pipe/smart/manifold4w/supply/hidden/layer4,
/obj/effect/turf_decal/tile/neutral/opposingcorners,
/turf/open/floor/iron/dark,
/area/station/command/heads_quarters/nt_rep)
"RZ" = (
/obj/structure/cable,
/obj/item/kirbyplants/random,
/obj/effect/turf_decal/tile/neutral/opposingcorners,
/turf/open/floor/iron/dark,
/area/station/command/heads_quarters/nt_rep)
"Tf" = (
/obj/structure/cable,
/obj/structure/fireplace,
/obj/effect/turf_decal/siding/dark{
	dir = 1
	},
/obj/structure/chair/comfy/brown{
	color = "#439C1E";
	dir = 2
	},
/obj/effect/landmark/start/nanotrasen_consultant,
/turf/open/floor/wood,
/area/station/command/heads_quarters/nt_rep)
"Ts" = (
/turf/open/floor/iron/dark,
/area/station/hallway/primary/central)
"UA" = (
/obj/machinery/atmospherics/pipe/smart/manifold4w/scrubbers/hidden/layer2,
/obj/structure/disposalpipe/segment{
	dir = 4
	},
/obj/effect/turf_decal/siding/dark/corner,
/obj/structure/table/wood/fancy/green,
/obj/item/clipboard{
	pixel_x = -4;
	pixel_y = 3
	},
/obj/item/reagent_containers/cup/glass/mug/nanotrasen,
/turf/open/floor/wood,
/area/station/command/heads_quarters/nt_rep)
"VM" = (
/obj/machinery/requests_console/auto_name/directional/north,
/obj/effect/mapping_helpers/requests_console/information,
/obj/effect/mapping_helpers/requests_console/supplies,
/obj/effect/mapping_helpers/requests_console/assistance,
/obj/effect/mapping_helpers/requests_console/announcement,
/obj/machinery/light_switch/directional/west,
/obj/machinery/button/door/directional/west{
	pixel_x = -35;
	pixel_y = 4;
	id = "blueshield_priv"
	},
/obj/effect/turf_decal/trimline/dark_blue/filled/line{
	dir = 1
	},
/obj/effect/turf_decal/bot,
/obj/machinery/modular_computer/preset/command,
/turf/open/floor/iron/dark/smooth_edge{
	dir = 1
	},
/area/station/command/heads_quarters/blueshield)
"Xg" = (
/obj/machinery/atmospherics/components/unary/vent_scrubber/on/layer2{
	dir = 1
	},
/obj/structure/noticeboard/directional/south,
/turf/open/floor/wood,
/area/station/command/heads_quarters/nt_rep)
"XD" = (
/obj/effect/mapping_helpers/airlock/access/all/cent_com/rep_door,
/obj/machinery/door/airlock/maintenance,
/obj/structure/disposalpipe/segment{
	dir = 4
	},
/obj/effect/mapping_helpers/airlock/unres/delayed{
	dir = 4
	},
/obj/machinery/door/poddoor/shutters/preopen{
	id = "nt_rep_priv"
	},
/turf/open/floor/iron/dark/textured_large,
/area/station/command/heads_quarters/nt_rep)
"Yq" = (
/obj/structure/closet/secure_closet/nanotrasen_consultant,
/obj/item/clothing/accessory/medal/gold/ordom,
/obj/item/clothing/accessory/medal/silver/bureaucracy,
/obj/item/hand_labeler,
/obj/machinery/newscaster/directional/north,
/obj/item/stack/sheet/mineral/wood/fifty,
/obj/item/clothing/accessory/pocketprotector,
/turf/open/floor/carpet/royalblack,
/area/station/command/heads_quarters/nt_rep)
"ZQ" = (
/obj/machinery/atmospherics/pipe/smart/manifold4w/scrubbers/hidden/layer2,
/obj/machinery/atmospherics/pipe/smart/manifold4w/supply/hidden/layer4,
/obj/structure/cable,
/turf/open/floor/iron,
/area/station/hallway/primary/central)

(1,1,1) = {"
zc
zc
zc
zc
uw
uw
uw
uw
uw
XD
uw
uw
"}
(2,1,1) = {"
Nv
Nv
Nv
Nv
uw
Yq
zO
Gf
Qi
wm
NK
uw
"}
(3,1,1) = {"
Nv
eN
gq
Qd
uw
NL
Gv
ia
LD
pk
Xg
uw
"}
(4,1,1) = {"
Nv
Er
cw
Ge
uw
uw
uw
uw
Tf
jm
un
uw
"}
(5,1,1) = {"
Nv
Nv
nj
Nv
uw
cR
Kc
Of
bN
UA
ij
uw
"}
(6,1,1) = {"
Nv
VM
gG
FK
vE
sP
rt
dW
ne
dB
BK
uw
"}
(7,1,1) = {"
Nv
ye
pt
cs
uw
rp
LO
eM
RZ
RP
hn
uw
"}
(8,1,1) = {"
Nv
Cj
pP
rQ
uw
uw
li
sc
Fk
yO
Rb
Rb
"}
(9,1,1) = {"
Nv
kd
kd
Gz
uw
IY
dO
lB
Ts
DQ
ex
uw
"}
(10,1,1) = {"
vs
fy
fy
ZQ
iK
fy
fy
LE
Qk
CV
fy
fy
"}
(11,1,1) = {"
uK
uK
uK
ZQ
zW
CV
CV
gP
gP
gP
FN
CV
"}
