//MAP CONVERTED BY dmm2tgm.py THIS HEADER COMMENT PREVENTS RECONVERSION, DO NOT REMOVE
"a" = (
/obj/structure/railing{
	dir = 1
	},
/obj/machinery/suit_storage_unit/security,
/obj/machinery/door/firedoor/border_only{
	dir = 1
	},
/obj/effect/turf_decal/tile/red/half/contrasted{
	dir = 8
	},
/turf/open/floor/iron/dark/textured,
/area/station/ai_monitored/security/armory)
"b" = (
/obj/machinery/door/window/brigdoor/left/directional/north{
	name = "Secure Weapons Storage";
	req_access = list("armory")
	},
/turf/open/floor/iron/dark/textured,
/area/station/ai_monitored/security/armory)
"c" = (
/obj/machinery/atmospherics/pipe/smart/manifold4w/scrubbers/hidden/layer2,
/obj/machinery/atmospherics/pipe/smart/manifold4w/supply/hidden/layer4,
/obj/effect/landmark/event_spawn,
/turf/open/floor/iron/dark/smooth_large,
/area/station/ai_monitored/security/armory)
"f" = (
/obj/machinery/light/directional/south,
/obj/effect/turf_decal/tile/red/half/contrasted,
/turf/open/floor/iron/dark/textured,
/area/station/ai_monitored/security/armory)
"g" = (
/obj/effect/turf_decal/tile/red/half/contrasted{
	dir = 8
	},
/obj/effect/spawner/armory_spawn/smg,
/obj/structure/rack,
/turf/open/floor/iron/dark/textured,
/area/station/ai_monitored/security/armory)
"i" = (
/obj/structure/rack,
/obj/item/gun/energy/ionrifle,
/obj/item/gun/energy/temperature/security,
/obj/item/clothing/suit/hooded/ablative,
/obj/effect/turf_decal/tile/red/anticorner/contrasted,
/turf/open/floor/iron/dark/textured,
/area/station/ai_monitored/security/armory)
"j" = (
/obj/item/radio/intercom/directional/east,
/obj/machinery/atmospherics/components/unary/vent_pump/on/layer4{
	dir = 8
	},
/obj/effect/turf_decal/tile/red/half/contrasted{
	dir = 4
	},
/turf/open/floor/iron/dark,
/area/station/ai_monitored/security/armory)
"l" = (
/obj/item/storage/toolbox/drone,
/obj/machinery/light/directional/east,
/obj/effect/turf_decal/tile/red/half/contrasted{
	dir = 4
	},
/turf/open/floor/iron/dark,
/area/station/ai_monitored/security/armory)
"n" = (
/obj/structure/rack,
/obj/item/gun/energy/laser{
	pixel_x = -3;
	pixel_y = 3
	},
/obj/item/gun/energy/laser,
/obj/item/gun/energy/laser{
	pixel_x = 3;
	pixel_y = -3
	},
/obj/effect/turf_decal/tile/red/anticorner/contrasted{
	dir = 8
	},
/turf/open/floor/iron/dark/textured,
/area/station/ai_monitored/security/armory)
"o" = (
/turf/open/floor/iron/stairs/medium{
	dir = 4
	},
/area/station/ai_monitored/security/armory)
"p" = (
/obj/structure/stairs/west,
/turf/open/floor/iron/dark/smooth_half,
/area/station/ai_monitored/security/armory)
"q" = (
/obj/structure/rack,
/obj/item/clothing/suit/armor/bulletproof{
	pixel_x = -3;
	pixel_y = 3
	},
/obj/item/clothing/suit/armor/bulletproof,
/obj/item/clothing/suit/armor/bulletproof{
	pixel_x = 3;
	pixel_y = -3
	},
/obj/item/clothing/head/helmet/alt{
	pixel_x = -3;
	pixel_y = 3
	},
/obj/item/clothing/head/helmet/alt,
/obj/item/clothing/head/helmet/alt{
	pixel_x = 3;
	pixel_y = -3
	},
/obj/effect/turf_decal/tile/red/anticorner/contrasted{
	dir = 1
	},
/turf/open/floor/iron/dark/textured,
/area/station/ai_monitored/security/armory)
"r" = (
/turf/closed/wall/r_wall,
/area/station/ai_monitored/security/armory)
"t" = (
/obj/machinery/atmospherics/components/unary/vent_scrubber/on/layer2{
	dir = 8
	},
/obj/machinery/light/directional/east,
/obj/effect/turf_decal/tile/red/half/contrasted{
	dir = 4
	},
/turf/open/floor/iron/dark,
/area/station/ai_monitored/security/armory)
"v" = (
/obj/structure/rack,
/obj/structure/window/reinforced/spawner/directional/north,
/obj/effect/turf_decal/tile/red/half{
	dir = 8
	},
/obj/effect/spawner/armory_spawn/shotguns,
/turf/open/floor/iron/dark/textured,
/area/station/ai_monitored/security/armory)
"w" = (
/mob/living/simple_animal/bot/secbot/beepsky/armsky,
/obj/machinery/atmospherics/pipe/smart/manifold4w/scrubbers/hidden/layer2,
/obj/effect/turf_decal/bot,
/obj/machinery/door/firedoor/border_only{
	dir = 8
	},
/turf/open/floor/iron/dark/smooth_large,
/area/station/ai_monitored/security/armory)
"C" = (
/obj/structure/railing,
/obj/machinery/suit_storage_unit/security,
/obj/machinery/atmospherics/pipe/smart/manifold4w/scrubbers/hidden/layer2,
/obj/machinery/atmospherics/pipe/smart/manifold4w/supply/hidden/layer4,
/obj/machinery/door/firedoor/border_only,
/obj/effect/turf_decal/tile/red/half/contrasted{
	dir = 8
	},
/turf/open/floor/iron/dark/textured,
/area/station/ai_monitored/security/armory)
"D" = (
/obj/structure/railing,
/obj/machinery/atmospherics/pipe/smart/manifold4w/scrubbers/hidden/layer2,
/obj/machinery/atmospherics/pipe/smart/manifold4w/supply/hidden/layer4,
/obj/machinery/door/firedoor/border_only,
/turf/open/floor/iron/dark/smooth_large,
/area/station/ai_monitored/security/armory)
"E" = (
/obj/structure/rack,
/obj/item/storage/box/rubbershot{
	pixel_x = -3;
	pixel_y = 3
	},
/obj/item/storage/box/rubbershot,
/obj/item/storage/box/rubbershot{
	pixel_x = 3;
	pixel_y = -3
	},
/obj/structure/window/reinforced/spawner/directional/north,
/obj/effect/turf_decal/tile/red/half/contrasted{
	dir = 4
	},
/turf/open/floor/iron/dark/textured,
/area/station/ai_monitored/security/armory)
"J" = (
/turf/open/floor/iron/dark/smooth_large,
/area/station/ai_monitored/security/armory)
"K" = (
/obj/machinery/atmospherics/pipe/smart/manifold4w/scrubbers/hidden/layer2,
/turf/open/floor/iron/dark,
/area/station/ai_monitored/security/armory)
"P" = (
/obj/structure/railing{
	dir = 1
	},
/obj/machinery/door/firedoor/border_only{
	dir = 1
	},
/turf/open/floor/iron/dark,
/area/station/ai_monitored/security/armory)
"R" = (
/obj/structure/closet/secure_closet/armory_kiboko,
/obj/item/ammo_box/c980grenade/riot,
/obj/item/ammo_box/c980grenade/smoke,
/obj/effect/turf_decal/tile/red/anticorner/contrasted{
	dir = 4
	},
/turf/open/floor/iron/dark,
/area/station/ai_monitored/security/armory)
"T" = (
/obj/machinery/camera/motion/directional/east{
	c_tag = "Security - Secure Armory"
	},
/obj/effect/turf_decal/tile/red/half/contrasted{
	dir = 4
	},
/turf/open/floor/iron/dark,
/area/station/ai_monitored/security/armory)
"V" = (
/obj/machinery/light/directional/north,
/obj/structure/rack,
/obj/item/clothing/glasses/hud/security/sunglasses/gars{
	pixel_x = 3;
	pixel_y = 2
	},
/obj/item/clothing/glasses/hud/security/sunglasses/gars{
	pixel_x = 3;
	pixel_y = -2
	},
/obj/item/clothing/glasses/hud/security/sunglasses{
	pixel_x = -3;
	pixel_y = -2
	},
/obj/item/clothing/glasses/hud/security/sunglasses{
	pixel_x = -3;
	pixel_y = 2
	},
/obj/effect/turf_decal/tile/red/half/contrasted{
	dir = 1
	},
/turf/open/floor/iron/dark/textured,
/area/station/ai_monitored/security/armory)
"W" = (
/obj/structure/rack,
/obj/item/clothing/suit/armor/riot{
	pixel_x = -3;
	pixel_y = 3
	},
/obj/item/clothing/suit/armor/riot,
/obj/item/clothing/suit/armor/riot{
	pixel_x = 3;
	pixel_y = -3
	},
/obj/item/clothing/head/helmet/toggleable/riot{
	pixel_x = -3;
	pixel_y = 3
	},
/obj/item/clothing/head/helmet/toggleable/riot,
/obj/item/clothing/head/helmet/toggleable/riot{
	pixel_x = 3;
	pixel_y = -3
	},
/obj/item/shield/riot{
	pixel_x = -3;
	pixel_y = 3
	},
/obj/item/shield/riot,
/obj/item/shield/riot{
	pixel_x = 3;
	pixel_y = -3
	},
/obj/effect/turf_decal/tile/red/half/contrasted{
	dir = 1
	},
/turf/open/floor/iron/dark/textured,
/area/station/ai_monitored/security/armory)

(1,1,1) = {"
r
q
g
C
p
a
r
r
r
"}
(2,1,1) = {"
r
W
J
D
o
P
v
n
r
"}
(3,1,1) = {"
r
V
J
c
w
K
b
f
r
"}
(4,1,1) = {"
r
R
l
j
T
t
E
i
r
"}
(5,1,1) = {"
r
r
r
r
r
r
r
r
r
"}
