//MAP CONVERTED BY dmm2tgm.py THIS HEADER COMMENT PREVENTS RECONVERSION, DO NOT REMOVE
"ak" = (
/obj/effect/turf_decal/stripes/line{
	dir = 1
	},
/obj/effect/turf_decal/stripes/asteroid/corner{
	dir = 8
	},
/obj/structure/cable,
/obj/effect/decal/cleanable/dirt,
/obj/effect/decal/fakelattice/passthru,
/turf/open/floor/plating,
/area/ruin/space/has_grav)
"ct" = (
/obj/effect/decal/cleanable/wrapping{
	pixel_y = 19
	},
/obj/effect/decal/cleanable/dirt,
/turf/open/floor/plating,
/area/ruin/space/has_grav)
"dj" = (
/obj/structure/lattice,
/obj/machinery/atmospherics/pipe/smart/manifold4w/orange/visible,
/turf/template_noop,
/area/ruin/space/has_grav)
"eL" = (
/obj/machinery/portable_atmospherics/canister/freon{
	name = "Coolant canister"
	},
/obj/effect/decal/cleanable/dirt,
/turf/open/floor/plating,
/area/ruin/space/has_grav)
"fj" = (
/obj/structure/cable,
/obj/effect/decal/cleanable/dirt,
/obj/effect/decal/fakelattice/passthru,
/obj/machinery/light/small/red/directional/south,
/turf/open/floor/plating,
/area/ruin/space/has_grav)
"fo" = (
/obj/effect/decal/fakelattice/passthru,
/turf/closed/wall/mineral/titanium/spaceship/nodiagonal{
	color = "#8ab1ec"
	},
/area/ruin/space/has_grav)
"fF" = (
/obj/structure/frame/computer{
	dir = 4
	},
/obj/effect/decal/cleanable/dirt,
/turf/open/floor/plating,
/area/ruin/space/has_grav)
"fM" = (
/obj/structure/sign/warning,
/obj/structure/cable,
/turf/closed/wall/r_wall{
	color = "#7a9ee0"
	},
/area/ruin/space/has_grav)
"go" = (
/obj/machinery/door/airlock/external,
/obj/effect/mapping_helpers/airlock/cyclelink_helper{
	dir = 1
	},
/obj/effect/decal/cleanable/dirt,
/turf/open/floor/plating,
/area/ruin/space/has_grav)
"gw" = (
/obj/effect/decal/cleanable/robot_debris/limb{
	pixel_y = -7
	},
/obj/effect/decal/cleanable/dirt,
/turf/open/floor/plating,
/area/ruin/space/has_grav)
"gx" = (
/obj/effect/turf_decal/stripes/line,
/obj/structure/tank_holder/oxygen{
	pixel_x = 4;
	pixel_y = 17
	},
/obj/effect/decal/cleanable/dirt,
/obj/effect/decal/fakelattice/passthru,
/turf/open/floor/plating,
/area/ruin/space/has_grav)
"hf" = (
/obj/machinery/door/airlock/multi_tile/metal{
	dir = 8
	},
/obj/effect/decal/cleanable/dirt,
/turf/open/floor/plating,
/area/ruin/space/has_grav)
"hn" = (
/obj/effect/decal/cleanable/dirt,
/obj/machinery/atmospherics/pipe/smart/manifold4w/scrubbers/hidden/layer2{
	dir = 8
	},
/obj/machinery/atmospherics/pipe/smart/manifold4w/supply/hidden/layer4{
	dir = 4
	},
/obj/structure/decorative/fluff/ai_node{
	pixel_x = 24;
	pixel_y = 11
	},
/turf/open/floor/plating,
/area/ruin/space/has_grav)
"hp" = (
/obj/effect/turf_decal/stripes/line{
	dir = 1
	},
/obj/structure/cable,
/obj/effect/decal/cleanable/dirt,
/obj/effect/decal/fakelattice/passthru,
/turf/open/floor/plating,
/area/ruin/space/has_grav)
"iF" = (
/obj/machinery/atmospherics/pipe/smart/manifold4w/orange/visible,
/turf/template_noop,
/area/ruin/space/has_grav)
"ja" = (
/obj/structure/lattice,
/obj/structure/grille,
/turf/template_noop,
/area/ruin/space/has_grav)
"jx" = (
/obj/effect/turf_decal/stripes/line{
	dir = 1
	},
/obj/structure/chair/comfy/shuttle{
	dir = 1
	},
/obj/effect/turf_decal/stripes/asteroid/corner,
/obj/effect/decal/cleanable/dirt,
/obj/effect/decal/fakelattice/passthru,
/obj/machinery/light/dim/directional/south,
/turf/open/floor/plating,
/area/ruin/space/has_grav)
"jA" = (
/obj/effect/turf_decal/stripes/line,
/obj/structure/chair/comfy/shuttle,
/obj/effect/decal/cleanable/dirt,
/obj/effect/decal/fakelattice/passthru,
/turf/open/floor/plating,
/area/ruin/space/has_grav)
"jJ" = (
/obj/structure/frame/computer{
	dir = 4
	},
/obj/effect/decal/cleanable/dirt,
/obj/structure/decorative/fluff/ai_node{
	pixel_x = -5;
	pixel_y = -10
	},
/turf/open/floor/plating,
/area/ruin/space/has_grav)
"jL" = (
/obj/machinery/atmospherics/pipe/smart/manifold4w/orange/visible,
/turf/closed/wall/r_wall{
	color = "#7a9ee0"
	},
/area/ruin/space/has_grav)
"jM" = (
/obj/structure/table,
/obj/item/storage/toolbox/electrical{
	pixel_x = -3;
	pixel_y = 4
	},
/obj/item/storage/toolbox/mechanical{
	pixel_x = 2;
	pixel_y = 1
	},
/obj/effect/decal/cleanable/dirt,
/obj/machinery/light/small/red/directional/south,
/turf/open/floor/plating,
/area/ruin/space/has_grav)
"kg" = (
/obj/effect/turf_decal/stripes/line,
/obj/structure/chair/comfy/shuttle,
/obj/effect/decal/cleanable/dirt,
/obj/effect/decal/fakelattice/passthru,
/obj/machinery/light/dim/directional/west,
/turf/open/floor/plating,
/area/ruin/space/has_grav)
"kh" = (
/obj/effect/decal/cleanable/robot_debris/limb,
/obj/effect/decal/cleanable/dirt,
/obj/effect/decal/fakelattice/passthru,
/turf/open/floor/plating,
/area/ruin/space/has_grav)
"kQ" = (
/obj/effect/decal/cleanable/generic{
	pixel_x = 14
	},
/obj/effect/decal/cleanable/dirt,
/obj/machinery/atmospherics/pipe/smart/manifold4w/scrubbers/hidden/layer2{
	dir = 8
	},
/obj/machinery/atmospherics/pipe/smart/manifold4w/supply/hidden/layer4{
	dir = 4
	},
/turf/open/floor/plating,
/area/ruin/space/has_grav)
"lw" = (
/obj/item/ai_module/toy_ai{
	desc = "A totally real AI, the first of its kind to achieve self-awareness. Totally real.";
	name = "ascended AI";
	pixel_x = -5;
	pixel_y = -3
	},
/obj/effect/decal/cleanable/robot_debris,
/obj/effect/decal/cleanable/dirt,
/obj/effect/decal/fakelattice/passthru,
/obj/machinery/light/small/red/directional/north,
/obj/item/tape/ruins/ghostship,
/obj/structure/decorative/fluff/ai_node{
	pixel_x = -8;
	pixel_y = 24
	},
/turf/open/floor/plating,
/area/ruin/space/has_grav)
"lA" = (
/obj/effect/decal/cleanable/dirt,
/obj/effect/decal/fakelattice/passthru,
/obj/structure/decorative/fluff/ai_node{
	pixel_x = -22;
	pixel_y = 3
	},
/turf/open/floor/plating,
/area/ruin/space/has_grav)
"lG" = (
/obj/item/trash/boritos,
/obj/effect/decal/cleanable/dirt,
/obj/machinery/atmospherics/pipe/smart/manifold4w/scrubbers/hidden/layer2{
	dir = 8
	},
/obj/machinery/atmospherics/pipe/smart/manifold4w/supply/hidden/layer4{
	dir = 4
	},
/turf/open/floor/plating,
/area/ruin/space/has_grav)
"mx" = (
/obj/structure/table,
/obj/item/stock_parts/power_store/cell/hyper{
	pixel_x = -3;
	pixel_y = -2
	},
/obj/item/stock_parts/power_store/cell/hyper{
	pixel_y = 7
	},
/obj/item/stack/cable_coil,
/obj/effect/decal/cleanable/dirt,
/obj/item/disk/design_disk/bepis,
/turf/open/floor/plating,
/area/ruin/space/has_grav)
"mW" = (
/obj/effect/decal/cleanable/greenglow,
/obj/effect/decal/cleanable/dirt,
/obj/machinery/atmospherics/pipe/smart/manifold4w/scrubbers/hidden/layer2{
	dir = 8
	},
/turf/open/floor/plating,
/area/ruin/space/has_grav)
"nz" = (
/obj/machinery/atmospherics/pipe/smart/manifold4w/scrubbers/visible/layer2,
/turf/closed/wall/r_wall{
	color = "#7a9ee0"
	},
/area/ruin/space/has_grav)
"oc" = (
/obj/machinery/door/airlock/multi_tile/metal{
	dir = 4
	},
/obj/effect/decal/cleanable/dirt,
/turf/open/floor/plating,
/area/ruin/space/has_grav)
"oX" = (
/obj/effect/decal/fakelattice/passthru,
/obj/machinery/atmospherics/pipe/smart/manifold4w/orange/visible,
/turf/closed/wall/mineral/titanium/spaceship/nodiagonal{
	color = "#8ab1ec"
	},
/area/ruin/space/has_grav)
"pw" = (
/obj/effect/decal/cleanable/dirt,
/obj/machinery/atmospherics/pipe/smart/manifold4w/supply/hidden/layer4{
	dir = 4
	},
/turf/open/floor/plating,
/area/ruin/space/has_grav)
"pD" = (
/obj/machinery/power/smes,
/obj/effect/decal/cleanable/dirt,
/turf/open/floor/plating,
/area/ruin/space/has_grav)
"qW" = (
/obj/machinery/atmospherics/pipe/smart/manifold4w/orange/visible,
/turf/closed/wall/mineral/titanium/spaceship/nodiagonal{
	color = "#8ab1ec"
	},
/area/ruin/space/has_grav)
"rb" = (
/obj/effect/turf_decal/stripes/line,
/obj/effect/decal/cleanable/dirt,
/obj/effect/decal/fakelattice/passthru,
/obj/structure/decorative/shelf/soda_milk,
/turf/open/floor/plating,
/area/ruin/space/has_grav)
"rp" = (
/obj/structure/cable,
/obj/effect/decal/cleanable/robot_debris/limb,
/obj/effect/decal/cleanable/dirt,
/obj/effect/decal/fakelattice/passthru,
/turf/open/floor/plating,
/area/ruin/space/has_grav)
"sk" = (
/obj/effect/decal/cleanable/dirt,
/obj/machinery/light/small/red/directional/north,
/obj/structure/rack,
/obj/item/stack/sheet/mineral/titanium/fifty{
	pixel_x = 2
	},
/obj/item/stack/sheet/iron/fifty{
	pixel_x = -3
	},
/obj/machinery/atmospherics/pipe/smart/manifold4w/scrubbers/hidden/layer2{
	dir = 8
	},
/turf/open/floor/plating,
/area/ruin/space/has_grav)
"sp" = (
/obj/structure/cable,
/turf/closed/wall/mineral/titanium/spaceship/nodiagonal{
	color = "#8ab1ec"
	},
/area/ruin/space/has_grav)
"sz" = (
/obj/effect/decal/cleanable/dirt,
/obj/effect/decal/fakelattice/passthru,
/obj/machinery/light/small/red/directional/north,
/turf/open/floor/plating,
/area/ruin/space/has_grav)
"ts" = (
/obj/effect/turf_decal/stripes/line{
	dir = 1
	},
/obj/structure/chair/comfy/shuttle{
	dir = 1
	},
/obj/effect/decal/cleanable/dirt,
/obj/effect/decal/fakelattice/passthru,
/obj/machinery/light/dim/directional/west,
/turf/open/floor/plating,
/area/ruin/space/has_grav)
"tz" = (
/turf/closed/wall/mineral/titanium/spaceship/nodiagonal{
	color = "#8ab1ec"
	},
/area/ruin/space/has_grav)
"tV" = (
/obj/effect/decal/cleanable/generic,
/obj/effect/decal/cleanable/dirt,
/obj/effect/decal/fakelattice/passthru,
/turf/open/floor/plating,
/area/ruin/space/has_grav)
"vi" = (
/obj/effect/decal/cleanable/dirt,
/obj/structure/chair/comfy/shuttle{
	dir = 8
	},
/turf/open/floor/plating,
/area/ruin/space/has_grav)
"wp" = (
/obj/effect/turf_decal/stripes/line,
/obj/effect/decal/cleanable/dirt,
/obj/effect/decal/fakelattice/passthru,
/obj/structure/decorative/shelf/crates1,
/obj/item/taperecorder/empty,
/obj/machinery/light/dim/directional/west,
/turf/open/floor/plating,
/area/ruin/space/has_grav)
"wH" = (
/obj/effect/decal/cleanable/robot_debris/limb,
/obj/effect/decal/cleanable/oil,
/obj/effect/decal/cleanable/dirt,
/turf/open/floor/plating,
/area/ruin/space/has_grav)
"wN" = (
/obj/effect/decal/cleanable/robot_debris/limb{
	pixel_x = -16;
	pixel_y = -9
	},
/obj/effect/decal/cleanable/robot_debris,
/obj/effect/decal/cleanable/dirt,
/turf/open/floor/plating,
/area/ruin/space/has_grav)
"xq" = (
/obj/structure/frame/computer{
	dir = 1
	},
/obj/effect/decal/cleanable/dirt,
/turf/open/floor/plating,
/area/ruin/space/has_grav)
"xs" = (
/obj/effect/decal/cleanable/dirt,
/obj/machinery/atmospherics/components/unary/vent_pump/layer4{
	dir = 4
	},
/turf/open/floor/plating,
/area/ruin/space/has_grav)
"xF" = (
/obj/effect/decal/cleanable/dirt,
/obj/machinery/atmospherics/pipe/smart/manifold4w/scrubbers/hidden/layer2{
	dir = 8
	},
/turf/open/floor/plating,
/area/ruin/space/has_grav)
"xP" = (
/obj/structure/lattice,
/turf/template_noop,
/area/ruin/space/has_grav)
"ye" = (
/obj/effect/turf_decal/stripes/line,
/obj/effect/turf_decal/stripes/asteroid/line{
	dir = 1
	},
/obj/effect/decal/cleanable/dirt,
/obj/effect/decal/fakelattice/passthru,
/turf/open/floor/plating,
/area/ruin/space/has_grav)
"yi" = (
/obj/structure/fans/tiny,
/turf/open/floor/plating,
/area/ruin/space/has_grav)
"yG" = (
/obj/machinery/door_buttons/access_button{
	pixel_x = 9;
	pixel_y = 6
	},
/turf/closed/wall/mineral/titanium/spaceship/nodiagonal{
	color = "#8ab1ec"
	},
/area/ruin/space/has_grav)
"yU" = (
/obj/effect/decal/cleanable/generic,
/obj/effect/decal/cleanable/dirt,
/obj/item/stock_parts/power_store/cell/hyper{
	pixel_y = -10
	},
/turf/open/floor/plating,
/area/ruin/space/has_grav)
"yZ" = (
/obj/machinery/atmospherics/pipe/smart/manifold4w/scrubbers/visible/layer2,
/turf/closed/wall/mineral/titanium/spaceship/nodiagonal{
	color = "#8ab1ec"
	},
/area/ruin/space/has_grav)
"zE" = (
/obj/effect/turf_decal/stripes/line,
/obj/structure/chair/comfy/shuttle,
/obj/effect/turf_decal/stripes/asteroid/corner{
	dir = 4
	},
/obj/effect/decal/cleanable/dirt,
/obj/effect/decal/fakelattice/passthru,
/obj/machinery/light/dim/directional/north,
/turf/open/floor/plating,
/area/ruin/space/has_grav)
"zM" = (
/obj/effect/turf_decal/stripes/line{
	dir = 1
	},
/obj/structure/chair/comfy/shuttle{
	dir = 1
	},
/obj/effect/decal/cleanable/dirt,
/obj/effect/decal/fakelattice/passthru,
/turf/open/floor/plating,
/area/ruin/space/has_grav)
"Cc" = (
/obj/structure/cable,
/obj/effect/decal/cleanable/dirt,
/obj/machinery/power/apc/auto_name/directional/north,
/obj/effect/mapping_helpers/apc/unlocked,
/turf/open/floor/plating,
/area/ruin/space/has_grav)
"Ct" = (
/obj/effect/turf_decal/stripes/line{
	dir = 1
	},
/obj/structure/rack{
	pixel_x = 16;
	pixel_y = -3
	},
/obj/item/storage/medkit/ancient{
	pixel_x = 15;
	pixel_y = -3
	},
/obj/effect/decal/cleanable/generic,
/obj/effect/decal/cleanable/dirt,
/obj/effect/decal/fakelattice/passthru,
/turf/open/floor/plating,
/area/ruin/space/has_grav)
"DN" = (
/obj/machinery/atmospherics/components/unary/outlet_injector/layer2,
/obj/structure/lattice,
/turf/template_noop,
/area/ruin/space/has_grav)
"ER" = (
/obj/effect/decal/cleanable/plastic,
/obj/effect/decal/cleanable/dirt,
/turf/open/floor/plating,
/area/ruin/space/has_grav)
"Ga" = (
/obj/machinery/portable_atmospherics/canister/plasma{
	desc = "Plasma gas. Highly fuel efficient. Highly volatile. Highly toxic.";
	name = "Fuel canister"
	},
/obj/effect/decal/cleanable/dirt,
/obj/machinery/atmospherics/components/unary/portables_connector/visible{
	dir = 4
	},
/turf/open/floor/plating,
/area/ruin/space/has_grav)
"Gq" = (
/turf/closed/wall/mineral/titanium/spaceship{
	color = "#8ab1ec"
	},
/area/ruin/space/has_grav)
"He" = (
/obj/effect/decal/cleanable/dirt,
/turf/open/floor/plating,
/area/ruin/space/has_grav)
"Ij" = (
/obj/effect/turf_decal/stripes/line,
/obj/effect/turf_decal/stripes/asteroid/corner{
	dir = 1
	},
/obj/item/reagent_containers/cup/glass/waterbottle/empty,
/obj/effect/decal/cleanable/dirt,
/obj/effect/decal/fakelattice/passthru,
/turf/open/floor/plating,
/area/ruin/space/has_grav)
"Iy" = (
/obj/effect/decal/cleanable/robot_debris/limb,
/obj/effect/decal/cleanable/dirt,
/obj/structure/chair/comfy/shuttle{
	dir = 8
	},
/turf/open/floor/plating,
/area/ruin/space/has_grav)
"IJ" = (
/obj/machinery/door_buttons/access_button{
	pixel_x = 9;
	pixel_y = -6
	},
/turf/closed/wall/mineral/titanium/spaceship/nodiagonal{
	color = "#8ab1ec"
	},
/area/ruin/space/has_grav)
"JX" = (
/obj/effect/turf_decal/stripes/line{
	dir = 1
	},
/obj/effect/turf_decal/stripes/asteroid/line,
/obj/structure/cable,
/obj/effect/decal/cleanable/dirt,
/obj/effect/decal/fakelattice/passthru,
/turf/open/floor/plating,
/area/ruin/space/has_grav)
"Kj" = (
/obj/item/trash/energybar,
/obj/effect/decal/cleanable/dirt,
/turf/open/floor/plating,
/area/ruin/space/has_grav)
"Kt" = (
/obj/effect/decal/fakelattice/passthru,
/turf/closed/wall/mineral/titanium/spaceship{
	color = "#8ab1ec"
	},
/area/ruin/space/has_grav)
"KR" = (
/obj/effect/decal/cleanable/dirt,
/obj/machinery/atmospherics/components/unary/vent_pump/layer4{
	dir = 1
	},
/turf/open/floor/plating,
/area/ruin/space/has_grav)
"KZ" = (
/obj/structure/cable,
/obj/effect/decal/cleanable/dirt,
/obj/effect/decal/fakelattice/passthru,
/turf/open/floor/plating,
/area/ruin/space/has_grav)
"Li" = (
/obj/structure/rack,
/obj/item/stack/sheet/glass/fifty,
/obj/effect/decal/cleanable/dirt,
/turf/open/floor/plating,
/area/ruin/space/has_grav)
"Lk" = (
/obj/effect/decal/cleanable/dirt,
/obj/machinery/atmospherics/components/unary/vent_scrubber/layer2{
	dir = 1
	},
/turf/open/floor/plating,
/area/ruin/space/has_grav)
"LT" = (
/obj/machinery/airalarm/directional/south{
	pixel_x = -5
	},
/obj/effect/mapping_helpers/airalarm/all_access,
/turf/closed/wall/mineral/titanium/spaceship/nodiagonal{
	color = "#8ab1ec"
	},
/area/ruin/space/has_grav)
"LV" = (
/obj/effect/turf_decal/stripes/line,
/obj/effect/decal/cleanable/generic,
/obj/effect/decal/cleanable/dirt,
/obj/effect/decal/fakelattice/passthru,
/turf/open/floor/plating,
/area/ruin/space/has_grav)
"Mo" = (
/obj/effect/turf_decal/stripes/line,
/obj/effect/decal/cleanable/dirt,
/obj/effect/decal/fakelattice/passthru,
/turf/open/floor/plating,
/area/ruin/space/has_grav)
"Mp" = (
/obj/effect/decal/cleanable/plastic,
/obj/effect/decal/cleanable/dirt,
/obj/effect/decal/fakelattice/passthru,
/obj/machinery/light/small/red/directional/south,
/turf/open/floor/plating,
/area/ruin/space/has_grav)
"MQ" = (
/obj/effect/decal/cleanable/oil,
/obj/effect/decal/cleanable/dirt,
/turf/open/floor/plating,
/area/ruin/space/has_grav)
"MY" = (
/obj/effect/decal/cleanable/dirt,
/obj/machinery/atmospherics/pipe/smart/manifold4w/scrubbers/hidden/layer2{
	dir = 8
	},
/obj/machinery/atmospherics/pipe/smart/manifold4w/supply/hidden/layer4{
	dir = 4
	},
/turf/open/floor/plating,
/area/ruin/space/has_grav)
"Oj" = (
/obj/structure/window/reinforced/shuttle/spaceship{
	color = "#8ab1ec"
	},
/turf/open/floor/plating,
/area/ruin/space/has_grav)
"Pr" = (
/obj/effect/decal/cleanable/dirt,
/obj/effect/spawner/random/structure/crate_loot,
/turf/open/floor/plating,
/area/ruin/space/has_grav)
"Qc" = (
/obj/effect/turf_decal/stripes/line{
	dir = 1
	},
/obj/item/storage/medkit/ancient{
	pixel_x = -12;
	pixel_y = -3
	},
/obj/effect/decal/cleanable/dirt,
/obj/effect/decal/fakelattice/passthru,
/obj/structure/decorative/fluff/ai_node{
	pixel_x = -3;
	pixel_y = -25
	},
/turf/open/floor/plating,
/area/ruin/space/has_grav)
"QF" = (
/obj/effect/decal/cleanable/dirt,
/obj/machinery/atmospherics/components/tank/air,
/obj/machinery/atmospherics/components/unary/portables_connector/visible/layer4,
/turf/open/floor/plating,
/area/ruin/space/has_grav)
"QV" = (
/obj/effect/decal/cleanable/dirt,
/obj/structure/frame/computer{
	dir = 4
	},
/obj/structure/decorative/fluff/ai_node{
	pixel_x = 7;
	pixel_y = -3
	},
/turf/open/floor/plating,
/area/ruin/space/has_grav)
"RQ" = (
/obj/machinery/power/shuttle_engine/propulsion{
	dir = 4
	},
/turf/template_noop,
/area/ruin/space/has_grav)
"SR" = (
/obj/effect/turf_decal/stripes/line{
	dir = 1
	},
/obj/effect/decal/cleanable/dirt,
/obj/structure/closet,
/obj/effect/decal/fakelattice/passthru,
/obj/effect/spawner/random/maintenance/three,
/turf/open/floor/plating,
/area/ruin/space/has_grav)
"Ta" = (
/obj/effect/decal/cleanable/generic{
	pixel_x = 4;
	pixel_y = 9
	},
/obj/effect/decal/cleanable/dirt,
/turf/open/floor/plating,
/area/ruin/space/has_grav)
"TM" = (
/obj/machinery/door_buttons/airlock_controller{
	pixel_x = 9
	},
/turf/closed/wall/mineral/titanium/spaceship/nodiagonal{
	color = "#8ab1ec"
	},
/area/ruin/space/has_grav)
"TW" = (
/turf/template_noop,
/area/template_noop)
"Uf" = (
/obj/machinery/power/shuttle_engine/large{
	dir = 4
	},
/turf/closed/wall/mineral/titanium/spaceship/nodiagonal{
	color = "#8ab1ec"
	},
/area/ruin/space/has_grav)
"Uw" = (
/obj/machinery/power/terminal,
/obj/structure/cable,
/obj/effect/decal/cleanable/dirt,
/obj/machinery/light/dim/directional/west,
/obj/structure/decorative/fluff/ai_node{
	pixel_x = 7;
	pixel_y = -24
	},
/turf/open/floor/plating,
/area/ruin/space/has_grav)
"UL" = (
/obj/machinery/power/shuttle_engine/heater{
	dir = 4
	},
/turf/closed/wall/r_wall{
	color = "#7a9ee0"
	},
/area/ruin/space/has_grav)
"Vv" = (
/obj/effect/decal/cleanable/dirt,
/obj/machinery/portable_atmospherics/canister/plasma{
	desc = "Plasma gas. Highly fuel efficient. Highly volatile. Highly toxic.";
	name = "Fuel canister"
	},
/obj/machinery/atmospherics/components/unary/portables_connector/visible{
	dir = 4
	},
/turf/open/floor/plating,
/area/ruin/space/has_grav)
"WH" = (
/obj/machinery/door/airlock/external,
/obj/effect/mapping_helpers/airlock/cyclelink_helper,
/turf/open/floor/plating,
/area/ruin/space/has_grav)
"Xr" = (
/turf/closed/wall/r_wall{
	color = "#7a9ee0"
	},
/area/ruin/space/has_grav)
"Xz" = (
/obj/effect/decal/cleanable/dirt,
/obj/structure/decorative/fluff/ai_node{
	pixel_x = 7;
	pixel_y = 23
	},
/turf/open/floor/plating,
/area/ruin/space/has_grav)
"Yd" = (
/obj/item/trash/cheesie,
/obj/effect/decal/cleanable/dirt,
/turf/open/floor/plating,
/area/ruin/space/has_grav)
"YN" = (
/obj/structure/closet,
/obj/effect/turf_decal/stripes/line{
	dir = 1
	},
/obj/effect/decal/cleanable/dirt,
/obj/effect/decal/fakelattice/passthru,
/obj/machinery/light/dim/directional/west,
/turf/open/floor/plating,
/area/ruin/space/has_grav)
"YT" = (
/obj/structure/cable,
/obj/effect/decal/cleanable/dirt,
/turf/open/floor/plating,
/area/ruin/space/has_grav)
"Zf" = (
/obj/machinery/power/shuttle_engine/heater{
	dir = 4
	},
/obj/machinery/atmospherics/pipe/smart/manifold4w/orange/visible,
/turf/closed/wall/mineral/titanium/spaceship/nodiagonal{
	color = "#8ab1ec"
	},
/area/ruin/space/has_grav)

(1,1,1) = {"
TW
TW
TW
TW
TW
TW
TW
TW
TW
TW
TW
TW
TW
TW
TW
TW
TW
TW
TW
TW
"}
(2,1,1) = {"
TW
TW
TW
TW
TW
TW
TW
TW
TW
TW
TW
TW
TW
TW
TW
TW
TW
TW
TW
TW
"}
(3,1,1) = {"
TW
TW
TW
TW
TW
TW
TW
Gq
tz
Oj
Oj
tz
Gq
TW
TW
TW
TW
TW
TW
TW
"}
(4,1,1) = {"
TW
TW
TW
TW
TW
TW
TW
tz
jJ
fF
QV
fF
tz
TW
TW
TW
TW
TW
TW
TW
"}
(5,1,1) = {"
TW
TW
TW
Gq
tz
TW
Gq
tz
ER
vi
Iy
He
tz
Gq
TW
tz
Gq
TW
TW
TW
"}
(6,1,1) = {"
TW
TW
TW
tz
xP
Kt
tz
wp
ct
xs
He
He
YN
tz
Kt
xP
tz
TW
TW
TW
"}
(7,1,1) = {"
TW
TW
TW
tz
ja
fo
tz
rb
Kj
MY
Lk
Ta
SR
tz
fo
ja
tz
TW
TW
TW
"}
(8,1,1) = {"
TW
TW
TW
tz
TW
tz
eL
tz
tz
MY
oc
tz
tz
Xz
tz
TW
tz
TW
TW
TW
"}
(9,1,1) = {"
TW
TW
TW
tz
xP
tz
lw
tz
kg
MY
Yd
ts
tz
Mp
tz
xP
tz
TW
TW
TW
"}
(10,1,1) = {"
TW
TW
TW
TW
TW
yG
TM
IJ
jA
MY
He
zM
tz
Cc
tz
TW
TW
TW
TW
TW
"}
(11,1,1) = {"
TW
TW
TW
TW
TW
WH
yi
go
Mo
kQ
He
Ct
tz
KZ
tz
TW
TW
TW
TW
TW
"}
(12,1,1) = {"
TW
TW
TW
tz
xP
fo
tz
LT
gx
MY
KR
Qc
tz
YT
fo
xP
tz
TW
TW
TW
"}
(13,1,1) = {"
TW
TW
TW
tz
TW
tz
lA
tz
jA
lG
He
zM
tz
rp
tz
TW
tz
TW
TW
TW
"}
(14,1,1) = {"
TW
TW
TW
tz
ja
fo
yU
tz
jA
MY
Lk
zM
tz
YT
fo
ja
tz
TW
TW
TW
"}
(15,1,1) = {"
TW
TW
TW
tz
TW
tz
sz
tz
zE
MY
gw
jx
tz
fj
tz
TW
tz
TW
TW
TW
"}
(16,1,1) = {"
TW
TW
TW
TW
TW
tz
He
tz
ye
MY
He
JX
sp
YT
tz
TW
TW
TW
TW
TW
"}
(17,1,1) = {"
TW
TW
TW
TW
TW
tz
kh
tz
Ij
MY
ER
ak
tz
tV
tz
TW
TW
TW
TW
TW
"}
(18,1,1) = {"
TW
TW
Gq
tz
ja
fo
Ga
tz
LV
hn
He
hp
tz
Vv
fo
ja
tz
Gq
TW
TW
"}
(19,1,1) = {"
TW
TW
tz
tz
xP
fo
qW
Xr
Xr
MY
hf
fM
Xr
qW
oX
dj
tz
tz
TW
TW
"}
(20,1,1) = {"
TW
TW
tz
qW
iF
qW
jL
QF
pw
MY
KR
Uw
pD
Xr
tz
iF
qW
tz
TW
TW
"}
(21,1,1) = {"
TW
TW
tz
qW
ja
fo
Xr
Li
wH
xF
Lk
He
mx
Xr
fo
ja
qW
tz
TW
TW
"}
(22,1,1) = {"
TW
TW
Zf
Zf
DN
yZ
nz
sk
xF
mW
He
MQ
jM
Xr
tz
xP
Zf
Zf
TW
TW
"}
(23,1,1) = {"
TW
TW
RQ
RQ
TW
tz
Xr
Pr
He
ER
wN
He
xq
Xr
tz
TW
RQ
RQ
TW
TW
"}
(24,1,1) = {"
TW
TW
TW
TW
TW
tz
tz
Xr
Xr
UL
UL
Xr
Xr
tz
tz
TW
TW
TW
TW
TW
"}
(25,1,1) = {"
TW
TW
TW
TW
TW
Gq
tz
tz
tz
tz
Uf
tz
tz
tz
Gq
TW
TW
TW
TW
TW
"}
(26,1,1) = {"
TW
TW
TW
TW
TW
TW
TW
TW
TW
TW
TW
TW
TW
TW
TW
TW
TW
TW
TW
TW
"}
(27,1,1) = {"
TW
TW
TW
TW
TW
TW
TW
TW
TW
TW
TW
TW
TW
TW
TW
TW
TW
TW
TW
TW
"}
(28,1,1) = {"
TW
TW
TW
TW
TW
TW
TW
TW
TW
TW
TW
TW
TW
TW
TW
TW
TW
TW
TW
TW
"}
