//MAP CONVERTED BY dmm2tgm.py THIS HEADER COMMENT PREVENTS RECONVERSION, DO NOT REMOVE
"aP" = (
/obj/effect/mob_spawn/corpse/human/skeleton,
/obj/effect/gibspawner/human,
/turf/open/floor/iron/dark/airless,
/area/ruin/space/has_grav)
"aW" = (
/obj/effect/spawner/structure/window/reinforced/plasma/plastitanium,
/turf/open/floor/plating/airless,
/area/ruin/space/has_grav)
"bQ" = (
/obj/structure/grille/broken,
/obj/effect/mapping_helpers/burnt_floor,
/turf/open/floor/plating/airless,
/area/ruin/space/has_grav)
"cc" = (
/obj/machinery/autolathe,
/obj/item/stack/sheet/iron/fifty,
/obj/item/stack/sheet/glass/fifty,
/turf/open/floor/iron/airless,
/area/ruin/space/has_grav)
"dL" = (
/obj/structure/table/optable,
/obj/effect/mob_spawn/corpse/human/charredskeleton,
/obj/machinery/atmospherics/pipe/smart/simple/scrubbers/hidden{
	dir = 4
	},
/obj/effect/mapping_helpers/burnt_floor,
/turf/open/floor/iron/airless,
/area/ruin/space/has_grav)
"dO" = (
/obj/structure/grille/broken,
/turf/open/floor/plating/airless,
/area/ruin/space/has_grav)
"fA" = (
/obj/structure/lattice,
/obj/structure/girder,
/turf/template_noop,
/area/ruin/space/has_grav)
"iD" = (
/obj/structure/cable,
/obj/structure/frame/machine,
/turf/open/floor/engine/airless,
/area/ruin/space/has_grav)
"iJ" = (
/obj/machinery/recharger,
/turf/open/floor/iron/dark/airless,
/area/ruin/space/has_grav)
"jA" = (
/obj/machinery/atmospherics/components/unary/vent_scrubber{
	dir = 1
	},
/obj/effect/mapping_helpers/burnt_floor,
/turf/open/floor/iron/airless,
/area/ruin/space/has_grav)
"kf" = (
/obj/structure/grille,
/turf/open/floor/plating/airless,
/area/ruin/space/has_grav)
"kN" = (
/obj/effect/mapping_helpers/burnt_floor,
/turf/open/floor/iron/airless,
/area/ruin/space/has_grav)
"kP" = (
/obj/structure/girder,
/turf/open/floor/plating/airless,
/area/ruin/space/has_grav)
"ma" = (
/obj/structure/frame/computer,
/obj/effect/mapping_helpers/burnt_floor,
/turf/open/floor/plating/airless,
/area/ruin/space/has_grav)
"mj" = (
/obj/structure/frame/machine,
/turf/open/floor/iron/airless,
/area/ruin/space/has_grav)
"mP" = (
/obj/structure/table/reinforced,
/obj/item/surgery_tray/full,
/obj/item/reagent_containers/cup/beaker/cryoxadone,
/obj/machinery/atmospherics/pipe/smart/simple/scrubbers/hidden{
	dir = 5
	},
/obj/effect/mapping_helpers/burnt_floor,
/turf/open/floor/iron/airless,
/area/ruin/space/has_grav)
"on" = (
/obj/structure/closet/secure_closet/brig,
/obj/structure/window/reinforced/spawner/directional/west,
/turf/open/floor/iron/dark/airless,
/area/ruin/space/has_grav)
"oB" = (
/obj/machinery/atmospherics/components/unary/portables_connector/visible,
/obj/machinery/portable_atmospherics/canister/oxygen,
/obj/effect/mapping_helpers/burnt_floor,
/turf/open/floor/plating/airless,
/area/ruin/space/has_grav)
"qI" = (
/obj/machinery/firealarm{
	pixel_y = 26
	},
/obj/machinery/atmospherics/components/unary/portables_connector/visible,
/turf/open/floor/engine/airless,
/area/ruin/space/has_grav)
"se" = (
/obj/effect/mob_spawn/corpse/human/scientist,
/turf/open/floor/iron/dark/airless,
/area/ruin/space/has_grav)
"sr" = (
/obj/machinery/power/shuttle_engine/propulsion/burst,
/turf/open/floor/plating/airless,
/area/ruin/space/has_grav)
"sx" = (
/obj/machinery/power/shuttle_engine/heater,
/turf/closed/wall/mineral/titanium,
/area/ruin/space/has_grav)
"sD" = (
/obj/effect/gibspawner/human,
/turf/open/floor/iron/dark/airless,
/area/ruin/space/has_grav)
"sK" = (
/obj/structure/frame/computer,
/obj/effect/mapping_helpers/burnt_floor,
/turf/open/floor/iron/airless,
/area/ruin/space/has_grav)
"tH" = (
/obj/machinery/door/airlock/command/glass,
/obj/machinery/door/firedoor,
/turf/open/floor/iron/dark/airless,
/area/ruin/space/has_grav)
"tP" = (
/obj/machinery/cryo_cell,
/obj/effect/mapping_helpers/burnt_floor,
/turf/open/floor/plating/airless,
/area/ruin/space/has_grav)
"ve" = (
/obj/machinery/atmospherics/components/unary/thermomachine/freezer{
	dir = 1
	},
/obj/machinery/light/directional/west,
/obj/effect/mapping_helpers/burnt_floor,
/turf/open/floor/iron/airless,
/area/ruin/space/has_grav)
"wY" = (
/turf/closed/mineral/random/labormineral,
/area/ruin/space/has_grav)
"xe" = (
/obj/machinery/stasis,
/obj/effect/mob_spawn/corpse/human/charredskeleton,
/obj/effect/mapping_helpers/burnt_floor,
/turf/open/floor/plating/airless,
/area/ruin/space/has_grav)
"xy" = (
/turf/open/floor/iron/dark/airless,
/area/ruin/space/has_grav)
"yl" = (
/obj/structure/grille,
/obj/machinery/atmospherics/pipe/smart/simple/scrubbers/hidden{
	dir = 4
	},
/turf/open/floor/plating/airless,
/area/ruin/space/has_grav)
"Bf" = (
/turf/closed/wall/mineral/titanium,
/area/ruin/space/has_grav)
"Bm" = (
/obj/machinery/door/airlock/external,
/obj/structure/fans/tiny,
/obj/machinery/door/firedoor,
/turf/open/floor/iron/airless,
/area/ruin/space/has_grav)
"Cl" = (
/obj/effect/spawner/structure/window/reinforced/shuttle,
/turf/open/floor/plating/airless,
/area/ruin/space/has_grav)
"Dh" = (
/obj/machinery/atmospherics/pipe/smart/manifold/general/visible{
	dir = 8
	},
/obj/effect/mapping_helpers/burnt_floor,
/turf/open/floor/iron/airless,
/area/ruin/space/has_grav)
"Di" = (
/turf/open/floor/engine/airless,
/area/ruin/space/has_grav)
"DU" = (
/obj/machinery/door/window/brigdoor/left/directional/west,
/obj/machinery/light/directional/east,
/obj/effect/mob_spawn/corpse/human/skeleton,
/turf/open/floor/iron/dark/airless,
/area/ruin/space/has_grav)
"Fc" = (
/obj/machinery/light/directional/south,
/obj/effect/mapping_helpers/burnt_floor,
/turf/open/floor/iron/airless,
/area/ruin/space/has_grav)
"Fn" = (
/obj/machinery/cell_charger,
/obj/machinery/light/directional/west,
/turf/open/floor/plating/airless,
/area/ruin/space/has_grav)
"Ge" = (
/obj/structure/frame/machine,
/turf/open/floor/plating/airless,
/area/ruin/space/has_grav)
"Jd" = (
/obj/structure/frame/machine,
/obj/effect/mapping_helpers/burnt_floor,
/turf/open/floor/iron/airless,
/area/ruin/space/has_grav)
"JP" = (
/turf/template_noop,
/area/template_noop)
"LC" = (
/obj/machinery/door/airlock/mining/glass,
/obj/machinery/door/firedoor,
/obj/effect/mapping_helpers/burnt_floor,
/turf/open/floor/iron/airless,
/area/ruin/space/has_grav)
"LK" = (
/turf/open/misc/asteroid/airless,
/area/ruin/space/has_grav)
"Mk" = (
/obj/structure/window/reinforced/spawner/directional/west,
/obj/structure/window/reinforced/spawner/directional/east,
/turf/open/floor/plating/airless,
/area/ruin/space/has_grav)
"Mn" = (
/obj/effect/mob_spawn/corpse/human/clown,
/obj/effect/mapping_helpers/burnt_floor,
/turf/open/floor/iron/airless,
/area/ruin/space/has_grav)
"Mq" = (
/obj/effect/mob_spawn/corpse/human/charredskeleton,
/obj/machinery/atmospherics/pipe/smart/simple/scrubbers/hidden{
	dir = 4
	},
/obj/effect/mapping_helpers/burnt_floor,
/turf/open/floor/plating/airless,
/area/ruin/space/has_grav)
"ME" = (
/turf/closed/wall/mineral/titanium/nodiagonal,
/area/ruin/space/has_grav)
"Pz" = (
/obj/machinery/computer/operating{
	dir = 1
	},
/obj/machinery/atmospherics/pipe/smart/simple/scrubbers/hidden{
	dir = 4
	},
/obj/effect/mapping_helpers/burnt_floor,
/turf/open/floor/plating/airless,
/area/ruin/space/has_grav)
"RO" = (
/obj/machinery/door/airlock/research/glass{
	welded = 1
	},
/obj/machinery/door/firedoor,
/turf/open/floor/iron/dark/airless,
/area/ruin/space/has_grav)
"Sl" = (
/obj/machinery/atmospherics/pipe/smart/manifold{
	dir = 1
	},
/obj/effect/mapping_helpers/burnt_floor,
/turf/open/floor/iron/airless,
/area/ruin/space/has_grav)
"SO" = (
/obj/machinery/rnd/production/circuit_imprinter/offstation,
/turf/open/floor/iron/dark/airless,
/area/ruin/space/has_grav)
"Vy" = (
/obj/effect/mapping_helpers/burnt_floor,
/turf/open/floor/plating/airless,
/area/ruin/space/has_grav)
"VR" = (
/obj/structure/frame/computer{
	dir = 4
	},
/obj/effect/mapping_helpers/burnt_floor,
/turf/open/floor/iron/airless,
/area/ruin/space/has_grav)
"Wp" = (
/turf/closed/mineral/random/high_chance,
/area/ruin/space/has_grav)
"Wv" = (
/obj/machinery/atmospherics/pipe/smart/simple/general/visible{
	dir = 9
	},
/obj/effect/mob_spawn/corpse/human/charredskeleton,
/obj/effect/mapping_helpers/burnt_floor,
/turf/open/floor/plating/airless,
/area/ruin/space/has_grav)
"Wy" = (
/obj/structure/lattice,
/obj/structure/grille,
/turf/template_noop,
/area/ruin/space/has_grav)
"Xe" = (
/obj/machinery/suit_storage_unit/standard_unit,
/obj/effect/mapping_helpers/burnt_floor,
/turf/open/floor/iron/airless,
/area/ruin/space/has_grav)
"XV" = (
/obj/effect/mob_spawn/corpse/human/skeleton,
/obj/effect/mapping_helpers/burnt_floor,
/turf/open/floor/plating/airless,
/area/ruin/space/has_grav)
"Yr" = (
/obj/structure/lattice,
/turf/template_noop,
/area/ruin/space/has_grav)

(1,1,1) = {"
JP
JP
JP
JP
JP
JP
JP
JP
JP
JP
JP
JP
JP
JP
JP
JP
JP
JP
JP
JP
JP
JP
wY
wY
wY
wY
wY
wY
wY
wY
wY
wY
wY
JP
JP
JP
JP
JP
JP
JP
JP
JP
JP
JP
JP
JP
JP
JP
JP
JP
JP
JP
JP
JP
JP
JP
JP
JP
JP
JP
"}
(2,1,1) = {"
JP
JP
JP
JP
JP
JP
JP
JP
JP
JP
JP
JP
JP
JP
JP
JP
JP
JP
wY
wY
wY
wY
wY
wY
wY
wY
wY
wY
wY
wY
wY
wY
wY
wY
JP
JP
JP
JP
JP
JP
JP
JP
JP
JP
JP
JP
JP
JP
JP
JP
JP
JP
JP
JP
JP
JP
JP
JP
JP
JP
"}
(3,1,1) = {"
JP
JP
JP
JP
JP
JP
JP
JP
JP
JP
JP
JP
JP
JP
JP
JP
wY
wY
wY
wY
wY
wY
wY
wY
wY
wY
wY
wY
wY
wY
wY
wY
wY
wY
wY
JP
JP
JP
JP
JP
JP
JP
JP
JP
JP
JP
JP
JP
JP
JP
JP
JP
JP
JP
JP
JP
JP
JP
JP
JP
"}
(4,1,1) = {"
JP
JP
JP
JP
JP
JP
JP
JP
JP
JP
JP
JP
JP
JP
wY
wY
wY
wY
wY
wY
wY
wY
wY
wY
wY
wY
wY
wY
wY
wY
wY
wY
wY
wY
wY
JP
JP
JP
JP
JP
JP
JP
JP
JP
JP
JP
JP
JP
JP
JP
JP
JP
JP
JP
JP
JP
JP
JP
JP
JP
"}
(5,1,1) = {"
JP
JP
JP
JP
JP
JP
JP
JP
JP
JP
JP
JP
JP
wY
wY
wY
wY
wY
wY
wY
wY
wY
wY
wY
wY
wY
wY
wY
wY
wY
wY
wY
wY
wY
wY
JP
JP
JP
JP
JP
JP
JP
JP
JP
JP
JP
JP
JP
JP
JP
JP
JP
JP
JP
JP
JP
JP
JP
JP
JP
"}
(6,1,1) = {"
JP
JP
JP
JP
JP
JP
JP
JP
JP
JP
wY
wY
wY
wY
wY
wY
wY
wY
wY
wY
wY
wY
wY
wY
wY
wY
wY
wY
wY
wY
wY
wY
wY
wY
wY
wY
JP
JP
JP
JP
JP
JP
JP
JP
JP
JP
JP
JP
JP
JP
JP
JP
JP
JP
JP
JP
JP
JP
JP
JP
"}
(7,1,1) = {"
JP
JP
JP
JP
JP
JP
wY
wY
wY
wY
wY
wY
wY
wY
wY
wY
wY
wY
wY
wY
wY
wY
wY
wY
wY
wY
wY
wY
wY
wY
wY
wY
wY
wY
wY
wY
wY
JP
JP
JP
JP
JP
JP
JP
JP
JP
JP
JP
JP
JP
JP
JP
JP
JP
JP
JP
JP
JP
JP
JP
"}
(8,1,1) = {"
JP
JP
JP
JP
wY
wY
wY
wY
wY
wY
wY
wY
wY
wY
wY
wY
wY
wY
wY
wY
wY
wY
wY
wY
wY
wY
wY
wY
wY
wY
wY
wY
wY
wY
wY
wY
wY
JP
JP
JP
JP
JP
JP
JP
JP
JP
JP
JP
JP
JP
JP
JP
JP
JP
JP
JP
JP
JP
JP
JP
"}
(9,1,1) = {"
JP
JP
wY
wY
wY
wY
wY
wY
wY
wY
wY
wY
wY
wY
wY
wY
wY
wY
wY
wY
wY
wY
wY
wY
wY
wY
wY
wY
wY
wY
wY
wY
wY
wY
wY
wY
JP
JP
JP
JP
JP
JP
JP
JP
JP
JP
JP
JP
JP
JP
JP
JP
JP
JP
JP
JP
JP
JP
JP
JP
"}
(10,1,1) = {"
JP
JP
wY
wY
wY
wY
wY
wY
wY
wY
wY
wY
wY
wY
wY
wY
wY
wY
wY
wY
wY
wY
wY
Bf
Wp
Bf
Wp
Bf
Bf
Bf
LK
LK
wY
wY
JP
JP
JP
JP
JP
JP
JP
JP
JP
JP
JP
JP
JP
JP
JP
JP
JP
JP
JP
JP
JP
JP
JP
JP
JP
JP
"}
(11,1,1) = {"
JP
wY
wY
wY
wY
wY
wY
wY
wY
wY
wY
wY
wY
wY
wY
wY
wY
wY
wY
wY
wY
wY
Bf
Wp
Ge
Fn
Ge
sx
sr
JP
JP
JP
JP
JP
JP
JP
JP
JP
JP
JP
JP
JP
JP
JP
JP
JP
JP
JP
JP
JP
JP
JP
JP
JP
JP
JP
JP
JP
JP
JP
"}
(12,1,1) = {"
wY
wY
wY
wY
wY
wY
wY
wY
wY
wY
wY
wY
wY
wY
wY
wY
wY
wY
wY
wY
wY
Bf
ME
xy
aP
se
Bf
sx
sr
JP
JP
JP
JP
JP
JP
wY
wY
LK
wY
JP
JP
JP
JP
JP
JP
JP
JP
JP
JP
JP
JP
JP
JP
JP
JP
JP
JP
JP
JP
JP
"}
(13,1,1) = {"
wY
wY
wY
wY
wY
wY
wY
wY
wY
wY
wY
wY
wY
wY
wY
wY
wY
wY
wY
wY
wY
Wp
Ge
se
SO
sD
sx
sr
JP
JP
JP
JP
JP
JP
JP
wY
wY
wY
wY
JP
JP
JP
JP
JP
JP
JP
JP
JP
JP
JP
JP
JP
JP
JP
JP
JP
JP
JP
JP
JP
"}
(14,1,1) = {"
wY
wY
wY
wY
wY
wY
wY
wY
wY
wY
wY
wY
wY
wY
wY
wY
wY
wY
wY
wY
Bf
Bf
Bf
RO
Bf
Bf
sx
sr
JP
JP
JP
JP
JP
JP
JP
wY
LK
wY
wY
wY
JP
JP
JP
JP
JP
JP
JP
JP
JP
JP
JP
JP
JP
JP
JP
JP
JP
JP
JP
JP
"}
(15,1,1) = {"
wY
wY
wY
wY
wY
wY
wY
wY
wY
wY
wY
wY
wY
wY
wY
wY
wY
wY
wY
Bf
Wp
Bf
tP
Dh
ve
mP
Bf
Bf
Bf
JP
JP
JP
JP
JP
JP
JP
JP
wY
wY
wY
JP
JP
wY
JP
JP
JP
JP
JP
JP
JP
JP
JP
JP
JP
JP
JP
JP
JP
JP
JP
"}
(16,1,1) = {"
wY
wY
wY
wY
wY
wY
wY
wY
wY
wY
wY
wY
wY
wY
wY
wY
wY
wY
wY
Wp
fA
Bf
oB
Wv
kN
dL
Bf
kN
Bf
Bf
Bf
Bf
Bf
Bf
JP
JP
JP
JP
JP
JP
JP
JP
JP
JP
JP
JP
JP
JP
JP
JP
JP
JP
JP
JP
JP
JP
JP
JP
JP
JP
"}
(17,1,1) = {"
wY
wY
wY
wY
wY
wY
wY
wY
wY
wY
wY
wY
wY
wY
wY
wY
wY
Bf
ME
ma
Vy
kf
xe
Vy
Vy
Pz
kf
kN
sK
cc
Bf
VR
Jd
Bf
sx
sr
JP
JP
JP
JP
JP
JP
JP
JP
JP
JP
JP
JP
JP
JP
JP
JP
JP
wY
JP
JP
JP
JP
JP
JP
"}
(18,1,1) = {"
wY
wY
wY
wY
wY
wY
wY
wY
wY
wY
wY
wY
wY
wY
wY
wY
wY
wY
Wp
Vy
Vy
bQ
Vy
Vy
Vy
yl
dO
kN
kN
Fc
Bf
kN
Mn
Xe
sx
sr
JP
JP
JP
JP
JP
JP
JP
JP
JP
JP
wY
JP
JP
JP
JP
JP
JP
JP
JP
JP
JP
JP
JP
JP
"}
(19,1,1) = {"
wY
wY
wY
wY
wY
wY
wY
wY
wY
wY
wY
wY
wY
wY
wY
wY
wY
Cl
Wp
Wp
XV
tH
kN
Vy
Vy
Mq
Vy
Vy
kN
kN
LC
Sl
jA
kN
Bm
Mk
JP
JP
JP
JP
JP
JP
JP
JP
JP
JP
JP
JP
JP
JP
JP
JP
JP
JP
JP
JP
JP
JP
JP
JP
"}
(20,1,1) = {"
wY
wY
wY
wY
wY
wY
wY
wY
wY
wY
wY
wY
wY
wY
wY
wY
wY
wY
Wp
Vy
Vy
aW
Vy
fA
JP
Yr
Wy
fA
Vy
kN
Vy
Vy
kN
Xe
sx
sr
JP
JP
JP
JP
JP
JP
JP
JP
JP
JP
JP
JP
JP
JP
JP
JP
JP
JP
JP
JP
JP
JP
JP
JP
"}
(21,1,1) = {"
wY
wY
wY
wY
wY
wY
wY
wY
wY
wY
wY
wY
wY
wY
wY
wY
wY
Bf
kP
ma
Vy
aW
Di
JP
JP
JP
Yr
Yr
Ge
Vy
Yr
Vy
mj
Bf
sx
sr
JP
JP
JP
JP
JP
JP
JP
JP
JP
JP
JP
JP
JP
JP
JP
JP
JP
JP
JP
JP
JP
JP
JP
JP
"}
(22,1,1) = {"
wY
wY
wY
wY
wY
wY
wY
wY
wY
wY
wY
wY
wY
wY
wY
wY
wY
wY
Bf
Wp
Yr
Bf
iD
Yr
JP
JP
JP
Wy
Vy
Yr
Yr
Yr
Vy
Bf
JP
JP
JP
JP
JP
JP
JP
JP
JP
JP
JP
JP
JP
JP
JP
JP
JP
JP
JP
JP
JP
JP
JP
JP
JP
JP
"}
(23,1,1) = {"
wY
wY
wY
wY
wY
wY
wY
wY
wY
wY
wY
wY
wY
wY
wY
wY
wY
wY
wY
wY
wY
Bf
qI
Yr
JP
JP
JP
Yr
JP
JP
JP
JP
JP
JP
JP
JP
JP
JP
JP
JP
JP
JP
JP
JP
JP
JP
JP
JP
JP
JP
JP
JP
JP
JP
JP
JP
JP
JP
JP
wY
"}
(24,1,1) = {"
wY
wY
wY
wY
wY
wY
wY
wY
wY
wY
wY
wY
wY
wY
wY
wY
wY
wY
wY
wY
Bf
Wp
Bf
JP
Yr
Yr
JP
JP
JP
JP
JP
JP
JP
JP
JP
JP
JP
JP
JP
wY
LK
wY
JP
JP
JP
JP
JP
JP
JP
JP
JP
JP
JP
JP
JP
JP
JP
JP
JP
JP
"}
(25,1,1) = {"
wY
wY
wY
wY
wY
wY
wY
wY
wY
wY
wY
wY
wY
wY
wY
wY
wY
wY
wY
wY
wY
wY
xy
Vy
Vy
Vy
sx
sr
JP
JP
JP
LK
wY
wY
JP
JP
JP
wY
wY
wY
wY
wY
JP
JP
JP
JP
JP
JP
JP
JP
JP
JP
JP
JP
JP
JP
JP
JP
JP
JP
"}
(26,1,1) = {"
JP
JP
wY
wY
wY
wY
wY
wY
wY
wY
wY
wY
wY
wY
wY
wY
wY
wY
wY
wY
wY
Bf
Wp
Yr
iJ
xy
Bf
sx
sr
JP
JP
wY
wY
wY
JP
JP
JP
wY
LK
wY
wY
JP
JP
JP
JP
JP
JP
JP
wY
JP
JP
JP
JP
JP
JP
JP
JP
JP
JP
JP
"}
(27,1,1) = {"
JP
JP
wY
wY
wY
wY
wY
wY
wY
wY
wY
wY
wY
wY
wY
wY
wY
wY
wY
wY
wY
wY
Bf
Wp
on
DU
Wp
sx
sr
JP
JP
wY
wY
wY
wY
JP
JP
wY
wY
wY
wY
JP
JP
JP
JP
JP
JP
JP
JP
JP
JP
JP
JP
JP
JP
JP
JP
JP
JP
JP
"}
(28,1,1) = {"
JP
JP
JP
wY
wY
wY
wY
wY
wY
wY
wY
wY
wY
wY
wY
wY
wY
wY
wY
wY
wY
wY
wY
wY
Bf
wY
wY
Bf
wY
Bf
JP
JP
JP
wY
wY
JP
JP
JP
JP
JP
JP
JP
JP
JP
JP
JP
JP
JP
JP
JP
JP
JP
JP
JP
JP
JP
wY
JP
JP
JP
"}
(29,1,1) = {"
JP
JP
JP
wY
wY
wY
wY
wY
wY
wY
wY
wY
wY
wY
wY
wY
wY
wY
wY
wY
wY
wY
wY
wY
wY
wY
wY
wY
wY
wY
LK
LK
JP
JP
JP
JP
JP
JP
JP
JP
JP
JP
JP
JP
JP
JP
JP
JP
JP
JP
JP
JP
JP
JP
JP
JP
JP
JP
JP
JP
"}
(30,1,1) = {"
JP
JP
JP
JP
JP
JP
wY
wY
wY
wY
wY
wY
wY
wY
wY
wY
wY
wY
wY
wY
wY
wY
wY
wY
wY
wY
wY
wY
wY
wY
wY
wY
wY
wY
JP
JP
JP
JP
JP
JP
JP
JP
JP
JP
JP
JP
JP
JP
JP
JP
JP
JP
JP
JP
JP
JP
JP
JP
JP
JP
"}
(31,1,1) = {"
JP
JP
JP
JP
JP
JP
JP
JP
JP
JP
JP
JP
JP
wY
wY
wY
wY
wY
wY
wY
wY
wY
wY
wY
wY
wY
wY
wY
wY
wY
wY
wY
wY
wY
wY
JP
JP
JP
JP
JP
JP
JP
JP
JP
JP
JP
JP
JP
JP
JP
JP
JP
JP
JP
JP
JP
JP
JP
JP
JP
"}
(32,1,1) = {"
JP
JP
JP
JP
JP
JP
JP
JP
JP
JP
JP
JP
JP
JP
wY
wY
wY
wY
wY
wY
wY
wY
wY
wY
wY
wY
wY
wY
wY
wY
wY
wY
wY
wY
wY
JP
JP
JP
JP
JP
JP
JP
JP
JP
JP
JP
JP
JP
JP
JP
JP
JP
JP
JP
JP
JP
JP
JP
JP
JP
"}
(33,1,1) = {"
JP
JP
JP
JP
JP
JP
JP
JP
JP
JP
JP
JP
JP
JP
JP
JP
JP
JP
wY
wY
wY
wY
wY
wY
wY
wY
wY
wY
wY
wY
wY
wY
wY
wY
JP
JP
JP
JP
JP
JP
JP
JP
JP
JP
JP
JP
JP
JP
wY
wY
wY
JP
JP
JP
JP
JP
JP
JP
JP
JP
"}
(34,1,1) = {"
JP
JP
JP
JP
JP
JP
JP
JP
JP
JP
JP
JP
JP
JP
JP
JP
JP
JP
JP
JP
JP
JP
JP
JP
wY
wY
wY
wY
wY
wY
wY
wY
JP
JP
JP
JP
JP
JP
JP
JP
JP
JP
JP
JP
JP
JP
JP
Wp
wY
LK
wY
wY
JP
JP
JP
JP
JP
JP
JP
JP
"}
(35,1,1) = {"
JP
JP
JP
JP
JP
JP
JP
JP
JP
JP
JP
JP
JP
JP
JP
JP
JP
JP
JP
JP
JP
JP
JP
JP
JP
JP
JP
JP
JP
JP
JP
JP
JP
JP
JP
JP
JP
JP
JP
JP
JP
JP
JP
JP
JP
JP
JP
wY
wY
wY
wY
wY
JP
JP
JP
JP
JP
JP
JP
JP
"}
(36,1,1) = {"
JP
JP
JP
JP
JP
JP
JP
JP
JP
JP
JP
JP
JP
JP
JP
JP
JP
JP
JP
JP
JP
JP
JP
JP
JP
JP
JP
JP
JP
JP
JP
JP
JP
JP
JP
JP
JP
JP
JP
JP
JP
JP
JP
JP
JP
JP
JP
JP
wY
wY
wY
Wp
JP
JP
JP
JP
JP
JP
JP
JP
"}
