//MAP CONVERTED BY dmm2tgm.py THIS HEADER COMMENT PREVENTS RECONVERSION, DO NOT REMOVE
"ae" = (
/obj/machinery/airalarm/directional/north,
/turf/template_noop,
/area/template_noop)
"au" = (
/obj/structure/closet/secure_closet/personal/cabinet,
/obj/item/clothing/under/rank/centcom/officer,
/obj/item/clothing/under/rank/centcom/officer_skirt,
/obj/item/clothing/under/rank/centcom/intern,
/obj/item/clothing/under/rank/centcom/commander,
/obj/item/clothing/under/rank/centcom/centcom_skirt,
/obj/item/clothing/head/hats/centcom_cap,
/obj/item/clothing/suit/hooded/wintercoat/centcom/nt_consultant,
/obj/item/clothing/head/hats/centhat,
/obj/item/radio/headset/heads/nanotrasen_consultant/alt,
/obj/item/clothing/glasses/sunglasses,
/obj/item/clothing/suit/armor/centcom_formal/nt_consultant,
/obj/item/clothing/suit/armor/centcom_formal,
/obj/effect/turf_decal/siding/wood{
	dir = 1
	},
/turf/open/floor/wood,
/area/station/command/heads_quarters/nt_rep)
"aU" = (
/obj/machinery/requests_console/directional/west{
	name = "Nanotrasen Consultant's Requests Console";
	department = "Nanotrasen Consultant"
	},
/turf/open/floor/carpet/green,
/area/station/command/heads_quarters/nt_rep)
"bD" = (
/obj/structure/closet/secure_closet/nanotrasen_consultant,
/obj/item/clothing/accessory/medal/silver/bureaucracy,
/obj/item/clothing/accessory/medal/gold/nanotrasen_consultant,
/obj/item/clothing/accessory/medal/gold/ordom,
/obj/effect/turf_decal/siding/wood{
	dir = 1
	},
/obj/item/storage/briefcase/central_command,
/obj/machinery/light/directional/west,
/turf/open/floor/wood,
/area/station/command/heads_quarters/nt_rep)
"ca" = (
/obj/structure/table/wood,
/obj/item/folder/blue{
	pixel_y = -2;
	pixel_x = -2
	},
/obj/item/pen/fourcolor{
	pixel_y = -2;
	pixel_x = -5
	},
/turf/open/floor/carpet/green,
/area/station/command/heads_quarters/nt_rep)
"cP" = (
/obj/machinery/atmospherics/pipe/smart/manifold4w/scrubbers/hidden/layer2,
/obj/machinery/atmospherics/pipe/smart/manifold4w/supply/hidden/layer4,
/obj/structure/cable,
/obj/machinery/light/directional/south,
/obj/structure/extinguisher_cabinet/directional/south,
/turf/open/floor/wood,
/area/station/command/heads_quarters/nt_rep)
"eD" = (
/obj/structure/cable,
/obj/structure/disposalpipe/segment{
	dir = 4
	},
/turf/open/floor/plating/rust,
/area/station/maintenance/fore/lesser)
"gh" = (
/obj/effect/decal/cleanable/dirt,
/obj/item/radio/intercom/directional/west,
/turf/open/floor/iron,
/area/station/maintenance/hallway/abandoned_command)
"ii" = (
/obj/structure/cable,
/obj/machinery/door/airlock{
	name = "Maintenance"
	},
/obj/effect/mapping_helpers/airlock/access/any/command/maintenance,
/obj/effect/mapping_helpers/airlock/unres{
	dir = 8
	},
/obj/structure/disposalpipe/segment{
	dir = 4
	},
/turf/open/floor/plating,
/area/station/maintenance/fore/lesser)
"ix" = (
/obj/machinery/atmospherics/pipe/smart/manifold4w/scrubbers/hidden/layer2,
/obj/machinery/atmospherics/pipe/smart/manifold4w/supply/hidden/layer4,
/obj/structure/cable,
/obj/machinery/light_switch/directional/south,
/turf/open/floor/wood,
/area/station/command/heads_quarters/nt_rep)
"iC" = (
/obj/effect/mapping_helpers/broken_floor,
/obj/structure/cable,
/obj/structure/disposalpipe/segment{
	dir = 10
	},
/turf/open/floor/iron,
/area/station/maintenance/hallway/abandoned_command)
"iD" = (
/obj/structure/disposalpipe/segment{
	dir = 4
	},
/obj/structure/cable,
/obj/effect/spawner/random/trash,
/turf/open/floor/plating,
/area/station/maintenance/fore/lesser)
"iS" = (
/obj/structure/disposalpipe/segment{
	dir = 5
	},
/obj/structure/cable,
/obj/effect/mapping_helpers/broken_floor,
/turf/open/floor/plating,
/area/station/maintenance/fore/lesser)
"jh" = (
/obj/machinery/atmospherics/pipe/smart/manifold4w/supply/hidden/layer4,
/obj/effect/turf_decal/siding/wood{
	dir = 8
	},
/turf/open/floor/wood,
/area/station/command/heads_quarters/nt_rep)
"lJ" = (
/obj/machinery/power/apc/auto_name/directional/north,
/obj/structure/cable,
/obj/structure/disposalpipe/segment{
	dir = 4
	},
/turf/open/floor/plating,
/area/station/maintenance/fore/lesser)
"nh" = (
/obj/structure/chair/office/tactical{
	dir = 4
	},
/obj/effect/landmark/start/nanotrasen_consultant,
/obj/structure/sign/flag/nanotrasen/directional/west,
/turf/open/floor/carpet/green,
/area/station/command/heads_quarters/nt_rep)
"nw" = (
/turf/template_noop,
/area/template_noop)
"nM" = (
/obj/structure/cable,
/obj/structure/disposalpipe/segment{
	dir = 4
	},
/turf/open/floor/plating,
/area/station/maintenance/fore/lesser)
"pV" = (
/obj/machinery/atmospherics/components/unary/vent_pump/on/layer4{
	dir = 1
	},
/obj/machinery/camera/autoname/directional/east,
/obj/effect/turf_decal/siding/wood{
	dir = 8
	},
/turf/open/floor/wood,
/area/station/command/heads_quarters/nt_rep)
"rA" = (
/obj/structure/table/wood,
/obj/item/stamp/centcom{
	pixel_x = -8;
	pixel_y = 8
	},
/obj/item/stamp/denied{
	pixel_x = -8;
	pixel_y = 4
	},
/obj/item/stamp{
	pixel_x = -8
	},
/obj/item/paper_bin{
	pixel_y = 4;
	pixel_x = 4
	},
/obj/item/pen/fountain{
	pixel_x = 4;
	pixel_y = 4
	},
/obj/item/radio/intercom/directional/north,
/turf/open/floor/carpet/green,
/area/station/command/heads_quarters/nt_rep)
"sZ" = (
/turf/closed/wall/r_wall,
/area/station/command/heads_quarters/nt_rep)
"ti" = (
/obj/item/kirbyplants/random,
/obj/machinery/light_switch/directional/north,
/turf/open/floor/wood,
/area/station/command/heads_quarters/nt_rep)
"vK" = (
/obj/machinery/vending/boozeomat/all_access,
/turf/closed/wall/r_wall,
/area/station/command/heads_quarters/nt_rep)
"wx" = (
/obj/structure/cable,
/turf/open/floor/plating,
/area/station/maintenance/fore/lesser)
"xH" = (
/obj/machinery/button/door/directional/west{
	id = "nt_rep_priv";
	name = "Privacy Shutters Control"
	},
/obj/machinery/modular_computer/preset/command,
/obj/structure/sign/calendar/directional/north,
/obj/machinery/light/directional/west,
/turf/open/floor/carpet/green,
/area/station/command/heads_quarters/nt_rep)
"xL" = (
/obj/machinery/atmospherics/pipe/smart/manifold4w/supply/hidden/layer4,
/obj/structure/cable,
/turf/open/floor/wood,
/area/station/command/heads_quarters/nt_rep)
"yC" = (
/turf/open/floor/carpet/green,
/area/station/command/heads_quarters/nt_rep)
"Ab" = (
/obj/item/toy/crayon/white{
	pixel_y = -10;
	pixel_x = 10
	},
/turf/closed/wall/r_wall,
/area/station/command/heads_quarters/nt_rep)
"Bv" = (
/obj/effect/spawner/structure/window/reinforced,
/obj/machinery/door/poddoor/shutters/preopen{
	id = "nt_rep_priv";
	name = "Privacy Shutters"
	},
/obj/structure/cable,
/turf/open/floor/plating,
/area/station/command/heads_quarters/nt_rep)
"Bw" = (
/obj/structure/extinguisher_cabinet/directional/west,
/obj/structure/disposalpipe/segment,
/obj/machinery/atmospherics/components/unary/vent_scrubber/on/layer2{
	dir = 4
	},
/turf/open/floor/plating,
/area/station/maintenance/hallway/abandoned_command)
"Dp" = (
/obj/structure/reagent_dispensers/fueltank,
/turf/open/floor/plating,
/area/station/maintenance/fore/lesser)
"Ds" = (
/obj/machinery/door/airlock/maintenance,
/obj/effect/mapping_helpers/airlock/access/all/command/captain,
/obj/effect/mapping_helpers/airlock/locked,
/obj/machinery/door/firedoor,
/obj/structure/cable,
/turf/open/floor/plating,
/area/station/maintenance/fore/lesser)
"Et" = (
/obj/machinery/door/airlock/corporate{
	name = "Nanotrasen Consultant's Office"
	},
/obj/machinery/door/firedoor,
/obj/machinery/atmospherics/pipe/smart/manifold4w/scrubbers/hidden/layer2,
/obj/machinery/atmospherics/pipe/smart/manifold4w/supply/hidden/layer4,
/obj/structure/cable,
/obj/effect/mapping_helpers/airlock/access/all/cent_com/rep_door,
/obj/effect/turf_decal/siding/wood{
	dir = 8
	},
/obj/effect/mapping_helpers/airlock/unres{
	dir = 8
	},
/obj/effect/landmark/navigate_destination/autoname,
/turf/open/floor/iron/dark/textured_large,
/area/station/command/heads_quarters/nt_rep)
"EK" = (
/obj/machinery/atmospherics/components/unary/vent_scrubber/on/layer2,
/obj/machinery/newscaster/directional/north,
/obj/structure/table/wood/fancy/green,
/obj/item/statuebust{
	pixel_y = 8
	},
/turf/open/floor/wood,
/area/station/command/heads_quarters/nt_rep)
"FF" = (
/obj/structure/cable,
/turf/template_noop,
/area/station/command/heads_quarters/captain/private)
"FO" = (
/obj/effect/mapping_helpers/broken_floor,
/obj/machinery/atmospherics/pipe/smart/manifold4w/scrubbers/hidden/layer2,
/obj/machinery/atmospherics/pipe/smart/manifold4w/supply/hidden/layer4,
/obj/structure/cable,
/turf/open/floor/iron,
/area/station/maintenance/hallway/abandoned_command)
"Ht" = (
/obj/effect/spawner/random/maintenance,
/obj/structure/reagent_dispensers/watertank,
/turf/open/floor/plating/rust,
/area/station/maintenance/fore/lesser)
"HH" = (
/obj/structure/cable,
/obj/structure/displaycase/captain{
	pixel_y = 5
	},
/turf/open/floor/iron/dark/small,
/area/station/command/heads_quarters/captain/private)
"Ll" = (
/obj/effect/turf_decal/siding/wood{
	dir = 8
	},
/turf/open/floor/wood,
/area/station/command/heads_quarters/nt_rep)
"Nt" = (
/turf/open/floor/iron,
/area/station/maintenance/hallway/abandoned_command)
"OS" = (
/obj/structure/table/wood,
/obj/machinery/fax{
	fax_name = "Nanotrasen Consultant's Office";
	name = "Nanotrasen Consultant's Fax Machine"
	},
/obj/effect/turf_decal/siding/wood{
	dir = 1
	},
/obj/machinery/firealarm/directional/south,
/turf/open/floor/wood,
/area/station/command/heads_quarters/nt_rep)
"Pd" = (
/obj/structure/disposalpipe/segment{
	dir = 5
	},
/turf/open/floor/plating,
/area/station/maintenance/hallway/abandoned_command)
"Pf" = (
/turf/closed/wall/r_wall,
/area/station/maintenance/hallway/abandoned_command)
"QJ" = (
/obj/structure/disposalpipe/segment{
	dir = 4
	},
/obj/structure/cable,
/turf/open/floor/plating,
/area/station/maintenance/fore/lesser)
"Rb" = (
/obj/machinery/power/apc/auto_name/directional/north,
/obj/structure/cable,
/obj/machinery/photocopier,
/turf/open/floor/wood,
/area/station/command/heads_quarters/nt_rep)
"Rk" = (
/obj/structure/chalkboard,
/turf/closed/wall/r_wall,
/area/station/command/heads_quarters/nt_rep)
"TT" = (
/obj/structure/filingcabinet/medical{
	pixel_x = -10;
	icon_state = "employmentcabinet"
	},
/obj/structure/filingcabinet/employment,
/obj/structure/filingcabinet/security{
	pixel_x = 10;
	icon_state = "employmentcabinet"
	},
/obj/effect/turf_decal/siding/wood/corner{
	dir = 1
	},
/turf/open/floor/wood,
/area/station/command/heads_quarters/nt_rep)
"VM" = (
/obj/structure/chair/comfy/black{
	dir = 8
	},
/turf/open/floor/carpet/green,
/area/station/command/heads_quarters/nt_rep)
"Yp" = (
/turf/closed/wall/r_wall,
/area/station/maintenance/fore/lesser)
"Zf" = (
/obj/structure/hedge,
/obj/machinery/camera/autoname/directional/east,
/obj/structure/cable,
/turf/open/floor/iron/dark/small,
/area/station/command/heads_quarters/captain/private)
"ZQ" = (
/obj/effect/spawner/random/structure/crate_abandoned,
/turf/open/floor/plating,
/area/station/maintenance/fore/lesser)

(1,1,1) = {"
iS
wx
Ds
HH
FF
nw
"}
(2,1,1) = {"
QJ
Ht
Yp
nw
FF
nw
"}
(3,1,1) = {"
QJ
Dp
Yp
ae
FF
FF
"}
(4,1,1) = {"
eD
ZQ
Yp
nw
nw
Zf
"}
(5,1,1) = {"
QJ
sZ
sZ
sZ
sZ
sZ
"}
(6,1,1) = {"
QJ
sZ
xH
nh
aU
bD
"}
(7,1,1) = {"
lJ
sZ
rA
ca
yC
au
"}
(8,1,1) = {"
nM
Rk
VM
VM
yC
OS
"}
(9,1,1) = {"
iD
Ab
Ll
jh
pV
TT
"}
(10,1,1) = {"
QJ
sZ
Rb
xL
vK
sZ
"}
(11,1,1) = {"
nM
sZ
EK
cP
sZ
nw
"}
(12,1,1) = {"
eD
sZ
ti
ix
sZ
nw
"}
(13,1,1) = {"
ii
sZ
Bv
Et
sZ
Pf
"}
(14,1,1) = {"
iC
Bw
Pd
FO
Nt
gh
"}
