//MAP CONVERTED BY dmm2tgm.py THIS HEADER COMMENT PREVENTS RECONVERSION, DO NOT REMOVE
"a" = (
/turf/closed/wall,
/area/station/command/heads_quarters/nt_rep)
"c" = (
/obj/machinery/newscaster/directional/south,
/obj/item/radio/intercom/directional/west,
/obj/item/kirbyplants/random,
/turf/open/floor/wood,
/area/station/command/heads_quarters/nt_rep)
"e" = (
/obj/structure/closet/secure_closet/nanotrasen_consultant,
/obj/item/clothing/accessory/medal/silver/bureaucracy,
/obj/item/clothing/accessory/medal/gold/nanotrasen_consultant,
/obj/item/clothing/accessory/medal/gold/ordom,
/turf/open/floor/carpet/green,
/area/station/command/heads_quarters/nt_rep)
"f" = (
/obj/effect/spawner/structure/window/reinforced,
/obj/structure/cable,
/obj/machinery/door/poddoor/shutters/preopen{
	id = "nt_rep_priv";
	name = "Privacy Shutters"
	},
/turf/open/floor/plating,
/area/station/command/heads_quarters/nt_rep)
"g" = (
/obj/machinery/firealarm/directional/north,
/obj/machinery/fax{
	fax_name = "Nanotrasen Consultant's Office";
	name = "Nanotrasen Consultant's Fax Machine"
	},
/obj/structure/table/wood,
/turf/open/floor/carpet/green,
/area/station/command/heads_quarters/nt_rep)
"h" = (
/obj/structure/chair/office/tactical,
/obj/effect/landmark/start/nanotrasen_consultant,
/turf/open/floor/carpet/green,
/area/station/command/heads_quarters/nt_rep)
"i" = (
/obj/structure/cable,
/obj/machinery/power/apc/auto_name/directional/north,
/obj/structure/chair/comfy/black{
	dir = 4
	},
/obj/effect/landmark/start/nanotrasen_consultant,
/turf/open/floor/carpet/green,
/area/station/command/heads_quarters/nt_rep)
"j" = (
/obj/effect/turf_decal/siding/wood{
	dir = 1
	},
/turf/open/floor/wood,
/area/station/command/heads_quarters/nt_rep)
"k" = (
/obj/machinery/atmospherics/pipe/smart/manifold4w/supply/hidden/layer4,
/obj/structure/cable,
/turf/open/floor/wood,
/area/station/command/heads_quarters/nt_rep)
"l" = (
/obj/structure/cable,
/obj/effect/turf_decal/siding/wood{
	dir = 1
	},
/obj/effect/turf_decal/siding/wood{
	dir = 8
	},
/turf/open/floor/wood,
/area/station/command/heads_quarters/nt_rep)
"m" = (
/obj/effect/turf_decal/siding/wood{
	dir = 4
	},
/obj/effect/turf_decal/siding/wood{
	dir = 8
	},
/obj/machinery/vending/boozeomat/all_access,
/turf/open/floor/wood,
/area/station/command/heads_quarters/nt_rep)
"n" = (
/obj/machinery/atmospherics/components/unary/vent_scrubber/on/layer2{
	dir = 4
	},
/obj/effect/turf_decal/siding/wood{
	dir = 1
	},
/turf/open/floor/wood,
/area/station/command/heads_quarters/nt_rep)
"o" = (
/obj/structure/cable,
/obj/structure/chair/comfy/black{
	dir = 4
	},
/obj/effect/turf_decal/siding/wood/corner{
	dir = 8
	},
/obj/effect/landmark/start/nanotrasen_consultant,
/turf/open/floor/carpet/green,
/area/station/command/heads_quarters/nt_rep)
"p" = (
/obj/machinery/requests_console/directional/west{
	name = "Nanotrasen Consultant's Requests Console";
	department = "Nanotrasen Consultant"
	},
/obj/machinery/button/door/directional/east{
	pixel_y = 24;
	id = "nt_rep_priv";
	name = "Privacy Shutters Control";
	pixel_x = -24
	},
/turf/open/floor/carpet/green,
/area/station/command/heads_quarters/nt_rep)
"q" = (
/obj/structure/table/wood,
/obj/item/storage/fancy/cigarettes/cigars/cohiba{
	pixel_x = 4;
	pixel_y = 3
	},
/obj/item/lighter{
	pixel_x = 5
	},
/turf/open/floor/carpet/green,
/area/station/command/heads_quarters/nt_rep)
"r" = (
/obj/structure/cable,
/obj/machinery/door/airlock/corporate{
	name = "Nanotrasen Consultant's Office"
	},
/obj/machinery/atmospherics/pipe/smart/manifold4w/scrubbers/hidden/layer2,
/obj/machinery/atmospherics/pipe/smart/manifold4w/supply/hidden/layer4,
/obj/machinery/door/firedoor,
/obj/effect/mapping_helpers/airlock/access/all/cent_com/rep_door,
/obj/effect/landmark/navigate_destination/autoname,
/obj/effect/mapping_helpers/airlock/unres{
	dir = 1
	},
/turf/open/floor/iron/dark/textured_large,
/area/station/command/heads_quarters/nt_rep)
"s" = (
/obj/machinery/modular_computer/preset/command{
	dir = 1
	},
/turf/open/floor/carpet/green,
/area/station/command/heads_quarters/nt_rep)
"t" = (
/obj/effect/turf_decal/siding/wood{
	dir = 1
	},
/obj/machinery/atmospherics/pipe/smart/manifold4w/supply/hidden/layer4,
/turf/open/floor/wood,
/area/station/command/heads_quarters/nt_rep)
"u" = (
/obj/structure/table/wood,
/obj/item/stamp/centcom{
	pixel_x = -8;
	pixel_y = 8
	},
/obj/item/stamp/denied{
	pixel_x = -8;
	pixel_y = 4
	},
/obj/item/stamp{
	pixel_x = -8
	},
/obj/item/paper_bin{
	pixel_y = 4;
	pixel_x = 4
	},
/obj/item/pen/fountain{
	pixel_x = 4;
	pixel_y = 4
	},
/turf/open/floor/carpet/green,
/area/station/command/heads_quarters/nt_rep)
"v" = (
/obj/machinery/airalarm/directional/north,
/obj/structure/filingcabinet/medical{
	pixel_x = -10;
	icon_state = "employmentcabinet"
	},
/obj/structure/filingcabinet/employment,
/obj/structure/filingcabinet/security{
	pixel_x = 10;
	icon_state = "employmentcabinet"
	},
/turf/open/floor/carpet/green,
/area/station/command/heads_quarters/nt_rep)
"w" = (
/obj/item/radio/intercom/directional/east,
/obj/effect/turf_decal/siding/wood{
	dir = 1
	},
/turf/open/floor/wood,
/area/station/command/heads_quarters/nt_rep)
"x" = (
/obj/machinery/atmospherics/pipe/smart/manifold4w/supply/hidden/layer4,
/obj/effect/turf_decal/siding/wood{
	dir = 1
	},
/obj/effect/turf_decal/siding/wood/corner{
	dir = 4
	},
/turf/open/floor/wood,
/area/station/command/heads_quarters/nt_rep)
"y" = (
/turf/open/floor/carpet/green,
/area/station/command/heads_quarters/nt_rep)
"A" = (
/obj/machinery/atmospherics/components/unary/vent_pump/on/layer4{
	dir = 8
	},
/turf/open/floor/wood,
/area/station/command/heads_quarters/nt_rep)
"B" = (
/turf/open/floor/wood,
/area/station/command/heads_quarters/nt_rep)
"C" = (
/obj/effect/turf_decal/siding/wood{
	dir = 4
	},
/obj/effect/turf_decal/siding/wood{
	dir = 8
	},
/obj/effect/turf_decal/siding/wood,
/turf/open/floor/wood,
/area/station/command/heads_quarters/nt_rep)
"E" = (
/obj/structure/table/wood,
/obj/item/storage/briefcase/central_command{
	pixel_y = 7
	},
/turf/open/floor/carpet/green,
/area/station/command/heads_quarters/nt_rep)
"F" = (
/obj/machinery/atmospherics/pipe/smart/manifold4w/supply/hidden/layer4,
/obj/machinery/light_switch/directional/south,
/obj/structure/bed/dogbed{
	name = "Lisa's bed"
	},
/mob/living/basic/pet/dog/corgi/lisa,
/obj/structure/cable,
/turf/open/floor/wood,
/area/station/command/heads_quarters/nt_rep)
"G" = (
/obj/effect/turf_decal/siding/wood{
	dir = 4
	},
/obj/structure/table/wood,
/obj/item/camera{
	pixel_x = 6;
	pixel_y = 3
	},
/obj/item/camera_film{
	pixel_x = -9;
	pixel_y = 2
	},
/obj/item/camera_film{
	pixel_x = -11;
	pixel_y = 6
	},
/turf/open/floor/carpet/green,
/area/station/command/heads_quarters/nt_rep)
"H" = (
/obj/machinery/light/warm/directional/west,
/obj/structure/sign/calendar/directional/west,
/obj/effect/turf_decal/siding/wood{
	dir = 1
	},
/turf/open/floor/wood,
/area/station/command/heads_quarters/nt_rep)
"J" = (
/obj/structure/closet/secure_closet/personal/cabinet,
/obj/item/clothing/under/rank/centcom/officer,
/obj/item/clothing/under/rank/centcom/officer_skirt,
/obj/item/clothing/under/rank/centcom/intern,
/obj/item/clothing/under/rank/centcom/commander,
/obj/item/clothing/under/rank/centcom/centcom_skirt,
/obj/item/clothing/head/hats/centcom_cap,
/obj/item/clothing/suit/hooded/wintercoat/centcom/nt_consultant,
/obj/item/clothing/head/hats/centhat,
/obj/item/radio/headset/heads/nanotrasen_consultant/alt,
/obj/item/clothing/glasses/sunglasses,
/obj/item/clothing/suit/armor/centcom_formal/nt_consultant,
/obj/item/clothing/suit/armor/centcom_formal,
/obj/machinery/light/warm/directional/north,
/obj/machinery/status_display/evac/directional/north,
/turf/open/floor/carpet/green,
/area/station/command/heads_quarters/nt_rep)
"K" = (
/obj/item/kirbyplants/random,
/turf/open/floor/wood,
/area/station/command/heads_quarters/nt_rep)
"M" = (
/obj/structure/cable,
/obj/machinery/atmospherics/pipe/smart/manifold4w/scrubbers/hidden/layer2,
/obj/machinery/atmospherics/pipe/smart/manifold4w/supply/hidden/layer4,
/turf/open/floor/wood,
/area/station/command/heads_quarters/nt_rep)
"N" = (
/obj/effect/turf_decal/siding/wood/corner,
/turf/open/floor/carpet/green,
/area/station/command/heads_quarters/nt_rep)
"O" = (
/obj/effect/turf_decal/siding/wood{
	dir = 1
	},
/obj/machinery/atmospherics/components/unary/vent_pump/on/layer4{
	dir = 4
	},
/obj/structure/chair/comfy/black{
	dir = 1
	},
/turf/open/floor/wood,
/area/station/command/heads_quarters/nt_rep)
"Q" = (
/obj/structure/cable,
/obj/machinery/atmospherics/pipe/smart/manifold4w/scrubbers/hidden/layer2,
/obj/machinery/atmospherics/pipe/smart/manifold4w/supply/hidden/layer4,
/obj/effect/turf_decal/siding/wood/corner{
	dir = 1
	},
/turf/open/floor/wood,
/area/station/command/heads_quarters/nt_rep)
"T" = (
/obj/structure/sign/clock/directional/east,
/obj/structure/chair/comfy/black{
	dir = 8
	},
/obj/effect/landmark/start/nanotrasen_consultant,
/turf/open/floor/carpet/green,
/area/station/command/heads_quarters/nt_rep)
"U" = (
/obj/machinery/status_display/ai/directional/east,
/obj/structure/chair/comfy/black{
	dir = 8
	},
/obj/effect/landmark/start/nanotrasen_consultant,
/turf/open/floor/carpet/green,
/area/station/command/heads_quarters/nt_rep)
"V" = (
/obj/machinery/light/warm/directional/east,
/obj/structure/extinguisher_cabinet/directional/east,
/obj/machinery/photocopier,
/turf/open/floor/wood,
/area/station/command/heads_quarters/nt_rep)
"W" = (
/obj/machinery/light/warm/directional/north,
/obj/structure/table/wood,
/obj/structure/sign/flag/nanotrasen/directional/north,
/obj/item/reagent_containers/cup/glass/bottle/champagne{
	pixel_y = 6;
	pixel_x = -5
	},
/turf/open/floor/carpet/green,
/area/station/command/heads_quarters/nt_rep)
"Z" = (
/obj/machinery/holopad,
/obj/effect/turf_decal/bot,
/turf/open/floor/iron/dark/textured_large,
/area/station/command/heads_quarters/nt_rep)

(1,1,1) = {"
a
a
a
a
a
a
a
"}
(2,1,1) = {"
a
e
p
u
H
c
a
"}
(3,1,1) = {"
a
J
h
s
O
B
f
"}
(4,1,1) = {"
a
v
y
E
t
B
f
"}
(5,1,1) = {"
a
g
N
G
x
k
f
"}
(6,1,1) = {"
a
m
C
Z
n
F
a
"}
(7,1,1) = {"
a
i
o
l
Q
M
r
"}
(8,1,1) = {"
a
W
q
j
A
B
f
"}
(9,1,1) = {"
a
T
U
w
V
K
a
"}
(10,1,1) = {"
a
a
a
a
a
a
a
"}
