//MAP CONVERTED BY dmm2tgm.py THIS HEADER COMMENT PREVENTS RECONVERSION, DO NOT REMOVE
"a" = (
/obj/effect/mob_spawn/corpse/human/miner/explorer,
/turf/open/misc/asteroid/snow/icemoon,
/area/icemoon/surface/outdoors/nospawn)
"c" = (
/obj/effect/turf_decal/stripes/white/line{
	dir = 9
	},
/turf/open/misc/asteroid/snow/icemoon,
/area/icemoon/surface/outdoors/nospawn)
"f" = (
/obj/structure/ore_vent/ghost_mining/snowland/ras,
/turf/open/misc/asteroid/snow/icemoon,
/area/icemoon/surface/outdoors/nospawn)
"j" = (
/obj/effect/turf_decal/stripes/white/line{
	dir = 8
	},
/turf/open/misc/asteroid/snow/icemoon,
/area/icemoon/surface/outdoors/nospawn)
"l" = (
/obj/effect/turf_decal/stripes/white/line{
	dir = 5
	},
/turf/open/misc/asteroid/snow/icemoon,
/area/icemoon/surface/outdoors/nospawn)
"n" = (
/obj/effect/turf_decal/stripes/white/line{
	dir = 6
	},
/turf/open/misc/asteroid/snow/icemoon,
/area/icemoon/surface/outdoors/nospawn)
"t" = (
/obj/effect/turf_decal/stripes/white/line{
	dir = 5
	},
/mob/living/basic/mining/wolf,
/turf/open/misc/asteroid/snow/icemoon,
/area/icemoon/surface/outdoors/nospawn)
"B" = (
/obj/structure/table/rolling,
/obj/item/flatpacked_machine/boulder_collector,
/turf/open/misc/asteroid/snow/icemoon,
/area/icemoon/surface/outdoors/nospawn)
"F" = (
/obj/effect/turf_decal/stripes/white/line{
	dir = 4
	},
/turf/open/misc/asteroid/snow/icemoon,
/area/icemoon/surface/outdoors/nospawn)
"K" = (
/obj/effect/turf_decal/stripes/white/line,
/turf/open/misc/asteroid/snow/icemoon,
/area/icemoon/surface/outdoors/nospawn)
"N" = (
/obj/effect/turf_decal/stripes/white/line{
	dir = 10
	},
/turf/open/misc/asteroid/snow/icemoon,
/area/icemoon/surface/outdoors/nospawn)
"O" = (
/obj/effect/turf_decal/stripes/white/line{
	dir = 9
	},
/mob/living/basic/mining/wolf,
/turf/open/misc/asteroid/snow/icemoon,
/area/icemoon/surface/outdoors/nospawn)
"P" = (
/mob/living/basic/mining/wolf,
/turf/open/misc/asteroid/snow/icemoon,
/area/icemoon/surface/outdoors/nospawn)
"R" = (
/turf/open/misc/asteroid/snow/icemoon,
/area/icemoon/surface/outdoors/nospawn)
"V" = (
/obj/effect/turf_decal/stripes/white/line{
	dir = 1
	},
/turf/open/misc/asteroid/snow/icemoon,
/area/icemoon/surface/outdoors/nospawn)

(1,1,1) = {"
n
j
j
j
j
j
j
j
l
"}
(2,1,1) = {"
V
R
B
R
R
R
R
R
K
"}
(3,1,1) = {"
V
R
n
j
j
j
t
R
K
"}
(4,1,1) = {"
V
R
V
R
R
R
K
R
K
"}
(5,1,1) = {"
V
R
V
R
f
R
K
R
K
"}
(6,1,1) = {"
V
R
V
P
R
a
K
R
K
"}
(7,1,1) = {"
V
R
N
F
F
F
O
R
K
"}
(8,1,1) = {"
V
R
R
R
R
R
R
R
K
"}
(9,1,1) = {"
N
F
F
F
F
F
F
F
c
"}
