//MAP CONVERTED BY dmm2tgm.py THIS HEADER COMMENT PREVENTS RECONVERSION, DO NOT REMOVE
"a" = (
/obj/item/trash/candle,
/turf/open/floor/plating/snowed/smoothed/icemoon,
/area/icemoon/underground/unexplored)
"c" = (
/obj/effect/decal/cleanable/blood/tracks{
	dir = 1
	},
/turf/open/misc/asteroid/snow/icemoon,
/area/icemoon/underground/unexplored)
"k" = (
/obj/effect/decal/cleanable/blood/gibs/up,
/turf/open/floor/plating/snowed/smoothed/icemoon,
/area/icemoon/underground/unexplored)
"s" = (
/obj/effect/decal/cleanable/blood/tracks,
/turf/open/misc/asteroid/snow/icemoon,
/area/icemoon/underground/unexplored)
"u" = (
/obj/effect/decal/cleanable/blood/tracks{
	dir = 9
	},
/turf/open/misc/asteroid/snow/icemoon,
/area/icemoon/underground/unexplored)
"x" = (
/obj/effect/decal/cleanable/blood/gibs/down,
/turf/open/floor/plating/snowed/smoothed/icemoon,
/area/icemoon/underground/unexplored)
"B" = (
/obj/effect/decal/cleanable/blood/tracks{
	dir = 4
	},
/turf/open/misc/asteroid/snow/icemoon,
/area/icemoon/underground/unexplored)
"E" = (
/obj/effect/decal/cleanable/blood/tracks{
	dir = 5
	},
/turf/open/misc/asteroid/snow/icemoon,
/area/icemoon/underground/unexplored)
"F" = (
/obj/effect/decal/cleanable/crayon/rune4,
/turf/open/floor/plating/snowed/smoothed/icemoon,
/area/icemoon/underground/unexplored)
"G" = (
/obj/effect/decal/cleanable/blood/tracks{
	dir = 10
	},
/turf/open/misc/asteroid/snow/icemoon,
/area/icemoon/underground/unexplored)
"K" = (
/obj/effect/decal/cleanable/blood/tracks{
	dir = 8
	},
/turf/open/misc/asteroid/snow/icemoon,
/area/icemoon/underground/unexplored)
"M" = (
/obj/effect/decal/cleanable/blood/tracks{
	dir = 6
	},
/turf/open/misc/asteroid/snow/icemoon,
/area/icemoon/underground/unexplored)
"O" = (
/turf/open/misc/asteroid/snow/icemoon,
/area/icemoon/underground/unexplored)
"S" = (
/turf/open/floor/plating/snowed/smoothed/icemoon,
/area/icemoon/underground/unexplored)
"U" = (
/obj/structure/ore_vent/ghost_mining/boss/icemoon,
/turf/open/misc/asteroid/snow/icemoon,
/area/icemoon/underground/unexplored)
"Y" = (
/obj/effect/decal/cleanable/blood/gibs/torso,
/turf/open/floor/plating/snowed/smoothed/icemoon,
/area/icemoon/underground/unexplored)
"Z" = (
/turf/template_noop,
/area/template_noop)

(1,1,1) = {"
Z
Z
O
O
O
O
O
O
O
Z
Z
"}
(2,1,1) = {"
Z
u
s
s
s
s
s
s
s
G
Z
"}
(3,1,1) = {"
O
K
S
S
a
S
F
S
S
B
O
"}
(4,1,1) = {"
O
K
F
u
c
c
c
G
a
B
O
"}
(5,1,1) = {"
O
K
S
B
S
S
x
K
S
B
O
"}
(6,1,1) = {"
O
K
a
B
k
U
S
K
F
B
O
"}
(7,1,1) = {"
O
K
S
B
S
Y
S
K
S
B
O
"}
(8,1,1) = {"
O
K
F
E
s
s
s
M
a
B
O
"}
(9,1,1) = {"
O
K
S
S
a
S
F
S
S
B
O
"}
(10,1,1) = {"
Z
E
c
c
c
c
c
c
c
M
Z
"}
(11,1,1) = {"
Z
Z
O
O
O
O
O
O
O
Z
Z
"}
