//MAP CONVERTED BY dmm2tgm.py THIS HEADER COMMENT PREVENTS RECONVERSION, DO NOT REMOVE
"a" = (
/turf/open/misc/asteroid/snow/icemoon,
/area/icemoon/underground/unexplored)
"g" = (
/turf/open/floor/plating/snowed/smoothed/icemoon,
/area/icemoon/underground/unexplored)
"p" = (
/obj/structure/ore_vent/ghost_mining/boss/elite/Icemoon,
/turf/open/misc/asteroid/snow/icemoon,
/area/icemoon/underground/unexplored)
"x" = (
/obj/effect/decal/cleanable/blood,
/turf/open/misc/asteroid/snow/icemoon,
/area/icemoon/underground/unexplored)
"y" = (
/obj/effect/decal/cleanable/blood/splatter,
/turf/open/misc/asteroid/snow/icemoon,
/area/icemoon/underground/unexplored)
"D" = (
/obj/effect/decal/cleanable/blood/tracks{
	dir = 1
	},
/turf/open/misc/asteroid/snow/icemoon,
/area/icemoon/underground/unexplored)
"F" = (
/obj/effect/decal/cleanable/blood/gibs/up,
/turf/open/floor/plating/snowed/smoothed/icemoon,
/area/icemoon/underground/unexplored)
"L" = (
/obj/effect/decal/cleanable/blood/gibs/body,
/turf/open/floor/plating/snowed/smoothed/icemoon,
/area/icemoon/underground/unexplored)
"M" = (
/obj/effect/decal/cleanable/blood/tracks{
	dir = 6
	},
/turf/open/floor/plating/snowed/smoothed/icemoon,
/area/icemoon/underground/unexplored)
"Q" = (
/obj/effect/decal/cleanable/blood/tracks{
	dir = 9
	},
/turf/open/floor/plating/snowed/smoothed/icemoon,
/area/icemoon/underground/unexplored)
"R" = (
/obj/effect/decal/cleanable/blood/gibs/core,
/turf/open/floor/plating/snowed/smoothed/icemoon,
/area/icemoon/underground/unexplored)
"S" = (
/obj/effect/decal/cleanable/blood/tracks{
	dir = 9
	},
/turf/open/misc/asteroid/snow/icemoon,
/area/icemoon/underground/unexplored)
"X" = (
/obj/effect/decal/cleanable/blood/tracks{
	dir = 6
	},
/turf/open/misc/asteroid/snow/icemoon,
/area/icemoon/underground/unexplored)
"Y" = (
/obj/effect/decal/cleanable/blood/gibs,
/turf/open/floor/plating/snowed/smoothed/icemoon,
/area/icemoon/underground/unexplored)

(1,1,1) = {"
a
y
a
S
X
"}
(2,1,1) = {"
a
R
Q
M
a
"}
(3,1,1) = {"
D
F
p
g
a
"}
(4,1,1) = {"
a
Y
g
L
a
"}
(5,1,1) = {"
a
x
a
a
y
"}
