//MAP CONVERTED BY dmm2tgm.py THIS HEADER COMMENT PREVENTS RECONVERSION, DO NOT REMOVE
"ad" = (
/obj/machinery/button/door/directional/west{
	id = "cargounload1";
	name = "Loading Doors";
	pixel_y = 8;
	pixel_x = 24
	},
/turf/open/floor/iron/dark/smooth_edge{
	dir = 4
	},
/area/shuttle/supply)
"ap" = (
/turf/open/floor/iron/dark/smooth_edge,
/area/shuttle/supply)
"bY" = (
/obj/effect/decal/cleanable/dirt,
/turf/open/floor/iron/dark/smooth_corner{
	dir = 1
	},
/area/shuttle/supply)
"cJ" = (
/obj/structure/railing{
	dir = 1
	},
/obj/effect/turf_decal/stripes/line{
	dir = 5
	},
/turf/open/floor/iron,
/area/shuttle/supply)
"cN" = (
/obj/structure/railing{
	dir = 8
	},
/obj/effect/decal/cleanable/dirt,
/turf/open/floor/iron/dark/smooth_edge{
	dir = 1
	},
/area/shuttle/supply)
"dc" = (
/obj/effect/turf_decal/delivery,
/obj/effect/decal/cleanable/dirt,
/turf/open/floor/iron/dark/smooth_edge{
	dir = 4
	},
/area/shuttle/supply)
"dY" = (
/obj/machinery/light/directional/east,
/turf/open/floor/iron/dark/smooth_edge{
	dir = 4
	},
/area/shuttle/supply)
"eA" = (
/obj/effect/turf_decal/stripes/line,
/obj/effect/turf_decal/delivery,
/obj/effect/decal/cleanable/dirt,
/turf/open/floor/iron,
/area/shuttle/supply)
"eB" = (
/obj/machinery/light/directional/east,
/turf/open/floor/iron/dark/smooth_corner{
	dir = 1
	},
/area/shuttle/supply)
"fx" = (
/obj/structure/railing,
/obj/effect/turf_decal/stripes/line{
	dir = 6
	},
/turf/open/floor/iron,
/area/shuttle/supply)
"gq" = (
/obj/effect/turf_decal/stripes/line,
/obj/effect/decal/cleanable/blood/oil,
/turf/open/floor/iron/edge{
	dir = 1
	},
/area/shuttle/supply)
"hq" = (
/obj/structure/gangway,
/turf/open/floor/iron/dark/textured_large,
/area/template_noop)
"hw" = (
/obj/machinery/light/directional/west,
/turf/open/floor/iron/dark/smooth_corner{
	dir = 4
	},
/area/shuttle/supply)
"hy" = (
/obj/structure/railing,
/obj/effect/turf_decal/stripes/line,
/obj/effect/turf_decal/delivery,
/obj/effect/decal/cleanable/dirt,
/turf/open/floor/iron/edge{
	dir = 1
	},
/area/shuttle/supply)
"hA" = (
/obj/effect/turf_decal/bot,
/obj/effect/decal/cleanable/dirt,
/obj/effect/decal/cleanable/dirt,
/turf/open/floor/iron/dark/textured_large,
/area/shuttle/supply)
"iz" = (
/obj/effect/turf_decal/stripes/line{
	dir = 1
	},
/obj/effect/decal/cleanable/blood/oil,
/turf/open/floor/iron,
/area/shuttle/supply)
"jM" = (
/obj/machinery/door/poddoor{
	id = "cargounload";
	name = "Supply Dock Unloading Door"
	},
/turf/open/floor/iron/dark/textured_large,
/area/shuttle/supply)
"kF" = (
/obj/machinery/door/poddoor{
	id = "cargoload1";
	name = "Supply Dock Loading Door"
	},
/turf/open/floor/iron/dark/textured_large,
/area/shuttle/supply)
"kR" = (
/turf/open/floor/iron/dark/smooth_edge{
	dir = 4
	},
/area/shuttle/supply)
"mM" = (
/obj/machinery/door/airlock/multi_tile/metal,
/obj/effect/mapping_helpers/airlock/access/all/supply/general,
/turf/open/floor/iron/dark/textured_large,
/area/shuttle/supply)
"mQ" = (
/obj/structure/railing{
	dir = 1
	},
/obj/effect/turf_decal/stripes/line{
	dir = 1
	},
/obj/effect/turf_decal/delivery,
/turf/open/floor/iron/edge,
/area/shuttle/supply)
"nk" = (
/obj/effect/turf_decal/stripes/line,
/obj/effect/turf_decal/delivery,
/turf/open/floor/iron,
/area/shuttle/supply)
"nO" = (
/obj/machinery/button/door/directional/west{
	id = "cargoload";
	name = "Loading Doors";
	pixel_y = -8;
	pixel_x = 24
	},
/turf/open/floor/iron/dark/smooth_edge{
	dir = 4
	},
/area/shuttle/supply)
"qo" = (
/obj/effect/decal/cleanable/dirt,
/turf/open/floor/iron/dark/smooth_edge{
	dir = 1
	},
/area/shuttle/supply)
"qs" = (
/obj/structure/railing{
	dir = 4
	},
/obj/machinery/light/directional/west,
/obj/effect/decal/cleanable/dirt,
/turf/open/floor/iron/dark/smooth_corner,
/area/shuttle/supply)
"qG" = (
/turf/open/floor/iron/dark/textured_large,
/area/shuttle/supply)
"sD" = (
/obj/effect/turf_decal/stripes/line{
	dir = 9
	},
/obj/effect/decal/cleanable/blood/oil,
/turf/open/floor/iron,
/area/shuttle/supply)
"tF" = (
/obj/structure/gangway,
/turf/open/floor/iron/dark/textured_large,
/area/shuttle/supply)
"uQ" = (
/obj/effect/turf_decal/stripes/line{
	dir = 1
	},
/obj/effect/decal/cleanable/dirt,
/turf/open/floor/iron,
/area/shuttle/supply)
"vc" = (
/obj/effect/turf_decal/stripes/line{
	dir = 5
	},
/turf/open/floor/iron,
/area/shuttle/supply)
"vk" = (
/obj/structure/railing{
	dir = 4
	},
/turf/open/floor/iron/dark/smooth_edge{
	dir = 1
	},
/area/shuttle/supply)
"wF" = (
/turf/open/floor/iron/dark/textured_large,
/area/template_noop)
"xb" = (
/obj/effect/turf_decal/delivery,
/turf/open/floor/iron/dark/smooth_edge{
	dir = 8
	},
/area/shuttle/supply)
"xm" = (
/obj/effect/turf_decal/stripes/line{
	dir = 1
	},
/obj/effect/turf_decal/delivery,
/turf/open/floor/iron,
/area/shuttle/supply)
"xD" = (
/obj/structure/railing{
	dir = 1
	},
/obj/effect/turf_decal/stripes/line{
	dir = 1
	},
/obj/effect/turf_decal/delivery,
/obj/effect/decal/cleanable/dirt,
/turf/open/floor/iron/edge,
/area/shuttle/supply)
"xN" = (
/obj/effect/turf_decal/stripes/line,
/obj/effect/decal/cleanable/blood/oil,
/turf/open/floor/iron,
/area/shuttle/supply)
"yb" = (
/obj/effect/turf_decal/stripes/line{
	dir = 1
	},
/turf/open/floor/iron,
/area/shuttle/supply)
"ys" = (
/obj/structure/fake_stairs/directional/south{
	icon_state = "stairs-old";
	icon = 'modular_zubbers/icons/turf/floors/floors.dmi';
	color = "#3d3e44"
	},
/obj/effect/decal/cleanable/dirt,
/turf/open/floor/iron/dark/smooth_edge{
	dir = 1
	},
/area/shuttle/supply)
"yM" = (
/turf/open/floor/catwalk_floor/iron_dark,
/area/shuttle/supply)
"zs" = (
/obj/machinery/button/door/directional/west{
	id = "cargoload1";
	name = "Loading Doors";
	pixel_y = -8;
	pixel_x = 24
	},
/obj/effect/decal/cleanable/dirt,
/turf/open/floor/iron/dark/smooth_edge{
	dir = 4
	},
/area/shuttle/supply)
"As" = (
/obj/structure/railing{
	dir = 1
	},
/obj/effect/turf_decal/stripes/line{
	dir = 9
	},
/turf/open/floor/iron,
/area/shuttle/supply)
"Ax" = (
/obj/structure/railing{
	dir = 8
	},
/obj/machinery/light/directional/east,
/obj/effect/decal/cleanable/dirt,
/turf/open/floor/iron/dark/smooth_corner{
	dir = 8
	},
/area/shuttle/supply)
"BM" = (
/obj/structure/fake_stairs/directional/south{
	icon_state = "stairs-old";
	icon = 'modular_zubbers/icons/turf/floors/floors.dmi';
	color = "#3d3e44";
	dir = 1
	},
/obj/structure/railing{
	dir = 4;
	pixel_y = 0
	},
/obj/effect/decal/cleanable/dirt,
/turf/open/floor/iron/dark/smooth_edge,
/area/shuttle/supply)
"BP" = (
/obj/structure/railing{
	dir = 8
	},
/obj/machinery/light/directional/east,
/turf/open/floor/iron/dark/smooth_corner{
	dir = 8
	},
/area/shuttle/supply)
"Cl" = (
/turf/open/floor/iron/dark/smooth_edge{
	dir = 8
	},
/area/shuttle/supply)
"CC" = (
/obj/effect/decal/cleanable/dirt,
/turf/open/floor/iron/dark/smooth_edge{
	dir = 4
	},
/area/shuttle/supply)
"CS" = (
/obj/effect/turf_decal/stripes/line{
	dir = 1
	},
/obj/effect/turf_decal/delivery,
/obj/effect/decal/cleanable/dirt,
/obj/effect/decal/cleanable/blood/oil,
/turf/open/floor/iron,
/area/shuttle/supply)
"Ds" = (
/obj/machinery/button/door/directional/west{
	id = "cargounload";
	name = "Loading Doors";
	pixel_y = 8;
	pixel_x = 24
	},
/turf/open/floor/iron/dark/smooth_edge{
	dir = 4
	},
/area/shuttle/supply)
"Ey" = (
/obj/structure/fake_stairs/directional/south{
	icon_state = "stairs-old";
	icon = 'modular_zubbers/icons/turf/floors/floors.dmi';
	color = "#3d3e44";
	dir = 1
	},
/obj/structure/railing{
	dir = 8
	},
/obj/effect/decal/cleanable/dirt,
/turf/open/floor/iron/dark/smooth_edge,
/area/shuttle/supply)
"EQ" = (
/obj/machinery/door/airlock/survival_pod,
/obj/effect/mapping_helpers/airlock/access/all/supply/general,
/obj/docking_port/mobile/supply/cargo_train,
/turf/open/floor/iron/dark/textured_large,
/area/shuttle/supply)
"Fb" = (
/turf/template_noop,
/area/template_noop)
"Fk" = (
/turf/open/floor/iron/dark/smooth_edge{
	dir = 1
	},
/area/shuttle/supply)
"Fu" = (
/obj/effect/turf_decal/stripes/line,
/obj/effect/decal/cleanable/dirt,
/turf/open/floor/iron,
/area/shuttle/supply)
"Gm" = (
/obj/structure/fake_stairs/directional/south{
	icon_state = "stairs-old";
	icon = 'modular_zubbers/icons/turf/floors/floors.dmi';
	color = "#3d3e44";
	dir = 1
	},
/obj/structure/railing{
	dir = 4;
	pixel_y = 0
	},
/turf/open/floor/iron/dark/smooth_edge,
/area/shuttle/supply)
"HC" = (
/obj/effect/turf_decal/stripes/line{
	dir = 1
	},
/turf/open/floor/iron/edge,
/area/shuttle/supply)
"HD" = (
/obj/structure/railing,
/obj/effect/turf_decal/stripes/line{
	dir = 10
	},
/turf/open/floor/iron,
/area/shuttle/supply)
"HJ" = (
/obj/effect/decal/cleanable/dirt,
/turf/open/floor/catwalk_floor/iron_dark,
/area/shuttle/supply)
"Jz" = (
/obj/effect/turf_decal/stripes/line,
/turf/open/floor/iron,
/area/shuttle/supply)
"JS" = (
/obj/effect/decal/cleanable/dirt,
/turf/open/floor/iron/dark/smooth_edge,
/area/shuttle/supply)
"Kw" = (
/obj/structure/railing,
/obj/effect/turf_decal/stripes/line{
	dir = 6
	},
/obj/effect/decal/cleanable/dirt,
/obj/effect/decal/cleanable/blood/oil,
/turf/open/floor/iron,
/area/shuttle/supply)
"Lv" = (
/obj/effect/turf_decal/bot,
/turf/open/floor/iron/dark/textured_large,
/area/shuttle/supply)
"Mf" = (
/obj/structure/fake_stairs/directional/south{
	icon_state = "stairs-old";
	icon = 'modular_zubbers/icons/turf/floors/floors.dmi';
	color = "#3d3e44"
	},
/turf/open/floor/iron/dark/smooth_edge{
	dir = 1
	},
/area/shuttle/supply)
"NG" = (
/obj/machinery/door/poddoor{
	id = "cargounload1";
	name = "Supply Dock Unloading Door"
	},
/turf/open/floor/iron/dark/textured_large,
/area/shuttle/supply)
"NH" = (
/obj/effect/decal/cleanable/dirt,
/obj/effect/decal/cleanable/blood/oil,
/turf/open/floor/iron/dark/smooth_edge{
	dir = 8
	},
/area/shuttle/supply)
"OD" = (
/obj/effect/turf_decal/stripes/line{
	dir = 1
	},
/obj/effect/decal/cleanable/dirt,
/turf/open/floor/iron/edge,
/area/shuttle/supply)
"Pd" = (
/obj/effect/turf_decal/delivery,
/turf/open/floor/iron/dark/smooth_edge{
	dir = 4
	},
/area/shuttle/supply)
"Qs" = (
/obj/structure/railing,
/obj/effect/turf_decal/stripes/line,
/obj/effect/turf_decal/delivery,
/turf/open/floor/iron/edge{
	dir = 1
	},
/area/shuttle/supply)
"QT" = (
/obj/structure/fake_stairs/directional/south{
	icon_state = "stairs-old";
	icon = 'modular_zubbers/icons/turf/floors/floors.dmi';
	color = "#3d3e44";
	dir = 1
	},
/obj/structure/railing{
	dir = 8
	},
/turf/open/floor/iron/dark/smooth_edge,
/area/shuttle/supply)
"Re" = (
/obj/effect/turf_decal/stripes/line{
	dir = 1
	},
/obj/effect/turf_decal/delivery,
/obj/effect/decal/cleanable/dirt,
/turf/open/floor/iron,
/area/shuttle/supply)
"Rf" = (
/obj/effect/turf_decal/delivery,
/obj/effect/decal/cleanable/blood/oil,
/turf/open/floor/iron/dark/smooth_edge{
	dir = 4
	},
/area/shuttle/supply)
"Ro" = (
/obj/effect/decal/cleanable/dirt,
/obj/effect/decal/cleanable/dirt,
/turf/open/floor/catwalk_floor/iron_dark,
/area/shuttle/supply)
"Ru" = (
/obj/effect/turf_decal/stripes/line{
	dir = 9
	},
/turf/open/floor/iron,
/area/shuttle/supply)
"RM" = (
/obj/effect/decal/cleanable/dirt,
/turf/closed/wall/mineral/titanium/survival/nodiagonal,
/area/shuttle/supply)
"Sq" = (
/obj/effect/turf_decal/stripes/line,
/turf/open/floor/iron/edge{
	dir = 1
	},
/area/shuttle/supply)
"Ta" = (
/obj/machinery/door/airlock/survival_pod,
/obj/effect/mapping_helpers/airlock/access/all/supply/general,
/turf/open/floor/iron/dark/textured_large,
/area/shuttle/supply)
"Tv" = (
/obj/effect/turf_decal/stripes/line{
	dir = 1
	},
/obj/effect/decal/cleanable/dirt,
/obj/effect/decal/cleanable/dirt,
/turf/open/floor/iron/edge,
/area/shuttle/supply)
"TZ" = (
/obj/effect/decal/cleanable/dirt,
/obj/effect/decal/cleanable/blood/oil,
/turf/open/floor/iron/dark/smooth_edge,
/area/shuttle/supply)
"UD" = (
/turf/closed/wall/mineral/titanium/survival/nodiagonal,
/area/shuttle/supply)
"UW" = (
/obj/effect/turf_decal/stripes/line{
	dir = 10
	},
/turf/open/floor/iron,
/area/shuttle/supply)
"VJ" = (
/obj/effect/turf_decal/delivery,
/obj/effect/decal/cleanable/dirt,
/turf/open/floor/iron/dark/smooth_edge{
	dir = 8
	},
/area/shuttle/supply)
"Wo" = (
/obj/machinery/door/poddoor{
	id = "cargoload";
	name = "Supply Dock Loading Door"
	},
/turf/open/floor/iron/dark/textured_large,
/area/shuttle/supply)
"Wy" = (
/obj/structure/railing{
	dir = 1
	},
/obj/effect/turf_decal/stripes/line{
	dir = 1
	},
/obj/effect/turf_decal/delivery,
/obj/effect/decal/cleanable/dirt,
/obj/effect/decal/cleanable/dirt,
/turf/open/floor/iron/edge,
/area/shuttle/supply)
"WX" = (
/obj/effect/turf_decal/bot,
/obj/effect/decal/cleanable/dirt,
/turf/open/floor/iron/dark/textured_large,
/area/shuttle/supply)
"XY" = (
/obj/effect/turf_decal/stripes/line,
/obj/effect/decal/cleanable/dirt,
/turf/open/floor/iron/edge{
	dir = 1
	},
/area/shuttle/supply)
"Yi" = (
/obj/effect/decal/cleanable/dirt,
/turf/open/floor/iron/dark/textured_large,
/area/shuttle/supply)
"YH" = (
/obj/effect/turf_decal/stripes/line{
	dir = 6
	},
/turf/open/floor/iron,
/area/shuttle/supply)
"ZA" = (
/obj/structure/railing{
	dir = 4
	},
/obj/machinery/light/directional/west,
/turf/open/floor/iron/dark/smooth_corner,
/area/shuttle/supply)
"ZL" = (
/obj/effect/decal/cleanable/dirt,
/turf/open/floor/iron/dark/smooth_edge{
	dir = 8
	},
/area/shuttle/supply)

(1,1,1) = {"
Fb
Fb
Fb
Fb
Fb
UD
UD
UD
UD
UD
UD
UD
UD
UD
UD
UD
UD
UD
UD
UD
UD
UD
Fb
UD
UD
UD
UD
UD
UD
UD
UD
UD
UD
UD
UD
UD
UD
UD
UD
UD
Fb
UD
UD
UD
UD
UD
RM
UD
UD
UD
UD
UD
UD
UD
UD
UD
UD
UD
Fb
Fb
"}
(2,1,1) = {"
Fb
Fb
Fb
Fb
Fb
UD
qG
qG
qG
qG
qG
UD
qG
qG
qG
qG
qG
qG
qG
qG
qG
UD
Fb
UD
sD
HD
ZA
Cl
xb
xb
Cl
Cl
Cl
xb
xb
NH
hw
As
UW
UD
Fb
UD
Ru
HD
qs
NH
VJ
VJ
ZL
ZL
ZL
VJ
xb
ZL
hw
As
UW
UD
Fb
Fb
"}
(3,1,1) = {"
Fb
Fb
Fb
Fb
Fb
UD
qG
qG
qG
qG
qG
UD
UD
qG
qG
qG
qG
qG
qG
qG
qG
UD
Fb
UD
yb
XY
ys
HJ
yM
yM
yM
yM
HJ
HJ
Ro
Ro
Ey
HC
Jz
UD
Fb
UD
uQ
XY
ys
yM
HJ
HJ
yM
yM
yM
yM
yM
yM
QT
OD
xN
UD
Fb
Fb
"}
(4,1,1) = {"
Fb
Fb
Fb
Fb
Fb
UD
qG
qG
qG
qG
qG
qG
UD
qG
qG
qG
qG
qG
qG
qG
qG
UD
Fb
UD
uQ
XY
Mf
HJ
Lv
Lv
Lv
WX
Lv
WX
Lv
yM
BM
HC
Jz
UD
Fb
UD
iz
Sq
ys
yM
Lv
WX
WX
Lv
Lv
WX
Lv
HJ
Gm
OD
Jz
UD
Fb
Fb
"}
(5,1,1) = {"
Fb
Fb
Fb
Fb
Fb
UD
qG
qG
qG
qG
qG
qG
UD
qG
qG
qG
qG
qG
qG
qG
qG
UD
hq
UD
Re
Qs
cN
HJ
Lv
Lv
WX
WX
WX
Lv
Lv
yM
JS
mQ
nk
UD
tF
UD
CS
Qs
cN
HJ
Lv
Lv
WX
WX
WX
WX
Lv
HJ
ap
xD
nk
UD
Fb
Fb
"}
(6,1,1) = {"
Fb
Fb
Fb
Fb
Fb
UD
qG
qG
qG
qG
qG
UD
UD
qG
qG
qG
qG
qG
qG
qG
qG
mM
wF
mM
Re
Qs
qo
yM
Lv
Lv
Lv
hA
WX
WX
WX
Yi
JS
Wy
nk
mM
qG
mM
xm
hy
Fk
yM
Lv
Lv
WX
WX
Lv
WX
Lv
HJ
ap
xD
nk
UD
Fb
Fb
"}
(7,1,1) = {"
Fb
Fb
Fb
Fb
Fb
UD
qG
qG
qG
qG
qG
UD
qG
qG
qG
qG
qG
qG
qG
qG
qG
qG
wF
qG
xm
Qs
Fk
HJ
Lv
WX
WX
Lv
Lv
Lv
Lv
yM
qG
Wy
nk
qG
qG
qG
xm
Qs
qo
HJ
Lv
Lv
Lv
WX
WX
WX
Lv
HJ
ap
xD
nk
UD
Fb
Fb
"}
(8,1,1) = {"
Fb
Fb
Fb
Fb
Fb
UD
UD
UD
UD
UD
UD
UD
UD
UD
Ta
UD
UD
UD
UD
Ta
UD
UD
hq
UD
Re
Qs
vk
Ro
WX
hA
WX
Lv
Lv
Lv
Lv
Ro
TZ
xD
eA
UD
tF
UD
xm
Qs
vk
HJ
WX
WX
Lv
Lv
WX
WX
Lv
HJ
ap
xD
nk
UD
Fb
Fb
"}
(9,1,1) = {"
Fb
Fb
Fb
Fb
Fb
Fb
Fb
Fb
Fb
Fb
Fb
Fb
UD
qG
qG
qG
qG
qG
qG
qG
qG
UD
Fb
UD
yb
XY
ys
yM
WX
Lv
WX
Lv
Lv
Lv
WX
HJ
Ey
Tv
Fu
UD
Fb
UD
yb
Sq
ys
HJ
WX
WX
Lv
Lv
WX
Lv
WX
HJ
Ey
OD
Fu
UD
Fb
Fb
"}
(10,1,1) = {"
Fb
Fb
Fb
Fb
Fb
Fb
Fb
Fb
Fb
Fb
Fb
Fb
UD
qG
qG
qG
qG
qG
qG
qG
qG
UD
Fb
UD
iz
gq
Mf
yM
yM
yM
yM
HJ
yM
yM
yM
HJ
Gm
OD
Fu
UD
Fb
UD
yb
XY
Mf
yM
HJ
HJ
yM
yM
yM
yM
yM
HJ
BM
OD
Fu
UD
Fb
Fb
"}
(11,1,1) = {"
Fb
Fb
Fb
Fb
Fb
Fb
Fb
Fb
Fb
Fb
Fb
Fb
UD
qG
qG
qG
qG
qG
qG
qG
qG
UD
Fb
UD
vc
fx
BP
kR
Pd
Pd
ad
kR
zs
dc
dc
kR
eB
cJ
YH
UD
Fb
UD
vc
Kw
Ax
CC
dc
Pd
Ds
kR
nO
Pd
Rf
dY
bY
cJ
YH
UD
Fb
Fb
"}
(12,1,1) = {"
Fb
Fb
Fb
Fb
Fb
Fb
Fb
Fb
Fb
Fb
Fb
Fb
UD
UD
UD
UD
UD
UD
UD
UD
UD
UD
Fb
UD
UD
UD
UD
Ta
NG
NG
UD
UD
UD
kF
kF
Ta
UD
UD
UD
UD
Fb
UD
UD
UD
UD
EQ
jM
jM
UD
UD
UD
Wo
Wo
Ta
UD
UD
UD
UD
Fb
Fb
"}
