//MAP CONVERTED BY dmm2tgm.py THIS HEADER COMMENT PREVENTS RECONVERSION, DO NOT REMOVE
"b" = (
/obj/machinery/light/small/directional/north,
/obj/effect/decal/cleanable/dirt,
/obj/structure/reagent_forge,
/turf/open/floor/stone,
/area/mine/blacksmith)
"c" = (
/obj/effect/decal/cleanable/dirt,
/obj/machinery/atmospherics/components/unary/vent_pump/on/layer4,
/turf/open/floor/stone,
/area/mine/blacksmith)
"l" = (
/obj/effect/decal/cleanable/dirt,
/obj/structure/reagent_water_basin,
/turf/open/floor/stone,
/area/mine/blacksmith)
"n" = (
/obj/effect/decal/cleanable/dirt,
/obj/machinery/airalarm/directional/east,
/turf/open/floor/stone,
/area/mine/blacksmith)
"s" = (
/obj/structure/table/wood,
/obj/machinery/door/window/left/directional/west{
	req_access = list("blacksmith")
	},
/obj/machinery/door/window/left/directional/east,
/turf/open/floor/stone,
/area/mine/blacksmith)
"t" = (
/obj/effect/decal/cleanable/dirt,
/obj/effect/decal/cleanable/ash,
/obj/structure/cable,
/obj/machinery/power/apc/auto_name/directional/west,
/turf/open/floor/stone,
/area/mine/blacksmith)
"u" = (
/turf/closed/wall,
/area/mine/blacksmith)
"y" = (
/turf/open/floor/stone,
/area/mine/blacksmith)
"C" = (
/obj/machinery/atmospherics/pipe/smart/manifold4w/scrubbers/hidden/layer2,
/obj/machinery/atmospherics/pipe/smart/manifold4w/supply/hidden/layer4,
/obj/structure/cable,
/obj/effect/decal/cleanable/dirt,
/turf/open/floor/stone,
/area/mine/blacksmith)
"F" = (
/obj/machinery/atmospherics/components/unary/vent_scrubber/on/layer2,
/turf/open/floor/stone,
/area/mine/blacksmith)
"H" = (
/obj/machinery/atmospherics/pipe/smart/manifold4w/scrubbers/hidden/layer2,
/obj/machinery/atmospherics/pipe/smart/manifold4w/supply/hidden/layer4,
/obj/structure/cable,
/obj/machinery/door/airlock/maintenance{
	name = "Blacksmith Mining Workhop Maintenance"
	},
/obj/effect/mapping_helpers/airlock/access/all/supply/mining_station,
/obj/effect/mapping_helpers/airlock/access/all/engineering/maintenance,
/turf/open/floor/plating,
/area/mine/blacksmith)
"L" = (
/obj/machinery/atmospherics/pipe/smart/manifold4w/scrubbers/hidden/layer2,
/obj/machinery/atmospherics/pipe/smart/manifold4w/supply/hidden/layer4,
/obj/structure/cable,
/obj/structure/reagent_anvil,
/turf/open/floor/stone,
/area/mine/blacksmith)
"O" = (
/obj/effect/decal/cleanable/dirt,
/obj/machinery/camera/autoname/mine/directional/east,
/obj/machinery/portable_atmospherics/canister/oxygen,
/turf/open/floor/stone,
/area/mine/blacksmith)
"P" = (
/obj/machinery/atmospherics/pipe/smart/manifold4w/scrubbers/hidden/layer2,
/obj/machinery/atmospherics/pipe/smart/manifold4w/supply/hidden/layer4,
/obj/structure/cable,
/obj/machinery/door/airlock/mining/glass{
	name = "Blacksmith Mining Workshop"
	},
/obj/effect/mapping_helpers/airlock/access/any/supply/general,
/turf/open/floor/stone,
/area/mine/blacksmith)
"T" = (
/obj/structure/reagent_crafting_bench,
/obj/item/toy/plush/skyrat/deer{
	name = "Noye";
	desc = "His treasures were his tools, and the swords and knives he made. His life was at the forge."
	},
/obj/item/radio/intercom/directional/west,
/turf/open/floor/stone,
/area/mine/blacksmith)
"U" = (
/obj/machinery/atmospherics/pipe/smart/manifold4w/scrubbers/hidden/layer2,
/obj/machinery/atmospherics/pipe/smart/manifold4w/supply/hidden/layer4,
/obj/structure/cable,
/obj/effect/decal/cleanable/dirt,
/obj/structure/closet/crate/wooden,
/obj/item/clothing/suit/leatherapron,
/obj/item/clothing/suit/toggle/jacket/zubber/bomber/cargo/smith,
/obj/item/stack/rods/twentyfive,
/obj/item/stack/sheet/iron/twenty,
/obj/item/stack/sheet/bronze/thirty,
/obj/item/forging/tongs,
/obj/item/forging/hammer,
/obj/item/forging/billow,
/obj/item/stack/sheet/mineral/coal/ten,
/turf/open/floor/stone,
/area/mine/blacksmith)
"V" = (
/obj/effect/decal/cleanable/dirt,
/obj/machinery/space_heater,
/turf/open/floor/stone,
/area/mine/blacksmith)

(1,1,1) = {"
u
u
u
H
"}
(2,1,1) = {"
u
T
t
C
"}
(3,1,1) = {"
u
b
F
L
"}
(4,1,1) = {"
V
l
y
U
"}
(5,1,1) = {"
O
n
c
C
"}
(6,1,1) = {"
u
u
s
P
"}
