"a" = (/turf/open/floor/stone,/area/mine/storage)
"d" = (/obj/structure/reagent_crafting_bench,/obj/item/toy/plush/skyrat/deer{name = "Noye"; desc = "His treasures were his tools, and the swords and knives he made. His life was at the forge."},/turf/open/floor/stone,/area/mine/storage)
"g" = (/obj/effect/decal/cleanable/dirt,/obj/machinery/portable_atmospherics/canister/oxygen,/turf/open/floor/stone,/area/mine/storage)
"k" = (/obj/effect/decal/cleanable/dirt,/turf/open/floor/stone,/area/mine/storage)
"l" = (/obj/effect/decal/cleanable/dirt,/obj/machinery/space_heater,/turf/open/floor/stone,/area/mine/storage)
"v" = (/obj/machinery/atmospherics/pipe/smart/manifold4w/scrubbers/hidden/layer2,/obj/machinery/atmospherics/pipe/smart/manifold4w/supply/hidden/layer4,/obj/structure/cable,/obj/effect/decal/cleanable/dirt,/turf/open/floor/stone,/area/mine/storage)
"w" = (/obj/effect/decal/cleanable/dirt,/obj/structure/closet/crate/cargo/mining,/obj/item/stack/sheet/mineral/coal/ten,/obj/item/forging/billow,/obj/item/forging/hammer,/obj/item/forging/tongs,/obj/item/stack/sheet/bronze/thirty,/obj/item/stack/sheet/iron/twenty,/obj/item/stack/rods/twentyfive,/obj/item/clothing/suit/toggle/jacket/zubber/bomber/cargo/smith,/obj/item/clothing/suit/leatherapron,/turf/open/floor/stone,/area/mine/storage)
"x" = (/obj/structure/table/wood,/obj/machinery/door/window/left/directional/west{req_access = list("blacksmith")},/obj/machinery/door/window/left/directional/east,/turf/open/floor/stone,/area/mine/storage)
"z" = (/obj/effect/decal/cleanable/dirt,/obj/effect/decal/cleanable/ash,/turf/open/floor/stone,/area/mine/storage)
"C" = (/obj/machinery/atmospherics/pipe/smart/manifold4w/scrubbers/hidden/layer2,/obj/machinery/atmospherics/pipe/smart/manifold4w/supply/hidden/layer4,/obj/structure/cable,/obj/structure/reagent_anvil,/turf/open/floor/stone,/area/mine/storage)
"D" = (/turf/closed/wall,/area/mine/storage)
"F" = (/obj/machinery/atmospherics/pipe/smart/manifold4w/scrubbers/hidden/layer2,/obj/machinery/atmospherics/pipe/smart/manifold4w/supply/hidden/layer4,/obj/structure/cable,/obj/effect/mapping_helpers/airlock/access/any/supply/blacksmith,/obj/effect/mapping_helpers/airlock/autoname,/obj/machinery/door/airlock/mining/glass,/turf/open/floor/plating,/area/mine/storage)
"M" = (/obj/effect/decal/cleanable/dirt,/obj/structure/reagent_water_basin,/turf/open/floor/stone,/area/mine/storage)
"V" = (/obj/machinery/light/small/directional/north,/obj/effect/decal/cleanable/dirt,/obj/structure/reagent_forge,/turf/open/floor/stone,/area/mine/storage)

(1,1,1) = {"
DDDglD
DdVMwD
Dzaakx
FvCvvF
"}
