//MAP CONVERTED BY dmm2tgm.py THIS HEADER COMMENT PREVENTS RECONVERSION, DO NOT REMOVE
"a" = (
/obj/structure/cable,
/turf/open/floor/plating,
/area/mine/maintenance/service)
"b" = (
/turf/closed/wall,
/area/mine/maintenance/service/disposals)
"c" = (
/obj/effect/turf_decal/sand/plating/volcanic,
/obj/machinery/conveyor_switch/oneway{
	id = "mining_disposals";
	name = "disposals conveyor"
	},
/obj/machinery/light/small/directional/west,
/turf/open/floor/plating/lavaland_atmos,
/area/mine/maintenance/service/disposals)
"d" = (
/obj/machinery/conveyor{
	dir = 6;
	id = "mining_disposals"
	},
/obj/effect/turf_decal/sand/plating/volcanic,
/turf/open/floor/plating/lavaland_atmos,
/area/mine/maintenance/service/disposals)
"f" = (
/obj/structure/lattice/catwalk,
/obj/structure/disposalpipe/segment{
	dir = 6
	},
/turf/open/misc/asteroid/basalt/lava_land_surface,
/area/lavaland/surface/outdoors)
"g" = (
/obj/effect/decal/cleanable/dirt,
/obj/structure/cable,
/turf/open/floor/plating,
/area/mine/maintenance/service)
"h" = (
/obj/structure/lattice/catwalk,
/obj/structure/disposalpipe/segment{
	dir = 4
	},
/obj/structure/cable,
/turf/open/misc/asteroid/basalt/lava_land_surface,
/area/lavaland/surface/outdoors)
"i" = (
/obj/machinery/light/small/directional/west,
/obj/structure/rack,
/obj/item/chair,
/obj/item/chair{
	pixel_x = 3;
	pixel_y = 3
	},
/obj/item/chair{
	pixel_x = 6;
	pixel_y = 6
	},
/turf/open/floor/plating,
/area/mine/maintenance/service)
"j" = (
/obj/effect/turf_decal/sand/plating/volcanic,
/obj/effect/spawner/random/maintenance/two,
/turf/open/floor/plating/lavaland_atmos,
/area/mine/maintenance/service/disposals)
"k" = (
/obj/structure/cable,
/obj/machinery/power/port_gen/pacman{
	anchored = 1
	},
/obj/effect/decal/cleanable/dirt,
/turf/open/floor/plating,
/area/mine/maintenance/service)
"l" = (
/obj/structure/cable,
/obj/effect/decal/cleanable/dirt,
/obj/structure/rack,
/obj/item/stock_parts/power_store/cell/high{
	pixel_x = 6;
	pixel_y = 7
	},
/obj/item/stock_parts/power_store/cell/high{
	pixel_x = -3;
	pixel_y = 5
	},
/obj/item/stock_parts/power_store/cell/high{
	pixel_x = 3
	},
/turf/open/floor/plating,
/area/mine/maintenance/service)
"m" = (
/obj/structure/lattice/catwalk,
/obj/structure/disposalpipe/segment{
	dir = 6
	},
/obj/structure/cable,
/turf/open/misc/asteroid/basalt/lava_land_surface,
/area/lavaland/surface/outdoors)
"n" = (
/obj/effect/decal/cleanable/dirt,
/turf/open/floor/plating,
/area/mine/maintenance/service)
"o" = (
/obj/structure/fence{
	dir = 8
	},
/obj/effect/turf_decal/sand/plating/volcanic,
/turf/open/floor/plating/lavaland_atmos,
/area/mine/maintenance/service/disposals)
"p" = (
/obj/machinery/power/terminal{
	dir = 4
	},
/obj/structure/cable,
/obj/machinery/light/small/directional/north,
/obj/effect/decal/cleanable/dirt,
/turf/open/floor/plating,
/area/mine/maintenance/service)
"q" = (
/obj/machinery/conveyor{
	id = "mining_disposals"
	},
/obj/effect/turf_decal/sand/plating/volcanic,
/turf/open/floor/plating/lavaland_atmos,
/area/mine/maintenance/service/disposals)
"r" = (
/obj/effect/spawner/structure/window/reinforced/tinted,
/obj/structure/cable,
/turf/open/floor/plating,
/area/mine/maintenance/service)
"s" = (
/obj/structure/lattice/catwalk,
/obj/structure/disposalpipe/segment{
	dir = 4
	},
/turf/open/misc/asteroid/basalt/lava_land_surface,
/area/lavaland/surface/outdoors)
"u" = (
/obj/machinery/conveyor{
	dir = 4;
	id = "mining_disposals"
	},
/obj/effect/turf_decal/sand/plating/volcanic,
/obj/effect/spawner/random/maintenance/six,
/turf/open/floor/plating/lavaland_atmos,
/area/mine/maintenance/service/disposals)
"v" = (
/obj/structure/fence/cut/large{
	dir = 4
	},
/obj/effect/turf_decal/sand/plating/volcanic,
/turf/open/floor/plating/lavaland_atmos,
/area/mine/maintenance/service/disposals)
"w" = (
/obj/machinery/door/airlock/maintenance{
	name = "Mining Station Maintenance"
	},
/obj/structure/cable,
/obj/effect/mapping_helpers/airlock/access/any/engineering/maintenance,
/turf/open/floor/plating,
/area/mine/maintenance/service)
"x" = (
/obj/effect/decal/cleanable/dirt,
/obj/machinery/space_heater,
/turf/open/floor/plating,
/area/mine/maintenance/service)
"y" = (
/obj/machinery/power/colony_wind_turbine,
/obj/structure/lattice/catwalk,
/obj/structure/cable,
/turf/open/misc/asteroid/basalt/lava_land_surface,
/area/lavaland/surface/outdoors)
"z" = (
/turf/open/misc/asteroid/basalt/lava_land_surface,
/area/lavaland/surface/outdoors)
"A" = (
/obj/structure/cable,
/obj/machinery/power/smes/super/full,
/obj/effect/decal/cleanable/dirt,
/turf/open/floor/plating,
/area/mine/maintenance/service)
"B" = (
/obj/structure/disposalpipe/trunk{
	dir = 4
	},
/obj/structure/disposaloutlet{
	dir = 8
	},
/obj/effect/turf_decal/sand/plating/volcanic,
/turf/open/floor/plating/lavaland_atmos,
/area/mine/maintenance/service/disposals)
"C" = (
/obj/effect/spawner/structure/window/reinforced,
/obj/structure/cable,
/turf/open/floor/plating,
/area/mine/maintenance/service)
"D" = (
/obj/effect/decal/cleanable/dirt,
/obj/machinery/power/port_gen/pacman{
	anchored = 1
	},
/obj/structure/cable,
/turf/open/floor/plating,
/area/mine/maintenance/service)
"F" = (
/obj/structure/disposalpipe/segment{
	dir = 9
	},
/obj/structure/cable,
/obj/effect/turf_decal/sand/plating/volcanic,
/obj/machinery/power/apc/auto_name/directional/east,
/turf/open/floor/plating/lavaland_atmos,
/area/mine/maintenance/service/disposals)
"G" = (
/obj/structure/reagent_dispensers/fueltank,
/obj/effect/decal/cleanable/dirt,
/turf/open/floor/plating,
/area/mine/maintenance/service)
"H" = (
/obj/structure/lattice/catwalk,
/obj/structure/disposalpipe/segment,
/obj/structure/cable,
/turf/open/misc/asteroid/basalt/lava_land_surface,
/area/lavaland/surface/outdoors)
"I" = (
/obj/effect/turf_decal/sand/plating/volcanic,
/turf/open/floor/plating/lavaland_atmos,
/area/mine/maintenance/service/disposals)
"J" = (
/turf/open/floor/plating,
/area/mine/maintenance/service)
"K" = (
/turf/closed/wall,
/area/mine/maintenance/service)
"L" = (
/obj/structure/reagent_dispensers/watertank,
/turf/open/floor/plating,
/area/mine/maintenance/service)
"M" = (
/obj/structure/lattice/catwalk,
/obj/structure/disposalpipe/segment{
	dir = 9
	},
/obj/structure/cable,
/turf/open/misc/asteroid/basalt/lava_land_surface,
/area/lavaland/surface/outdoors)
"N" = (
/obj/machinery/atmospherics/pipe/smart/manifold4w/supply/hidden/layer4,
/obj/machinery/atmospherics/pipe/smart/manifold4w/scrubbers/hidden/layer2,
/obj/structure/cable,
/obj/effect/decal/cleanable/dirt,
/turf/open/floor/plating,
/area/mine/maintenance/service)
"O" = (
/obj/structure/fence/door/opened,
/obj/structure/disposalpipe/segment,
/obj/effect/turf_decal/sand/plating/volcanic,
/turf/open/floor/plating/lavaland_atmos,
/area/mine/maintenance/service/disposals)
"P" = (
/obj/effect/turf_decal/sand/plating/volcanic,
/obj/structure/cable,
/turf/open/floor/plating/lavaland_atmos,
/area/mine/maintenance/service/disposals)
"Q" = (
/obj/structure/lattice/catwalk,
/turf/open/misc/asteroid/basalt/lava_land_surface,
/area/lavaland/surface/outdoors)
"R" = (
/obj/machinery/recycler{
	dir = 8
	},
/obj/machinery/conveyor{
	dir = 4;
	id = "mining_disposals"
	},
/obj/effect/turf_decal/sand/plating/volcanic,
/turf/open/floor/plating/lavaland_atmos,
/area/mine/maintenance/service/disposals)
"S" = (
/obj/machinery/door/airlock/maintenance{
	name = "Mining Station Maintenance"
	},
/obj/effect/mapping_helpers/airlock/access/any/engineering/maintenance,
/obj/structure/cable,
/turf/open/floor/plating,
/area/mine/maintenance/service)
"T" = (
/obj/structure/fence/end{
	dir = 8
	},
/obj/effect/turf_decal/sand/plating/volcanic,
/turf/open/floor/plating/lavaland_atmos,
/area/mine/maintenance/service/disposals)
"U" = (
/obj/structure/lattice/catwalk,
/obj/structure/disposalpipe/segment{
	dir = 9
	},
/turf/open/misc/asteroid/basalt/lava_land_surface,
/area/lavaland/surface/outdoors)
"V" = (
/obj/machinery/power/port_gen/pacman{
	anchored = 1
	},
/obj/structure/cable,
/turf/open/floor/plating,
/area/mine/maintenance/service)
"W" = (
/obj/structure/cable,
/obj/machinery/power/apc/auto_name/directional/east,
/turf/open/floor/plating,
/area/mine/maintenance/service)
"X" = (
/obj/structure/lattice/catwalk,
/obj/structure/cable,
/turf/open/misc/asteroid/basalt/lava_land_surface,
/area/lavaland/surface/outdoors)
"Z" = (
/obj/structure/fence{
	dir = 4
	},
/obj/effect/turf_decal/sand/plating/volcanic,
/turf/open/floor/plating/lavaland_atmos,
/area/mine/maintenance/service/disposals)

(1,1,1) = {"
y
X
y
X
y
z
z
z
b
b
b
b
b
"}
(2,1,1) = {"
X
z
X
z
X
z
z
z
v
j
c
u
o
"}
(3,1,1) = {"
y
X
y
X
y
z
z
z
Z
B
I
R
T
"}
(4,1,1) = {"
X
z
X
z
X
z
z
f
O
F
P
d
q
"}
(5,1,1) = {"
y
Q
y
X
y
z
z
s
K
K
C
C
K
"}
(6,1,1) = {"
X
z
X
z
X
z
z
s
K
L
D
x
i
"}
(7,1,1) = {"
y
Q
y
X
y
z
f
U
K
G
g
a
g
"}
(8,1,1) = {"
X
z
X
z
X
z
s
K
K
K
K
K
a
"}
(9,1,1) = {"
y
X
y
X
y
z
s
K
V
k
V
K
S
"}
(10,1,1) = {"
z
z
z
z
X
z
h
r
p
J
n
K
g
"}
(11,1,1) = {"
z
z
z
z
m
H
M
K
A
l
W
w
N
"}
