//MAP CONVERTED BY dmm2tgm.py THIS HEADER COMMENT PREVENTS RECONVERSION, DO NOT REMOVE
"ar" = (
/obj/structure/flora/biolumi/mine/weaklight,
/turf/open/misc/dirt/jungle/dark,
/area/misc/hilbertshotel)
"aC" = (
/obj/structure/table/wood/shuttle_bar,
/obj/item/flashlight/flare/candle/infinite{
	pixel_x = 8;
	pixel_y = 9
	},
/obj/effect/decal/cleanable/dirt/dust,
/obj/effect/decal/cleanable/dirt/dust,
/turf/open/floor/wood,
/area/misc/hilbertshotel)
"aS" = (
/obj/structure/flora/bush/stalky/style_2,
/turf/open/water{
	planetary_atmos = 0
	},
/area/misc/hilbertshotel)
"cy" = (
/obj/structure/flora/rock,
/turf/open/water{
	planetary_atmos = 0
	},
/area/misc/hilbertshotel)
"dT" = (
/obj/effect/decal/cleanable/xenoblood/xgibs/body,
/turf/open/misc/dirt/jungle/dark,
/area/misc/hilbertshotel)
"fa" = (
/obj/effect/decal/remains/xeno,
/turf/open/misc/dirt/jungle/dark,
/area/misc/hilbertshotel)
"gr" = (
/obj/structure/barricade/wooden/crude,
/turf/open/misc/dirt/jungle/dark,
/area/misc/hilbertshotel)
"gQ" = (
/obj/effect/decal/cleanable/dirt/dust,
/turf/open/floor/wood/large,
/area/misc/hilbertshotel)
"jr" = (
/obj/effect/decal/cleanable/rubble,
/obj/structure/wall_torch/spawns_lit/directional/west,
/turf/open/misc/dirt/jungle/dark,
/area/misc/hilbertshotel)
"jx" = (
/turf/open/floor/wood/large{
	invisibility = 1
	},
/area/misc/hilbertshotel)
"jT" = (
/obj/effect/decal/cleanable/xenoblood/xgibs/core,
/turf/open/misc/dirt/jungle/dark,
/area/misc/hilbertshotel)
"kh" = (
/obj/effect/decal/cleanable/blood/old{
	pixel_x = -2;
	pixel_y = -1
	},
/obj/effect/decal/remains/human{
	pixel_x = -4;
	pixel_y = 6
	},
/turf/open/misc/dirt/jungle/dark,
/area/misc/hilbertshotel)
"kD" = (
/obj/structure/closet/secure_closet/personal/cabinet,
/obj/item/hairbrush/tactical,
/obj/item/serviette_pack,
/obj/effect/decal/cleanable/dirt/dust,
/turf/open/floor/wood/large,
/area/misc/hilbertshotel)
"kS" = (
/turf/open/misc/grass/jungle,
/area/misc/hilbertshotel)
"lY" = (
/obj/effect/decal/cleanable/rubble,
/obj/structure/spacevine,
/turf/open/misc/dirt/jungle/dark,
/area/misc/hilbertshotel)
"mK" = (
/obj/effect/decal/cleanable/cobweb/cobweb2,
/obj/effect/decal/cleanable/dirt/dust,
/turf/open/floor/wood/large,
/area/misc/hilbertshotel)
"nA" = (
/obj/effect/decal/cleanable/dirt/dust{
	pixel_x = 2;
	pixel_y = -1
	},
/obj/effect/decal/remains/human{
	pixel_x = -12;
	pixel_y = 9
	},
/turf/open/floor/wood/large,
/area/misc/hilbertshotel)
"oZ" = (
/obj/structure/table/wood,
/obj/item/storage/backpack/satchel/flat{
	pixel_x = 0;
	pixel_y = 6
	},
/turf/open/floor/wood/large{
	invisibility = 1
	},
/area/misc/hilbertshotel)
"pm" = (
/obj/effect/decal/cleanable/dirt/dust,
/obj/structure/table/wood/shuttle_bar,
/turf/open/floor/wood/large,
/area/misc/hilbertshotel)
"pv" = (
/obj/structure/flora/grass/jungle/a/style_4{
	pixel_x = 23;
	pixel_y = 0
	},
/turf/open/misc/dirt/jungle/dark,
/area/misc/hilbertshotel)
"pD" = (
/obj/structure/flora/grass/jungle/a/style_4{
	pixel_x = 3;
	pixel_y = 39
	},
/turf/open/misc/dirt/jungle/dark,
/area/misc/hilbertshotel)
"tE" = (
/obj/effect/supplypod_rubble,
/turf/open/misc/dirt/jungle/dark,
/area/misc/hilbertshotel)
"tZ" = (
/obj/item/toy/toy_dagger,
/obj/effect/decal/cleanable/dirt/dust,
/obj/structure/table/wood/shuttle_bar,
/turf/open/floor/wood/large,
/area/misc/hilbertshotel)
"uX" = (
/obj/structure/spacevine,
/turf/open/misc/dirt/jungle/dark,
/area/misc/hilbertshotel)
"wb" = (
/obj/structure/flora/rock/pile,
/obj/machinery/vending/dorms,
/turf/open/misc/dirt/jungle/dark,
/area/misc/hilbertshotel)
"wl" = (
/obj/effect/decal/cleanable/cobweb,
/obj/effect/mob_spawn/corpse/human/miner,
/obj/effect/spawner/random/decoration/glowstick{
	pixel_x = 10;
	pixel_y = 9
	},
/obj/item/flashlight/lantern/on{
	pixel_x = -10;
	pixel_y = 5
	},
/turf/open/misc/dirt/jungle/dark,
/area/misc/hilbertshotel)
"wu" = (
/obj/structure/flora/rock,
/obj/effect/decal/cleanable/cobweb/cobweb2,
/turf/open/misc/dirt/jungle/dark,
/area/misc/hilbertshotel)
"wS" = (
/obj/effect/decal/cleanable/xenoblood,
/obj/structure/closet/crate,
/obj/item/flashlight{
	pixel_x = 3;
	pixel_y = -1
	},
/obj/item/flashlight{
	pixel_x = -5;
	pixel_y = -4
	},
/obj/item/flashlight/flare,
/obj/item/flashlight/flare{
	pixel_x = 2;
	pixel_y = 3
	},
/obj/item/flashlight/flare{
	pixel_x = 0;
	pixel_y = 5
	},
/obj/item/clothing/head/utility/hardhat/white{
	pixel_x = -2;
	pixel_y = 0
	},
/obj/item/clothing/head/utility/hardhat/white{
	pixel_x = -8;
	pixel_y = 1
	},
/turf/open/misc/dirt/jungle/dark,
/area/misc/hilbertshotel)
"xT" = (
/obj/structure/spacevine,
/turf/closed/mineral/random/asteroid/rockplanet/labor,
/area/misc/hilbertshotel)
"zY" = (
/obj/effect/decal/cleanable/cobweb/cobweb2,
/obj/effect/decal/cleanable/greenglow/ecto,
/turf/open/misc/dirt/jungle/dark,
/area/misc/hilbertshotel)
"Ae" = (
/obj/structure/flora/rock/style_4,
/turf/open/misc/dirt/jungle/dark,
/area/misc/hilbertshotel)
"AO" = (
/obj/structure/spacevine,
/turf/open/water{
	planetary_atmos = 0
	},
/area/misc/hilbertshotel)
"BF" = (
/obj/effect/decal/cleanable/cobweb,
/obj/effect/decal/cleanable/dirt/dust,
/obj/structure/rack/wooden,
/obj/item/clothing/glasses/blindfold{
	pixel_x = 1;
	pixel_y = 5
	},
/obj/item/clothing/mask/muzzle,
/obj/item/restraints/handcuffs{
	icon_state = "brass_manacles";
	name = "cultist restraints";
	pixel_x = 0;
	pixel_y = -9
	},
/turf/open/floor/wood/large,
/area/misc/hilbertshotel)
"Dc" = (
/obj/structure/flora/ocean/glowweed{
	pixel_x = 15;
	pixel_y = 12
	},
/turf/open/misc/dirt/jungle/dark,
/area/misc/hilbertshotel)
"DR" = (
/obj/effect/decal/cleanable/dirt/dust,
/obj/effect/rune/apocalypse,
/turf/open/floor/wood/large,
/area/misc/hilbertshotel)
"DX" = (
/obj/effect/decal/cleanable/rubble,
/turf/open/misc/dirt/jungle/dark,
/area/misc/hilbertshotel)
"Ea" = (
/obj/structure/mineral_door/wood,
/obj/structure/barricade/wooden/crude,
/turf/open/misc/dirt/jungle/dark,
/area/misc/hilbertshotel)
"EX" = (
/obj/structure/flora/rock/pile/jungle/large,
/turf/open/misc/grass/jungle,
/area/misc/hilbertshotel)
"Gv" = (
/obj/effect/decal/cleanable/ash/large{
	pixel_x = -25;
	pixel_y = 12
	},
/obj/effect/decal/cleanable/dirt/dust,
/turf/open/floor/wood/large,
/area/misc/hilbertshotel)
"Ig" = (
/turf/closed/mineral/random/asteroid/rockplanet/labor{
	pixel_x = 0;
	pixel_y = 0
	},
/area/misc/hilbertshotel)
"Ix" = (
/obj/effect/decal/cleanable/dirt/dust,
/obj/machinery/door/morgue,
/turf/open/floor/wood/large,
/area/misc/hilbertshotel)
"Je" = (
/obj/machinery/room_controller/directional/north{
	layer = 3.5
	},
/turf/open/misc/dirt/jungle/dark,
/area/misc/hilbertshotel)
"JW" = (
/obj/structure/bed/double,
/obj/item/bedsheet/cult/double,
/obj/effect/decal/cleanable/dirt/dust,
/turf/open/floor/wood,
/area/misc/hilbertshotel)
"LC" = (
/obj/effect/decal/cleanable/dirt,
/obj/effect/decal/cleanable/dirt/dust,
/turf/open/floor/wood/large,
/area/misc/hilbertshotel)
"Mj" = (
/turf/closed/indestructible/hoteldoor{
	icon_state = "door_closed";
	icon = 'icons/obj/doors/puzzledoor/default.dmi'
	},
/area/misc/hilbertshotel)
"Mk" = (
/obj/structure/flora/rock/icy/style_3,
/obj/effect/decal/cleanable/cobweb/cobweb2,
/obj/effect/heretic_rune,
/turf/open/misc/dirt/jungle/dark,
/area/misc/hilbertshotel)
"Np" = (
/turf/open/water{
	planetary_atmos = 0
	},
/area/misc/hilbertshotel)
"NX" = (
/obj/effect/decal/cleanable/xenoblood,
/obj/item/forging/incomplete/pickaxe{
	pixel_x = -12;
	pixel_y = -1
	},
/turf/open/misc/dirt/jungle/dark,
/area/misc/hilbertshotel)
"Oh" = (
/obj/structure/table/wood,
/obj/effect/spawner/random/food_or_drink/booze{
	pixel_x = -8;
	pixel_y = 6
	},
/obj/effect/spawner/random/food_or_drink/dinner{
	pixel_x = 4;
	pixel_y = 5
	},
/turf/open/floor/wood/large{
	invisibility = 1
	},
/area/misc/hilbertshotel)
"PK" = (
/obj/structure/flora/rock/icy/style_2,
/turf/open/misc/grass/jungle,
/area/misc/hilbertshotel)
"QJ" = (
/obj/structure/dresser,
/obj/effect/decal/cleanable/dirt/dust,
/turf/open/floor/wood/large,
/area/misc/hilbertshotel)
"SV" = (
/obj/structure/bed/maint,
/turf/open/misc/dirt/jungle/dark,
/area/misc/hilbertshotel)
"Tu" = (
/turf/open/misc/dirt/jungle/dark,
/area/misc/hilbertshotel)
"UU" = (
/obj/item/crowbar,
/turf/open/misc/dirt/jungle/dark,
/area/misc/hilbertshotel)
"UY" = (
/obj/item/flashlight/lantern/on{
	pixel_x = 9;
	pixel_y = 9
	},
/turf/open/misc/dirt/jungle/dark,
/area/misc/hilbertshotel)
"Wl" = (
/obj/effect/decal/cleanable/cobweb/cobweb2,
/obj/machinery/portable_atmospherics/scrubber,
/turf/open/misc/dirt/jungle/dark,
/area/misc/hilbertshotel)
"WX" = (
/obj/structure/flora/rock/pile,
/obj/structure/flora/rock/pile/jungle/style_2,
/turf/open/misc/dirt/jungle/dark,
/area/misc/hilbertshotel)
"YW" = (
/obj/effect/decal/cleanable/blood/old,
/obj/effect/decal/cleanable/dirt/dust,
/turf/open/floor/wood/large,
/area/misc/hilbertshotel)
"Zq" = (
/turf/closed/mineral/random/asteroid/rockplanet/labor,
/area/misc/hilbertshotel)

(1,1,1) = {"
Zq
Zq
Zq
Zq
Zq
Zq
Zq
Zq
Zq
Zq
Zq
Zq
Zq
Zq
Zq
"}
(2,1,1) = {"
Zq
Zq
Mj
Zq
Zq
Zq
wl
jT
wS
jr
Zq
Zq
Zq
Zq
Zq
"}
(3,1,1) = {"
Zq
Zq
Tu
Tu
Zq
Zq
tE
NX
dT
Tu
Tu
SV
Zq
Zq
Zq
"}
(4,1,1) = {"
Zq
gr
Je
Tu
DX
Zq
Ig
Ig
Wl
UY
Tu
Tu
Tu
Oh
Zq
"}
(5,1,1) = {"
Zq
Zq
Zq
DX
DX
kh
Ig
Ig
xT
xT
uX
DX
jx
oZ
Zq
"}
(6,1,1) = {"
Zq
Zq
Zq
wu
Tu
Tu
DX
xT
xT
xT
uX
Zq
Zq
Zq
Zq
"}
(7,1,1) = {"
Zq
Zq
Zq
Zq
ar
Tu
Tu
Tu
lY
uX
Tu
Tu
Zq
Zq
Zq
"}
(8,1,1) = {"
Zq
BF
Zq
Zq
DX
Tu
Tu
Tu
xT
zY
Tu
Tu
Ae
Zq
Zq
"}
(9,1,1) = {"
Zq
gQ
Zq
Zq
Zq
Ig
Mk
Tu
Zq
Zq
fa
pv
Tu
wb
Zq
"}
(10,1,1) = {"
Zq
Ix
Zq
Zq
Zq
Ig
Zq
UU
Zq
Zq
Zq
Dc
Tu
pD
Zq
"}
(11,1,1) = {"
Zq
gQ
gQ
gQ
LC
gQ
Ea
Tu
Zq
Zq
Zq
WX
Tu
Tu
Zq
"}
(12,1,1) = {"
Zq
tZ
nA
gQ
DR
gQ
Zq
Zq
Zq
Zq
cy
Np
EX
kS
Zq
"}
(13,1,1) = {"
Zq
pm
Gv
gQ
YW
gQ
Zq
Zq
Zq
aS
Np
Np
Np
PK
Zq
"}
(14,1,1) = {"
Zq
gQ
gQ
gQ
gQ
gQ
Zq
xT
xT
AO
Np
Np
Np
Np
Zq
"}
(15,1,1) = {"
Zq
mK
QJ
JW
aC
kD
Zq
xT
AO
AO
AO
Np
Np
Np
Zq
"}
(16,1,1) = {"
Zq
Zq
Zq
Zq
Zq
Zq
Zq
xT
xT
xT
xT
Zq
Zq
Zq
Zq
"}
