//MAP CONVERTED BY dmm2tgm.py THIS HEADER COMMENT PREVENTS RECONVERSION, DO NOT REMOVE
"aj" = (
/obj/structure/table/wood/shuttle_bar,
/obj/item/storage/box/matches,
/obj/item/cigarette/cigar{
	pixel_x = 7;
	pixel_y = 10
	},
/obj/machinery/firealarm/directional/west{
	soundloop = /datum/looping_sound/firealarm;
	appearance_power_state = 0;
	is_operational = 0
	},
/turf/open/indestructible/hotelwood{
	force_no_gravity = 1
	},
/area/misc/hilbertshotel)
"ay" = (
/obj/effect/mapping_helpers/broken_floor,
/obj/effect/spawner/random/trash/moisture_trap,
/turf/open/indestructible/plating{
	force_no_gravity = 1
	},
/area/misc/hilbertshotel)
"aD" = (
/obj/machinery/atmospherics/pipe/smart/manifold/supply/hidden/layer2,
/obj/machinery/atmospherics/pipe/smart/manifold/scrubbers/hidden/layer4,
/obj/machinery/vending/dorms,
/turf/open/indestructible/hotelwood{
	force_no_gravity = 1
	},
/area/misc/hilbertshotel)
"aG" = (
/obj/machinery/atmospherics/pipe/smart/manifold/scrubbers/hidden/layer4,
/obj/machinery/atmospherics/pipe/smart/manifold/supply/hidden/layer2,
/obj/structure/cable,
/turf/closed/indestructible/titanium,
/area/misc/hilbertshotel)
"bl" = (
/obj/structure/sign/poster/official/safety_internals/directional/north,
/turf/open/indestructible/dark/textured{
	force_no_gravity = 1;
	name = "Dark Tiling"
	},
/area/misc/hilbertshotel)
"cA" = (
/obj/effect/mapping_helpers/broken_floor,
/obj/machinery/hydroponics/constructable,
/obj/effect/mapping_helpers/broken_machine,
/turf/open/indestructible/dark/textured{
	force_no_gravity = 1;
	name = "Dark Tiling"
	},
/area/misc/hilbertshotel)
"cK" = (
/obj/effect/mapping_helpers/burnt_floor,
/obj/machinery/light/red/dim/directional/south,
/turf/open/indestructible/dark/textured{
	force_no_gravity = 1;
	name = "Dark Tiling"
	},
/area/misc/hilbertshotel)
"cO" = (
/obj/machinery/atmospherics/pipe/smart/manifold/supply/hidden/layer2,
/turf/open/indestructible/dark/textured{
	force_no_gravity = 1;
	name = "Dark Tiling"
	},
/area/misc/hilbertshotel)
"dS" = (
/obj/machinery/atmospherics/components/unary/vent_pump/on/layer2,
/turf/open/indestructible/dark/textured{
	force_no_gravity = 1;
	name = "Dark Tiling"
	},
/area/misc/hilbertshotel)
"dY" = (
/obj/machinery/light/broken/directional/north,
/obj/structure/showcase/fakeid{
	name = "research console"
	},
/turf/open/indestructible/dark/textured{
	force_no_gravity = 1;
	name = "Dark Tiling"
	},
/area/misc/hilbertshotel)
"eM" = (
/obj/structure/showcase{
	icon = 'icons/obj/machines/research.dmi';
	icon_state = "protolathe";
	name = "Science Protolathe";
	desc = "A special protolathe with a built in interface meant for departmental usage, with built in ExoSync receivers allowing it to print designs researched that match its ROM-encoded department type."
	},
/turf/open/indestructible/dark/textured{
	force_no_gravity = 1;
	name = "Dark Tiling"
	},
/area/misc/hilbertshotel)
"eZ" = (
/obj/structure/chair/comfy/brown{
	dir = 8
	},
/turf/open/indestructible/hotelwood{
	force_no_gravity = 1
	},
/area/misc/hilbertshotel)
"fM" = (
/obj/machinery/firealarm/directional/west{
	soundloop = /datum/looping_sound/firealarm;
	appearance_power_state = 0;
	is_operational = 0
	},
/obj/item/flashlight/flare{
	start_on = 1
	},
/obj/item/crowbar/large,
/turf/open/indestructible/dark/textured{
	force_no_gravity = 1;
	name = "Dark Tiling"
	},
/area/misc/hilbertshotel)
"gG" = (
/obj/structure/cable,
/obj/machinery/atmospherics/pipe/smart/manifold/supply/hidden/layer2,
/obj/machinery/atmospherics/pipe/smart/manifold/scrubbers/hidden/layer4,
/turf/closed/indestructible/hoteldoor{
	icon_state = "closed";
	icon = 'modular_skyrat/modules/aesthetics/airlock/icons/airlocks/station2/glass.dmi';
	baseturfs = /turf/open/indestructible/plating
	},
/area/misc/hilbertshotel)
"ia" = (
/obj/item/wallframe/intercom,
/turf/closed/indestructible/titanium{
	baseturfs = /turf/open/indestructible/plating
	},
/area/misc/hilbertshotel)
"jp" = (
/turf/open/indestructible/dark/textured{
	force_no_gravity = 1;
	name = "Dark Tiling"
	},
/area/misc/hilbertshotel)
"jx" = (
/obj/effect/spawner/structure/window/reinforced/plasma,
/obj/structure/cable,
/obj/effect/mapping_helpers/damaged_window,
/obj/effect/mapping_helpers/damaged_window,
/turf/open/indestructible/plating{
	force_no_gravity = 1
	},
/area/misc/hilbertshotel)
"jK" = (
/obj/effect/mapping_helpers/burnt_floor,
/obj/machinery/light/broken/directional/north,
/obj/machinery/vending/hydronutrients,
/obj/effect/mapping_helpers/broken_machine,
/turf/open/indestructible/dark/textured{
	force_no_gravity = 1;
	name = "Dark Tiling"
	},
/area/misc/hilbertshotel)
"jV" = (
/obj/effect/spawner/structure/window/reinforced/plasma,
/obj/structure/cable,
/obj/effect/mapping_helpers/damaged_window,
/turf/open/indestructible/plating{
	force_no_gravity = 1
	},
/area/misc/hilbertshotel)
"kg" = (
/obj/machinery/atmospherics/pipe/smart/manifold/supply/hidden/layer2,
/obj/machinery/atmospherics/pipe/smart/manifold/scrubbers/hidden/layer4,
/turf/open/indestructible/hotelwood{
	force_no_gravity = 1
	},
/area/misc/hilbertshotel)
"kG" = (
/obj/machinery/atmospherics/pipe/smart/manifold/supply/hidden/layer2,
/obj/machinery/atmospherics/pipe/smart/manifold/scrubbers/hidden/layer4,
/turf/closed/indestructible/titanium{
	baseturfs = /turf/open/indestructible/plating
	},
/area/misc/hilbertshotel)
"kJ" = (
/obj/structure/table/wood/shuttle_bar,
/obj/machinery/light/very_dim/directional/east,
/turf/open/indestructible/hotelwood{
	force_no_gravity = 1
	},
/area/misc/hilbertshotel)
"kX" = (
/obj/machinery/atmospherics/pipe/smart/manifold/supply/hidden/layer2,
/obj/effect/turf_decal/vg_decals/atmos/air,
/turf/open/indestructible/plating{
	force_no_gravity = 1
	},
/area/misc/hilbertshotel)
"lz" = (
/obj/structure/cable,
/turf/open/indestructible/plating{
	force_no_gravity = 1
	},
/area/misc/hilbertshotel)
"me" = (
/obj/structure/closet/emcloset{
	anchored = 1
	},
/turf/open/indestructible/dark/textured{
	force_no_gravity = 1;
	name = "Dark Tiling"
	},
/area/misc/hilbertshotel)
"ms" = (
/obj/structure/sign/departments/engineering/directional/west,
/turf/open/indestructible/dark/textured{
	force_no_gravity = 1;
	name = "Dark Tiling"
	},
/area/misc/hilbertshotel)
"mv" = (
/obj/item/melee/baton/security/cattleprod{
	pixel_x = -6;
	pixel_y = 6;
	preload_cell_type = /obj/item/stock_parts/power_store/cell/hyper
	},
/obj/effect/decal/cleanable/blood/old,
/obj/item/restraints/handcuffs/cable/yellow,
/turf/open/indestructible/plating{
	force_no_gravity = 1
	},
/area/misc/hilbertshotel)
"mH" = (
/obj/machinery/atmospherics/pipe/smart/manifold/scrubbers/hidden/layer4,
/obj/machinery/portable_atmospherics/scrubber,
/turf/open/indestructible/plating{
	force_no_gravity = 1
	},
/area/misc/hilbertshotel)
"mL" = (
/obj/item/paperwork,
/obj/machinery/atmospherics/components/unary/vent_pump/on/layer2,
/turf/open/indestructible/dark/textured{
	force_no_gravity = 1;
	name = "Dark Tiling"
	},
/area/misc/hilbertshotel)
"nx" = (
/obj/structure/cable,
/turf/closed/indestructible/titanium{
	baseturfs = /turf/open/indestructible/plating
	},
/area/misc/hilbertshotel)
"nV" = (
/obj/machinery/atmospherics/components/unary/vent_scrubber/on/layer4,
/turf/open/indestructible/dark/textured{
	force_no_gravity = 1;
	name = "Dark Tiling"
	},
/area/misc/hilbertshotel)
"oe" = (
/obj/structure/cable,
/obj/machinery/atmospherics/pipe/smart/manifold/supply/hidden/layer2,
/obj/machinery/atmospherics/pipe/smart/manifold/scrubbers/hidden/layer4,
/obj/effect/mapping_helpers/broken_floor,
/turf/open/indestructible/plating{
	force_no_gravity = 1
	},
/area/misc/hilbertshotel)
"oW" = (
/obj/structure/cable,
/obj/machinery/atmospherics/pipe/smart/manifold/supply/hidden/layer2,
/obj/machinery/atmospherics/pipe/smart/manifold/scrubbers/hidden/layer4,
/turf/open/indestructible/dark/textured{
	force_no_gravity = 1;
	name = "Dark Tiling"
	},
/area/misc/hilbertshotel)
"pz" = (
/obj/machinery/atmospherics/pipe/smart/manifold/supply/hidden/layer2,
/obj/machinery/atmospherics/pipe/smart/manifold/scrubbers/hidden/layer4,
/obj/structure/table/wood/shuttle_bar,
/obj/item/flashlight/lamp/green{
	pixel_y = 14
	},
/obj/item/reagent_containers/cup/glass/flask/gold{
	pixel_x = 6;
	pixel_y = 5
	},
/turf/open/indestructible/hotelwood{
	force_no_gravity = 1
	},
/area/misc/hilbertshotel)
"qg" = (
/obj/effect/mapping_helpers/burnt_floor,
/turf/open/indestructible/dark/textured{
	force_no_gravity = 1;
	name = "Dark Tiling"
	},
/area/misc/hilbertshotel)
"qm" = (
/obj/machinery/atmospherics/pipe/smart/manifold/supply/hidden/layer2,
/obj/machinery/atmospherics/pipe/smart/manifold/scrubbers/hidden/layer4,
/turf/open/floor/wood/tile{
	force_no_gravity = 1
	},
/area/misc/hilbertshotel)
"qp" = (
/obj/structure/bed/double,
/obj/item/bedsheet/hop/double,
/turf/open/indestructible/hotelwood{
	force_no_gravity = 1
	},
/area/misc/hilbertshotel)
"qA" = (
/obj/structure/closet/secure_closet/personal/cabinet{
	anchored = 1
	},
/obj/machinery/light/red/dim/directional/east,
/turf/open/indestructible/hotelwood{
	force_no_gravity = 1
	},
/area/misc/hilbertshotel)
"rs" = (
/obj/structure/cable,
/turf/closed/indestructible/reinforced,
/area/misc/hilbertshotel)
"rV" = (
/obj/machinery/vending/hydroseeds,
/obj/effect/mapping_helpers/broken_machine,
/turf/open/indestructible/dark/textured{
	force_no_gravity = 1;
	name = "Dark Tiling"
	},
/area/misc/hilbertshotel)
"rX" = (
/obj/structure/closet/crate/internals,
/turf/open/indestructible/dark/textured{
	force_no_gravity = 1;
	name = "Dark Tiling"
	},
/area/misc/hilbertshotel)
"sH" = (
/turf/closed/indestructible/hoteldoor{
	icon_state = "closed";
	icon = 'modular_skyrat/modules/aesthetics/airlock/icons/airlocks/station2/glass.dmi';
	baseturfs = /turf/open/indestructible/plating
	},
/area/misc/hilbertshotel)
"tb" = (
/obj/structure/broken_flooring/plating/always_floorplane/directional,
/turf/open/indestructible/plating{
	force_no_gravity = 1
	},
/area/misc/hilbertshotel)
"tY" = (
/obj/structure/grille/broken,
/turf/open/space/basic,
/area/misc/hilbertshotel)
"ua" = (
/obj/item/stack/sheet/mineral/titanium{
	pixel_x = 4;
	pixel_y = 4
	},
/obj/effect/mapping_helpers/burnt_floor,
/obj/effect/mapping_helpers/burnt_floor,
/turf/open/indestructible/dark/textured{
	force_no_gravity = 1;
	name = "Dark Tiling"
	},
/area/misc/hilbertshotel)
"uG" = (
/obj/machinery/atmospherics/components/unary/vent_scrubber/on/layer4,
/obj/machinery/light/red/dim/directional/west,
/turf/open/indestructible/plating{
	force_no_gravity = 1
	},
/area/misc/hilbertshotel)
"uL" = (
/obj/item/wallframe/light_fixture{
	pixel_x = -7;
	pixel_y = 6
	},
/obj/item/stack/cable_coil/cut,
/obj/item/light/tube/broken,
/turf/open/indestructible/plating{
	force_no_gravity = 1
	},
/area/misc/hilbertshotel)
"uN" = (
/obj/machinery/atmospherics/components/unary/vent_scrubber/on/layer4,
/turf/open/floor/wood/tile{
	force_no_gravity = 1
	},
/area/misc/hilbertshotel)
"vu" = (
/obj/effect/decal/cleanable/dirt,
/obj/machinery/light/red/dim/directional/north,
/turf/open/indestructible/dark/textured{
	force_no_gravity = 1;
	name = "Dark Tiling"
	},
/area/misc/hilbertshotel)
"vI" = (
/obj/machinery/light/red/dim/directional/west,
/turf/open/indestructible/dark/textured{
	force_no_gravity = 1;
	name = "Dark Tiling"
	},
/area/misc/hilbertshotel)
"vJ" = (
/obj/effect/spawner/structure/window/reinforced/plasma,
/obj/effect/mapping_helpers/damaged_window,
/obj/structure/cable,
/turf/open/indestructible/plating,
/area/misc/hilbertshotel)
"wn" = (
/obj/structure/closet/firecloset{
	anchored = 1
	},
/turf/open/indestructible/dark/textured{
	force_no_gravity = 1;
	name = "Dark Tiling"
	},
/area/misc/hilbertshotel)
"wr" = (
/obj/machinery/atmospherics/pipe/smart/manifold/scrubbers/hidden/layer4,
/obj/machinery/atmospherics/pipe/smart/manifold/supply/hidden/layer2,
/obj/structure/cable,
/obj/machinery/door/firedoor/closed,
/turf/open/indestructible/dark/textured{
	force_no_gravity = 1;
	name = "Dark Tiling"
	},
/area/misc/hilbertshotel)
"yg" = (
/obj/machinery/atmospherics/components/unary/vent_pump/on/layer2,
/turf/open/floor/wood/tile{
	force_no_gravity = 1
	},
/area/misc/hilbertshotel)
"yT" = (
/obj/effect/decal/cleanable/blood/splatter,
/obj/structure/cable,
/obj/machinery/atmospherics/pipe/smart/manifold/scrubbers/hidden/layer4,
/obj/machinery/atmospherics/pipe/smart/manifold/supply/hidden/layer2,
/obj/item/flashlight,
/turf/open/indestructible/dark/textured{
	force_no_gravity = 1;
	name = "Dark Tiling"
	},
/area/misc/hilbertshotel)
"yZ" = (
/obj/structure/cable,
/obj/machinery/atmospherics/components/tank/air/layer2,
/turf/open/indestructible/plating{
	force_no_gravity = 1
	},
/area/misc/hilbertshotel)
"zG" = (
/obj/effect/mapping_helpers/broken_floor,
/turf/open/indestructible/plating{
	force_no_gravity = 1
	},
/area/misc/hilbertshotel)
"Ak" = (
/obj/machinery/atmospherics/pipe/smart/manifold/scrubbers/hidden/layer4,
/turf/open/floor/wood/tile{
	force_no_gravity = 1
	},
/area/misc/hilbertshotel)
"Au" = (
/obj/effect/decal/cleanable/dirt,
/obj/effect/spawner/random/structure/closet_maintenance,
/turf/open/indestructible/plating{
	force_no_gravity = 1
	},
/area/misc/hilbertshotel)
"Ax" = (
/obj/item/wallframe/firecloset,
/turf/closed/indestructible/titanium{
	baseturfs = /turf/open/indestructible/plating
	},
/area/misc/hilbertshotel)
"AA" = (
/obj/structure/filingcabinet,
/turf/open/indestructible/dark/textured{
	force_no_gravity = 1;
	name = "Dark Tiling"
	},
/area/misc/hilbertshotel)
"Bl" = (
/obj/machinery/power/smes,
/obj/structure/cable,
/obj/effect/mapping_helpers/broken_machine,
/turf/open/indestructible/plating{
	force_no_gravity = 1
	},
/area/misc/hilbertshotel)
"Bu" = (
/obj/machinery/door/airlock/rd,
/obj/machinery/door/firedoor/closed,
/turf/open/indestructible/hotelwood{
	force_no_gravity = 1
	},
/area/misc/hilbertshotel)
"BE" = (
/obj/structure/table/reinforced/plasmarglass,
/obj/machinery/recharger,
/obj/item/paper_bin/carbon{
	pixel_x = -5;
	pixel_y = 6
	},
/obj/structure/cable,
/obj/machinery/light/red/dim/directional/south,
/obj/item/paper{
	pixel_x = 7;
	pixel_y = 8;
	name = "ATTENTION!";
	default_raw_text = "<B>ATTENTION!</B><BR><BR>This is a hand-typed letter from Research Director D. Warner. The Hydroponics-Cloning Farm has been engulfed by an unknown Anomaly simply referred to as a 'Void flux'. If you are reading this, and this portion of the station has yet not been safely recovered from whatever depths of presumably the void it resides in, proceed to the Bluespace Network pad down the Eastern Corridor.<BR><BR>-Signed, Research Director D. Warner"
	},
/turf/open/indestructible/dark/textured{
	force_no_gravity = 1;
	name = "Dark Tiling"
	},
/area/misc/hilbertshotel)
"Cd" = (
/obj/effect/spawner/structure/window/reinforced/plasma,
/obj/structure/cable,
/turf/open/indestructible/plating{
	force_no_gravity = 1
	},
/area/misc/hilbertshotel)
"Cq" = (
/obj/machinery/door/airlock/research,
/obj/machinery/door/firedoor/closed,
/turf/open/indestructible/dark/textured{
	force_no_gravity = 1;
	name = "Dark Tiling"
	},
/area/misc/hilbertshotel)
"CM" = (
/obj/structure/cable,
/obj/machinery/atmospherics/pipe/smart/manifold/supply/hidden/layer2,
/obj/machinery/atmospherics/pipe/smart/manifold/scrubbers/hidden/layer4,
/obj/machinery/door/airlock/maintenance_hatch,
/obj/machinery/door/firedoor/closed,
/turf/open/indestructible/dark/textured{
	force_no_gravity = 1;
	name = "Dark Tiling"
	},
/area/misc/hilbertshotel)
"Dc" = (
/obj/structure/trash_pile,
/turf/open/indestructible/plating{
	force_no_gravity = 1
	},
/area/misc/hilbertshotel)
"DS" = (
/obj/structure/cable,
/obj/machinery/atmospherics/pipe/smart/manifold/supply/hidden/layer2,
/obj/machinery/atmospherics/pipe/smart/manifold/scrubbers/hidden/layer4,
/turf/open/indestructible/plating{
	force_no_gravity = 1
	},
/area/misc/hilbertshotel)
"Ed" = (
/obj/effect/mapping_helpers/broken_floor,
/turf/open/indestructible/dark/textured{
	force_no_gravity = 1;
	name = "Dark Tiling"
	},
/area/misc/hilbertshotel)
"Ew" = (
/obj/effect/mapping_helpers/burnt_floor,
/obj/machinery/hydroponics/constructable,
/obj/effect/mapping_helpers/broken_machine,
/turf/open/indestructible/dark/textured{
	force_no_gravity = 1;
	name = "Dark Tiling"
	},
/area/misc/hilbertshotel)
"EB" = (
/obj/effect/decal/cleanable/dirt,
/turf/open/indestructible/plating{
	force_no_gravity = 1
	},
/area/misc/hilbertshotel)
"Fc" = (
/obj/structure/closet/l3closet/scientist{
	anchored = 1
	},
/turf/open/indestructible/dark/textured{
	force_no_gravity = 1;
	name = "Dark Tiling"
	},
/area/misc/hilbertshotel)
"FB" = (
/obj/machinery/light/red/dim/directional/south,
/turf/open/indestructible/dark/textured{
	force_no_gravity = 1;
	name = "Dark Tiling"
	},
/area/misc/hilbertshotel)
"Gq" = (
/obj/effect/spawner/structure/window/reinforced/plasma,
/obj/structure/grille/broken,
/obj/structure/cable,
/turf/open/indestructible/plating{
	force_no_gravity = 1
	},
/area/misc/hilbertshotel)
"Ht" = (
/obj/machinery/atmospherics/pipe/smart/manifold/scrubbers/hidden/layer4,
/obj/machinery/atmospherics/pipe/smart/manifold/supply/hidden/layer2,
/obj/structure/cable,
/obj/machinery/light/red/dim/directional/south,
/turf/open/indestructible/dark/textured{
	force_no_gravity = 1;
	name = "Dark Tiling"
	},
/area/misc/hilbertshotel)
"IN" = (
/obj/effect/spawner/structure/window/reinforced/plasma,
/obj/machinery/atmospherics/pipe/smart/manifold/scrubbers/hidden/layer4,
/obj/machinery/atmospherics/pipe/smart/manifold/supply/hidden/layer2,
/obj/structure/cable,
/turf/open/indestructible/dark/textured{
	force_no_gravity = 1;
	name = "Dark Tiling"
	},
/area/misc/hilbertshotel)
"IP" = (
/obj/structure/cable,
/obj/machinery/atmospherics/pipe/smart/manifold/supply/hidden/layer2,
/obj/machinery/atmospherics/pipe/smart/manifold/scrubbers/hidden/layer4,
/obj/effect/decal/cleanable/dirt,
/turf/open/indestructible/plating{
	force_no_gravity = 1
	},
/area/misc/hilbertshotel)
"IY" = (
/obj/item/crowbar/large,
/turf/open/indestructible/dark/textured{
	force_no_gravity = 1;
	name = "Dark Tiling"
	},
/area/misc/hilbertshotel)
"Jr" = (
/turf/closed/indestructible/titanium,
/area/misc/hilbertshotel)
"Ju" = (
/obj/effect/spawner/structure/window/reinforced/plasma,
/obj/structure/cable,
/obj/machinery/door/firedoor/closed,
/turf/open/indestructible/plating,
/area/misc/hilbertshotel)
"Ka" = (
/turf/open/indestructible/hotelwood{
	force_no_gravity = 1
	},
/area/misc/hilbertshotel)
"KJ" = (
/obj/machinery/atmospherics/pipe/smart/manifold/scrubbers/hidden/layer4,
/obj/machinery/atmospherics/pipe/smart/manifold/supply/hidden/layer2,
/obj/structure/cable,
/obj/structure/sign/departments/maint/directional/south,
/turf/open/indestructible/dark/textured{
	force_no_gravity = 1;
	name = "Dark Tiling"
	},
/area/misc/hilbertshotel)
"Lo" = (
/obj/effect/decal/cleanable/dirt,
/obj/machinery/door/airlock/engineering,
/obj/machinery/door/firedoor/closed,
/turf/open/indestructible/plating{
	force_no_gravity = 1
	},
/area/misc/hilbertshotel)
"Lz" = (
/obj/structure/dresser,
/turf/open/indestructible/hotelwood{
	force_no_gravity = 1
	},
/area/misc/hilbertshotel)
"Mc" = (
/turf/open/space/basic,
/area/misc/hilbertshotel)
"My" = (
/obj/item/stack/sheet/mineral/titanium{
	pixel_x = -7;
	pixel_y = 5
	},
/obj/structure/cable,
/turf/closed/indestructible/titanium{
	baseturfs = /turf/open/indestructible/plating
	},
/area/misc/hilbertshotel)
"ME" = (
/obj/effect/mapping_helpers/broken_floor,
/obj/structure/reagent_dispensers/watertank,
/turf/open/indestructible/plating{
	force_no_gravity = 1
	},
/area/misc/hilbertshotel)
"MK" = (
/obj/effect/decal/cleanable/dirt,
/turf/closed/indestructible/hoteldoor{
	icon_state = "closed";
	icon = 'modular_skyrat/modules/aesthetics/airlock/icons/airlocks/station2/glass.dmi';
	baseturfs = /turf/open/indestructible/plating
	},
/area/misc/hilbertshotel)
"Nb" = (
/obj/item/stack/rods{
	amount = 8
	},
/obj/effect/spawner/structure/window/reinforced/plasma,
/obj/structure/cable,
/obj/effect/mapping_helpers/damaged_window,
/turf/open/indestructible/plating{
	force_no_gravity = 1
	},
/area/misc/hilbertshotel)
"Oe" = (
/obj/effect/spawner/structure/window/reinforced/plasma,
/obj/effect/mapping_helpers/damaged_window,
/turf/open/indestructible/plating,
/area/misc/hilbertshotel)
"Og" = (
/obj/machinery/room_controller/directional/south,
/turf/open/indestructible/dark/textured{
	force_no_gravity = 1;
	name = "Dark Tiling"
	},
/area/misc/hilbertshotel)
"PC" = (
/obj/machinery/firealarm/directional/north{
	soundloop = /datum/looping_sound/firealarm;
	appearance_power_state = 0;
	is_operational = 0
	},
/obj/machinery/atmospherics/components/unary/vent_scrubber/on/layer4,
/turf/open/indestructible/dark/textured{
	force_no_gravity = 1;
	name = "Dark Tiling"
	},
/area/misc/hilbertshotel)
"PP" = (
/obj/effect/mapping_helpers/broken_floor,
/obj/machinery/atmospherics/pipe/smart/manifold/scrubbers/hidden/layer4,
/obj/machinery/atmospherics/pipe/smart/manifold/supply/hidden/layer2,
/obj/structure/cable,
/turf/open/indestructible/dark/textured{
	force_no_gravity = 1;
	name = "Dark Tiling"
	},
/area/misc/hilbertshotel)
"QK" = (
/obj/machinery/atmospherics/pipe/smart/manifold/scrubbers/hidden/layer4,
/turf/closed/indestructible/titanium,
/area/misc/hilbertshotel)
"QO" = (
/obj/machinery/door/airlock/multi_tile/metal,
/obj/machinery/atmospherics/pipe/smart/manifold/scrubbers/hidden/layer4,
/obj/machinery/atmospherics/pipe/smart/manifold/supply/hidden/layer2,
/obj/structure/cable,
/turf/open/indestructible/dark/textured{
	force_no_gravity = 1;
	name = "Dark Tiling"
	},
/area/misc/hilbertshotel)
"Re" = (
/obj/effect/mapping_helpers/burnt_floor,
/obj/machinery/hydroponics/constructable,
/turf/open/indestructible/dark/textured{
	force_no_gravity = 1;
	name = "Dark Tiling"
	},
/area/misc/hilbertshotel)
"Rt" = (
/turf/closed/indestructible/titanium{
	baseturfs = /turf/open/indestructible/plating
	},
/area/misc/hilbertshotel)
"SL" = (
/obj/effect/spawner/structure/window/reinforced/plasma,
/turf/open/indestructible/plating,
/area/misc/hilbertshotel)
"Tx" = (
/obj/structure/girder/reinforced,
/obj/item/stack/sheet/mineral/titanium{
	pixel_x = 4;
	pixel_y = 4
	},
/obj/effect/mapping_helpers/broken_floor,
/turf/open/indestructible/plating,
/area/misc/hilbertshotel)
"TR" = (
/obj/effect/decal/cleanable/dirt,
/obj/machinery/atmospherics/pipe/smart/manifold/supply/hidden/layer2,
/obj/machinery/door/airlock/maintenance_hatch,
/obj/machinery/door/firedoor/closed,
/turf/open/indestructible/plating{
	force_no_gravity = 1
	},
/area/misc/hilbertshotel)
"TY" = (
/obj/effect/mapping_helpers/broken_floor,
/obj/effect/decal/cleanable/glass/plasma,
/turf/open/indestructible/plating{
	force_no_gravity = 1
	},
/area/misc/hilbertshotel)
"Ul" = (
/obj/machinery/hydroponics/constructable,
/obj/machinery/atmospherics/pipe/smart/manifold/scrubbers/hidden/layer4,
/obj/machinery/atmospherics/pipe/smart/manifold/supply/hidden/layer2,
/obj/structure/cable,
/turf/open/indestructible/dark/textured{
	force_no_gravity = 1;
	name = "Dark Tiling"
	},
/area/misc/hilbertshotel)
"Uw" = (
/turf/open/indestructible/dark/textured{
	icon = 'modular_zubbers/icons/space/space.dmi';
	icon_state = "space";
	name = "space"
	},
/area/misc/hilbertshotel)
"UN" = (
/obj/structure/cable,
/obj/structure/closet/secure_closet/engineering_welding{
	anchored = 1
	},
/turf/open/indestructible/plating{
	force_no_gravity = 1
	},
/area/misc/hilbertshotel)
"UO" = (
/obj/effect/decal/cleanable/dirt,
/obj/machinery/firealarm/directional/west{
	soundloop = /datum/looping_sound/firealarm;
	appearance_power_state = 0;
	is_operational = 0
	},
/turf/open/indestructible/plating{
	force_no_gravity = 1
	},
/area/misc/hilbertshotel)
"Vh" = (
/obj/structure/cable,
/obj/effect/decal/cleanable/dirt,
/obj/structure/closet/secure_closet/engineering_electrical{
	anchored = 1
	},
/turf/open/indestructible/plating{
	force_no_gravity = 1
	},
/area/misc/hilbertshotel)
"Vj" = (
/obj/effect/spawner/random/trash/grime,
/turf/open/indestructible/plating{
	force_no_gravity = 1
	},
/area/misc/hilbertshotel)
"Wd" = (
/obj/structure/girder/reinforced,
/obj/item/stack/sheet/mineral/titanium{
	pixel_x = -7;
	pixel_y = 5
	},
/obj/effect/mapping_helpers/broken_floor,
/turf/open/indestructible/plating,
/area/misc/hilbertshotel)
"Wm" = (
/obj/item/flashlight,
/turf/open/indestructible/dark/textured{
	force_no_gravity = 1;
	name = "Dark Tiling"
	},
/area/misc/hilbertshotel)
"WL" = (
/obj/machinery/atmospherics/pipe/smart/manifold/scrubbers/hidden/layer4,
/obj/machinery/atmospherics/pipe/smart/manifold/supply/hidden/layer2,
/obj/structure/cable,
/turf/open/indestructible/dark/textured{
	force_no_gravity = 1;
	name = "Dark Tiling"
	},
/area/misc/hilbertshotel)
"Xm" = (
/obj/effect/decal/cleanable/glass/plasma,
/turf/open/indestructible/dark/textured{
	force_no_gravity = 1;
	name = "Dark Tiling"
	},
/area/misc/hilbertshotel)
"Xt" = (
/obj/item/stack/rods{
	amount = 12
	},
/obj/effect/spawner/structure/window/reinforced/plasma,
/obj/structure/cable,
/obj/effect/mapping_helpers/damaged_window,
/turf/open/indestructible/plating{
	force_no_gravity = 1
	},
/area/misc/hilbertshotel)
"Xy" = (
/obj/effect/spawner/structure/window/reinforced/plasma,
/obj/effect/mapping_helpers/damaged_window,
/obj/structure/cable,
/obj/machinery/door/firedoor/closed,
/turf/open/indestructible/plating,
/area/misc/hilbertshotel)
"Yh" = (
/obj/structure/grille/broken,
/obj/effect/decal/cleanable/glass/plasma,
/turf/open/indestructible/plating{
	force_no_gravity = 1
	},
/area/misc/hilbertshotel)
"Yk" = (
/obj/machinery/hydroponics/constructable,
/turf/open/indestructible/dark/textured{
	force_no_gravity = 1;
	name = "Dark Tiling"
	},
/area/misc/hilbertshotel)
"Zf" = (
/obj/effect/mapping_helpers/broken_floor,
/obj/effect/decal/cleanable/glass/plasma,
/obj/structure/frame/machine/secured,
/turf/open/indestructible/plating,
/area/misc/hilbertshotel)
"Zh" = (
/obj/effect/spawner/structure/window/reinforced/plasma,
/obj/structure/cable,
/turf/open/indestructible/plating,
/area/misc/hilbertshotel)
"Zk" = (
/obj/machinery/atmospherics/components/unary/vent_pump/on/layer2,
/turf/open/indestructible/plating{
	force_no_gravity = 1
	},
/area/misc/hilbertshotel)
"Zs" = (
/obj/machinery/gulag_teleporter{
	is_operational = 0;
	name = "Cloning Chamber";
	desc = "A deactivated Cloning Pod designed for the Hydroponics Research Wing."
	},
/obj/effect/mapping_helpers/broken_machine,
/turf/open/indestructible/dark/textured{
	force_no_gravity = 1;
	name = "Dark Tiling"
	},
/area/misc/hilbertshotel)
"ZQ" = (
/obj/structure/showcase/machinery/oldpod/used{
	dir = 1
	},
/obj/effect/mapping_helpers/broken_machine,
/turf/open/indestructible/dark/textured{
	force_no_gravity = 1;
	name = "Dark Tiling"
	},
/area/misc/hilbertshotel)

(1,1,1) = {"
vJ
vJ
Zh
nx
Rt
Rt
Rt
Rt
Rt
Rt
Rt
Rt
Rt
Mc
Mc
"}
(2,1,1) = {"
vJ
Zs
jp
AA
fM
rX
Fc
Rt
Bl
UO
uG
mH
QK
gG
Rt
"}
(3,1,1) = {"
Zh
eM
Wm
IY
mL
cO
ZQ
Rt
Vh
EB
Zk
kX
TR
DS
Rt
"}
(4,1,1) = {"
nx
dY
jp
mv
nV
yT
BE
nx
UN
lz
lz
yZ
nx
DS
SL
"}
(5,1,1) = {"
rs
nx
Wd
Tx
Cq
aG
Rt
Rt
Rt
Lo
Rt
Rt
Rt
DS
Oe
"}
(6,1,1) = {"
Mc
Ju
uL
zG
zG
wr
jp
jp
vI
jp
ms
wn
Rt
DS
SL
"}
(7,1,1) = {"
Mc
Xy
jp
tb
WL
wr
jp
jp
jp
jp
Ed
me
Rt
DS
Rt
"}
(8,1,1) = {"
rs
nx
Yh
Oe
IN
Jr
Jr
jp
jp
Rt
Rt
Rt
Rt
DS
Rt
"}
(9,1,1) = {"
ia
jp
Xm
jp
WL
jp
Jr
dS
oW
CM
DS
DS
IP
oe
Rt
"}
(10,1,1) = {"
Ax
rV
Yk
dS
Ul
jp
Jr
PC
KJ
Rt
Au
Vj
ay
Dc
Rt
"}
(11,1,1) = {"
Rt
jK
Ew
nV
Ul
FB
Jr
vu
WL
Rt
Rt
Rt
Rt
Rt
Rt
"}
(12,1,1) = {"
My
TY
ME
qg
PP
WL
QO
WL
Ht
kG
aD
kg
pz
aj
Rt
"}
(13,1,1) = {"
Cd
Gq
Zf
zG
Re
qg
qg
jp
jp
Bu
Ka
yg
qm
eZ
Rt
"}
(14,1,1) = {"
tY
Xt
jV
zG
cA
cK
Jr
bl
Og
Rt
Ka
uN
Ak
Ka
Rt
"}
(15,1,1) = {"
Mc
Uw
jx
Nb
TY
ua
Rt
sH
MK
Rt
qA
Lz
qp
kJ
Rt
"}
(16,1,1) = {"
Mc
Mc
Mc
Cd
Cd
nx
Rt
Mc
Mc
Rt
Rt
Rt
Rt
Rt
Rt
"}
