//MAP CONVERTED BY dmm2tgm.py THIS HEADER COMMENT PREVENTS RECONVERSION, DO NOT REMOVE
"aD" = (
/obj/structure/flora/rock/pile/jungle/style_random,
/obj/effect/turf_decal/weather/dirt{
	dir = 8
	},
/turf/open/floor/grass,
/area/misc/hilbertshotel)
"bC" = (
/obj/structure/flora/bush/fullgrass/style_random,
/obj/effect/turf_decal/weather/dirt{
	dir = 10
	},
/turf/open/floor/grass,
/area/misc/hilbertshotel)
"cw" = (
/obj/structure/flora/bush/fullgrass/style_random,
/obj/effect/turf_decal/weather/dirt{
	dir = 9
	},
/obj/structure/flora/rock/style_random,
/turf/open/floor/grass,
/area/misc/hilbertshotel)
"cP" = (
/obj/structure/flora/bush/reed/style_random,
/turf/open/water,
/area/misc/hilbertshotel)
"dv" = (
/obj/structure/flora/bush/fullgrass/style_random,
/obj/effect/turf_decal/weather/dirt,
/obj/structure/flora/bush/flowers_br/style_random,
/turf/open/floor/grass,
/area/misc/hilbertshotel)
"ef" = (
/obj/structure/flora/rock/pile/style_2,
/turf/open/floor/grass,
/area/misc/hilbertshotel)
"ez" = (
/obj/structure/flora/bush/large/style_random,
/obj/effect/turf_decal/weather/dirt{
	dir = 8
	},
/turf/open/floor/grass,
/area/misc/hilbertshotel)
"eR" = (
/obj/effect/turf_decal/weather/dirt{
	dir = 1
	},
/obj/structure/flora/bush/flowers_yw/style_random,
/turf/open/floor/grass,
/area/misc/hilbertshotel)
"fp" = (
/obj/structure/flora/bush/flowers_br/style_random,
/obj/effect/turf_decal/weather/dirt{
	dir = 5
	},
/turf/open/floor/grass,
/area/misc/hilbertshotel)
"gu" = (
/obj/structure/flora/bush/fullgrass/style_random,
/obj/effect/turf_decal/weather/dirt{
	dir = 1
	},
/turf/open/floor/grass,
/area/misc/hilbertshotel)
"hi" = (
/obj/structure/flora/bush/fullgrass/style_random,
/obj/effect/turf_decal/weather/dirt{
	dir = 4
	},
/turf/open/floor/grass,
/area/misc/hilbertshotel)
"iF" = (
/obj/structure/spacevine{
	name = "thick vines";
	opacity = 1
	},
/turf/closed/indestructible/rock,
/area/misc/hilbertshotel)
"js" = (
/obj/effect/turf_decal/weather/dirt{
	dir = 6
	},
/obj/effect/decal/cleanable/ants,
/turf/open/floor/grass,
/area/misc/hilbertshotel)
"ka" = (
/obj/structure/flora/bush/flowers_pp/style_random,
/turf/open/floor/grass,
/area/misc/hilbertshotel)
"kf" = (
/obj/effect/turf_decal/weather/dirt{
	dir = 1
	},
/obj/structure/flora/bush/fullgrass/style_random,
/turf/open/floor/grass,
/area/misc/hilbertshotel)
"kr" = (
/obj/effect/turf_decal/weather/dirt{
	dir = 1
	},
/obj/structure/flora/rock/pile/jungle/style_random,
/turf/open/floor/grass,
/area/misc/hilbertshotel)
"lf" = (
/obj/structure/flora/rock/pile{
	pixel_x = -3;
	pixel_y = -4
	},
/obj/effect/turf_decal/weather/dirt{
	dir = 5
	},
/turf/open/floor/grass,
/area/misc/hilbertshotel)
"lr" = (
/obj/structure/flora/bush/jungle/b/style_random,
/obj/structure/flora/bush/flowers_pp/style_random,
/turf/open/floor/grass,
/area/misc/hilbertshotel)
"lO" = (
/obj/structure/flora/bush/fullgrass/style_random,
/obj/effect/turf_decal/weather/dirt{
	dir = 8
	},
/turf/open/floor/grass,
/area/misc/hilbertshotel)
"mt" = (
/obj/effect/turf_decal/weather/dirt{
	dir = 8
	},
/obj/structure/flora/rock/style_random,
/turf/open/floor/grass,
/area/misc/hilbertshotel)
"mW" = (
/obj/effect/turf_decal/weather/dirt{
	dir = 8
	},
/obj/structure/flora/bush/sparsegrass/style_random,
/turf/open/floor/grass,
/area/misc/hilbertshotel)
"ot" = (
/obj/effect/turf_decal/weather/dirt{
	dir = 8
	},
/turf/open/floor/grass,
/area/misc/hilbertshotel)
"oy" = (
/obj/structure/fluff/beach_umbrella,
/turf/open/floor/carpet/red,
/area/misc/hilbertshotel)
"oK" = (
/obj/structure/flora/bush/jungle/c/style_random,
/obj/structure/flora/bush/flowers_pp/style_random,
/obj/effect/turf_decal/weather/dirt{
	dir = 6
	},
/turf/open/floor/grass,
/area/misc/hilbertshotel)
"oN" = (
/obj/effect/turf_decal/weather/dirt{
	dir = 6
	},
/turf/open/floor/grass,
/area/misc/hilbertshotel)
"pg" = (
/obj/structure/spacevine{
	name = "thick vines";
	opacity = 1
	},
/turf/open/misc/dirt/station,
/area/misc/hilbertshotel)
"pu" = (
/obj/structure/flora/bush/jungle/a/style_random,
/obj/structure/flora/bush/flowers_br/style_random,
/turf/open/floor/grass,
/area/misc/hilbertshotel)
"pW" = (
/obj/structure/flora/bush/fullgrass/style_random,
/turf/open/floor/grass,
/area/misc/hilbertshotel)
"qK" = (
/obj/effect/turf_decal/weather/dirt{
	dir = 1
	},
/obj/structure/flora/bush/fullgrass/style_random,
/obj/structure/flora/bush/flowers_yw/style_random,
/turf/open/floor/grass,
/area/misc/hilbertshotel)
"qV" = (
/obj/effect/turf_decal/weather/dirt{
	dir = 10
	},
/obj/structure/flora/bush/flowers_br/style_random,
/turf/open/floor/grass,
/area/misc/hilbertshotel)
"ri" = (
/obj/structure/flora/bush/reed/style_random,
/obj/structure/spacevine{
	name = "thick vines";
	opacity = 1
	},
/turf/open/water,
/area/misc/hilbertshotel)
"rj" = (
/obj/effect/turf_decal/weather/dirt{
	dir = 4
	},
/turf/open/floor/grass,
/area/misc/hilbertshotel)
"rC" = (
/obj/structure/flora/tree/jungle,
/turf/open/floor/grass,
/area/misc/hilbertshotel)
"rD" = (
/turf/open/misc/dirt/station,
/area/misc/hilbertshotel)
"sI" = (
/obj/effect/turf_decal/weather/dirt{
	dir = 9
	},
/turf/open/floor/grass,
/area/misc/hilbertshotel)
"tv" = (
/obj/structure/flora/bush/fullgrass/style_random,
/obj/effect/turf_decal/weather/dirt{
	dir = 9
	},
/turf/open/floor/grass,
/area/misc/hilbertshotel)
"up" = (
/obj/effect/turf_decal/weather/dirt{
	dir = 10
	},
/obj/structure/flora/bush/reed/style_random,
/turf/open/water,
/area/misc/hilbertshotel)
"uM" = (
/obj/structure/flora/bush/flowers_yw/style_random,
/obj/effect/turf_decal/weather/dirt{
	dir = 1
	},
/turf/open/floor/grass,
/area/misc/hilbertshotel)
"vg" = (
/obj/effect/turf_decal/weather/dirt{
	dir = 10
	},
/obj/structure/flora/rock/pile/jungle/style_random,
/turf/open/floor/grass,
/area/misc/hilbertshotel)
"vh" = (
/turf/closed/indestructible/rock,
/area/misc/hilbertshotel)
"wa" = (
/obj/structure/flora/bush/fullgrass/style_random,
/obj/structure/flora/bush/flowers_pp/style_random,
/turf/open/floor/grass,
/area/misc/hilbertshotel)
"wI" = (
/obj/structure/flora/bush/fullgrass/style_random,
/obj/effect/turf_decal/weather/dirt,
/turf/open/floor/grass,
/area/misc/hilbertshotel)
"xs" = (
/obj/structure/flora/bush/jungle/c/style_random,
/obj/effect/turf_decal/weather/dirt,
/turf/open/floor/grass,
/area/misc/hilbertshotel)
"xw" = (
/obj/structure/flora/bush/fullgrass/style_random,
/obj/effect/turf_decal/weather/dirt{
	dir = 6
	},
/turf/open/floor/grass,
/area/misc/hilbertshotel)
"xy" = (
/obj/structure/chair/sofa/bench/right,
/obj/effect/turf_decal/weather/dirt{
	dir = 10
	},
/turf/open/floor/grass,
/area/misc/hilbertshotel)
"xM" = (
/obj/structure/flora/bush/fullgrass/style_random,
/obj/structure/flora/bush/flowers_br/style_random,
/turf/open/floor/grass,
/area/misc/hilbertshotel)
"yb" = (
/obj/structure/flora/bush/flowers_br/style_random,
/turf/open/floor/grass,
/area/misc/hilbertshotel)
"zx" = (
/obj/structure/flora/rock/pile/jungle/style_random,
/obj/item/flashlight/lantern,
/turf/open/misc/dirt/station,
/area/misc/hilbertshotel)
"AY" = (
/obj/effect/turf_decal/weather/dirt,
/turf/open/floor/grass,
/area/misc/hilbertshotel)
"CZ" = (
/obj/item/clothing/head/costume/garland/rainbowbunch,
/turf/open/floor/carpet/red,
/area/misc/hilbertshotel)
"Dg" = (
/obj/structure/bonfire,
/obj/effect/light_emitter/fake_outdoors,
/turf/open/misc/dirt/station,
/area/misc/hilbertshotel)
"Di" = (
/turf/closed/indestructible/hoteldoor{
	icon_state = "door_closed";
	icon = 'icons/obj/doors/puzzledoor/default.dmi'
	},
/area/misc/hilbertshotel)
"DL" = (
/turf/open/floor/carpet/red,
/area/misc/hilbertshotel)
"EI" = (
/obj/structure/flora/bush/sparsegrass/style_random,
/obj/structure/spacevine{
	name = "thick vines";
	opacity = 1
	},
/turf/open/misc/dirt/station,
/area/misc/hilbertshotel)
"EQ" = (
/obj/effect/turf_decal/weather/dirt{
	dir = 10
	},
/turf/open/water,
/area/misc/hilbertshotel)
"FM" = (
/obj/structure/flora/biolumi/lamp/weaklight,
/turf/open/water,
/area/misc/hilbertshotel)
"Gb" = (
/obj/effect/turf_decal/weather/dirt{
	dir = 4
	},
/obj/structure/flora/rock/style_random,
/turf/open/floor/grass,
/area/misc/hilbertshotel)
"Gx" = (
/obj/structure/closet/crate/freezer{
	name = "Cooler"
	},
/obj/item/reagent_containers/cup/glass/bottle/beer,
/obj/item/reagent_containers/cup/glass/bottle/beer,
/obj/item/reagent_containers/cup/glass/bottle/beer,
/obj/item/reagent_containers/cup/glass/bottle/beer/light,
/obj/item/reagent_containers/cup/glass/bottle/beer/light,
/obj/item/reagent_containers/cup/glass/bottle/beer/light,
/obj/item/reagent_containers/cup/soda_cans/cola,
/obj/item/reagent_containers/cup/soda_cans/cola,
/obj/item/reagent_containers/cup/soda_cans/cola,
/obj/item/reagent_containers/cup/glass/waterbottle,
/obj/item/reagent_containers/cup/glass/waterbottle,
/obj/item/reagent_containers/cup/soda_cans/dr_gibb,
/obj/item/reagent_containers/cup/soda_cans/dr_gibb,
/obj/item/reagent_containers/cup/soda_cans/blood_tea,
/obj/item/reagent_containers/cup/soda_cans/blood_tea,
/obj/item/reagent_containers/cup/soda_cans/blood_tea,
/obj/item/reagent_containers/cup/soda_cans/dr_gibb,
/obj/item/reagent_containers/cup/glass/waterbottle,
/obj/item/reagent_containers/cup/soda_cans/lemon_lime,
/obj/item/reagent_containers/cup/soda_cans/lemon_lime,
/obj/item/reagent_containers/cup/soda_cans/lemon_lime,
/obj/item/reagent_containers/cup/soda_cans/melon_soda,
/obj/item/reagent_containers/cup/soda_cans/melon_soda,
/obj/item/reagent_containers/cup/soda_cans/melon_soda,
/turf/open/floor/carpet/red,
/area/misc/hilbertshotel)
"GS" = (
/obj/item/lighter,
/turf/open/misc/dirt/station,
/area/misc/hilbertshotel)
"Hq" = (
/obj/effect/turf_decal/weather/dirt{
	dir = 1
	},
/obj/structure/flora/bush/flowers_br/style_random,
/turf/open/floor/grass,
/area/misc/hilbertshotel)
"IB" = (
/obj/effect/turf_decal/weather/dirt{
	dir = 1
	},
/turf/open/floor/grass,
/area/misc/hilbertshotel)
"Jr" = (
/obj/item/storage/basket,
/turf/open/floor/carpet/red,
/area/misc/hilbertshotel)
"Jy" = (
/obj/structure/flora/rock/pile/jungle/style_random,
/turf/open/misc/dirt/station,
/area/misc/hilbertshotel)
"JG" = (
/obj/effect/turf_decal/weather/dirt{
	dir = 1
	},
/obj/structure/flora/bush/flowers_pp/style_random,
/turf/open/floor/grass,
/area/misc/hilbertshotel)
"JL" = (
/obj/structure/flora/bush/jungle/c/style_random,
/obj/effect/turf_decal/weather/dirt{
	dir = 5
	},
/turf/open/floor/grass,
/area/misc/hilbertshotel)
"KH" = (
/turf/open/water,
/area/misc/hilbertshotel)
"KS" = (
/obj/structure/flora/bush/jungle/a/style_random,
/turf/open/floor/grass,
/area/misc/hilbertshotel)
"LE" = (
/obj/effect/light_emitter/fake_outdoors,
/turf/open/misc/dirt/station,
/area/misc/hilbertshotel)
"LK" = (
/obj/structure/spacevine{
	name = "thick vines";
	opacity = 1
	},
/obj/effect/turf_decal/weather/dirt{
	dir = 9
	},
/turf/open/floor/grass,
/area/misc/hilbertshotel)
"Mx" = (
/obj/effect/turf_decal/weather/dirt,
/obj/structure/flora/bush/fullgrass/style_random,
/obj/structure/flora/rock/pile/jungle/style_random,
/turf/open/floor/grass,
/area/misc/hilbertshotel)
"Nv" = (
/obj/effect/turf_decal/weather/dirt{
	dir = 5
	},
/turf/open/floor/grass,
/area/misc/hilbertshotel)
"Of" = (
/obj/structure/flora/bush/large/style_random,
/obj/effect/turf_decal/weather/dirt{
	dir = 10
	},
/turf/open/floor/grass,
/area/misc/hilbertshotel)
"Qt" = (
/obj/effect/turf_decal/weather/dirt,
/obj/structure/chair/sofa/bench/left,
/turf/open/floor/grass,
/area/misc/hilbertshotel)
"Qy" = (
/obj/structure/flora/bush/large/style_random,
/turf/open/floor/grass,
/area/misc/hilbertshotel)
"QA" = (
/turf/open/floor/grass,
/area/misc/hilbertshotel)
"RK" = (
/obj/effect/turf_decal/weather/dirt,
/turf/open/water,
/area/misc/hilbertshotel)
"RO" = (
/obj/structure/flora/bush/jungle/b/style_random,
/turf/open/floor/grass,
/area/misc/hilbertshotel)
"Tf" = (
/obj/effect/turf_decal/weather/dirt{
	dir = 10
	},
/turf/open/floor/grass,
/area/misc/hilbertshotel)
"Tr" = (
/obj/structure/flora/bush/fullgrass/style_random,
/obj/structure/flora/bush/flowers_yw/style_random,
/obj/effect/turf_decal/weather/dirt,
/turf/open/floor/grass,
/area/misc/hilbertshotel)
"TO" = (
/obj/structure/flora/bush/flowers_yw/style_random,
/turf/open/floor/grass,
/area/misc/hilbertshotel)
"Vk" = (
/obj/structure/chair/stool/directional/north,
/turf/open/misc/dirt/station,
/area/misc/hilbertshotel)
"Vw" = (
/obj/structure/chair/stool/directional/south,
/obj/item/instrument/guitar,
/turf/open/misc/dirt/station,
/area/misc/hilbertshotel)
"Vx" = (
/obj/structure/flora/bush/flowers_br/style_random,
/obj/effect/turf_decal/weather/dirt{
	dir = 4
	},
/turf/open/floor/grass,
/area/misc/hilbertshotel)
"Wb" = (
/obj/structure/chair/stool/directional/west,
/turf/open/misc/dirt/station,
/area/misc/hilbertshotel)
"WX" = (
/obj/structure/flora/rock/pile{
	pixel_x = -3;
	pixel_y = -4
	},
/turf/open/floor/grass,
/area/misc/hilbertshotel)
"Xm" = (
/obj/effect/turf_decal/weather/dirt{
	dir = 5
	},
/obj/structure/flora/bush/jungle/b/style_random,
/turf/open/floor/grass,
/area/misc/hilbertshotel)
"Xz" = (
/obj/structure/flora/tree/jungle,
/obj/effect/turf_decal/weather/dirt,
/turf/open/floor/grass,
/area/misc/hilbertshotel)
"Yq" = (
/obj/structure/flora/rock/pile/style_2,
/turf/open/misc/dirt/station,
/area/misc/hilbertshotel)
"YD" = (
/obj/effect/turf_decal/weather/dirt{
	dir = 5
	},
/obj/structure/flora/bush/fullgrass/style_random,
/turf/open/floor/grass,
/area/misc/hilbertshotel)
"Zq" = (
/obj/structure/flora/bush/sparsegrass/style_random,
/turf/open/misc/dirt/station,
/area/misc/hilbertshotel)
"Zv" = (
/obj/structure/flora/rock/style_random,
/obj/structure/flora/bush/jungle/c/style_random,
/obj/effect/turf_decal/weather/dirt,
/turf/open/floor/grass,
/area/misc/hilbertshotel)

(1,1,1) = {"
vh
iF
iF
iF
vh
iF
Di
iF
vh
iF
iF
iF
iF
iF
vh
"}
(2,1,1) = {"
iF
iF
tv
mt
bC
iF
rD
zx
vh
iF
iF
cw
Of
iF
vh
"}
(3,1,1) = {"
iF
sI
RO
yb
rC
iF
EI
pg
LK
aD
ez
TO
Mx
vh
vh
"}
(4,1,1) = {"
iF
uM
pW
ka
RO
xy
rD
rD
qK
pu
rC
yb
AY
vh
vh
"}
(5,1,1) = {"
vh
gu
pW
pW
pW
Qt
rD
rD
Nv
QA
pW
pW
xs
iF
vh
"}
(6,1,1) = {"
vh
IB
pW
rC
QA
dv
rD
rD
Yq
JG
ef
KS
AY
iF
iF
"}
(7,1,1) = {"
vh
Xm
pW
CZ
oy
oN
rD
rD
rD
Nv
RO
QA
xM
vg
iF
"}
(8,1,1) = {"
vh
vh
kr
Gx
DL
rD
rD
LE
rD
rD
kf
QA
rC
Zv
iF
"}
(9,1,1) = {"
vh
iF
gu
Jr
DL
Vw
LE
Dg
LE
Vk
IB
pW
QA
js
vh
"}
(10,1,1) = {"
vh
iF
fp
pW
Tf
rD
Zq
LE
GS
Jy
Hq
pW
wI
iF
vh
"}
(11,1,1) = {"
vh
iF
up
lf
ka
qV
rD
Wb
rD
sI
KS
QA
Tr
iF
vh
"}
(12,1,1) = {"
vh
vh
KH
EQ
YD
Qy
ot
mW
lO
lr
QA
pW
ef
Of
vh
"}
(13,1,1) = {"
vh
vh
cP
KH
EQ
eR
WX
TO
QA
Qy
QA
QA
QA
oK
vh
"}
(14,1,1) = {"
vh
ri
FM
KH
RK
kf
QA
QA
wa
QA
QA
QA
Xz
iF
vh
"}
(15,1,1) = {"
vh
vh
KH
cP
RK
JL
Vx
hi
Gb
rj
rj
Gb
xw
iF
vh
"}
(16,1,1) = {"
vh
vh
vh
vh
vh
vh
vh
iF
iF
iF
iF
vh
vh
vh
vh
"}
