//MAP CONVERTED BY dmm2tgm.py THIS HEADER COMMENT PREVENTS RECONVERSION, DO NOT REMOVE
"aq" = (
/turf/open/floor/fakespace,
/area/misc/hilbertshotel)
"aC" = (
/turf/open/floor/iron/dark,
/area/misc/hilbertshotel)
"aF" = (
/obj/structure/chair/sofa/corp/left{
	dir = 8
	},
/turf/open/floor/iron/dark,
/area/misc/hilbertshotel)
"bp" = (
/obj/structure/table/reinforced/plasmarglass,
/obj/item/reagent_containers/cup/rag{
	pixel_y = 3
	},
/turf/open/floor/light,
/area/misc/hilbertshotel)
"bS" = (
/obj/structure/table/reinforced,
/obj/machinery/jukebox,
/obj/structure/musician/piano/minimoog{
	pixel_x = 15
	},
/obj/structure/railing{
	dir = 8
	},
/turf/open/floor/light,
/area/misc/hilbertshotel)
"cs" = (
/turf/open/floor/light/colour_cycle,
/area/misc/hilbertshotel)
"cy" = (
/turf/open/floor/carpet/purple,
/area/misc/hilbertshotel)
"cz" = (
/obj/structure/railing{
	dir = 10
	},
/turf/open/floor/light/colour_cycle/dancefloor_b,
/area/misc/hilbertshotel)
"dV" = (
/obj/machinery/light/dim/directional/west{
	alpha = 0
	},
/turf/open/floor/fakespace,
/area/misc/hilbertshotel)
"ep" = (
/obj/structure/table/reinforced,
/obj/item/instrument/piano_synth,
/obj/item/instrument/eguitar,
/obj/item/instrument/saxophone,
/turf/open/floor/iron/dark,
/area/misc/hilbertshotel)
"eG" = (
/obj/structure/falsewall,
/turf/open/floor/fakespace,
/area/misc/hilbertshotel)
"eR" = (
/obj/structure/chair/sofa/corp/right,
/turf/open/floor/iron/dark,
/area/misc/hilbertshotel)
"fa" = (
/obj/structure/chair/sofa/corp/corner{
	dir = 1
	},
/turf/open/floor/iron/dark,
/area/misc/hilbertshotel)
"fJ" = (
/obj/structure/disposalpipe/segment{
	dir = 4
	},
/turf/open/floor/iron/dark,
/area/misc/hilbertshotel)
"fZ" = (
/obj/structure/chair/sofa/corp/right{
	dir = 8
	},
/obj/item/clothing/sextoy/condom,
/turf/open/floor/iron/dark,
/area/misc/hilbertshotel)
"gL" = (
/obj/structure/chair/stool/bar/directional/north,
/turf/open/floor/carpet/purple,
/area/misc/hilbertshotel)
"hH" = (
/obj/structure/railing,
/turf/open/floor/light/colour_cycle/dancefloor_b,
/area/misc/hilbertshotel)
"id" = (
/turf/open/floor/iron/stairs{
	dir = 1
	},
/area/misc/hilbertshotel)
"jc" = (
/obj/structure/table/reinforced/plasmarglass,
/obj/machinery/reagentgrinder,
/turf/open/floor/light,
/area/misc/hilbertshotel)
"jr" = (
/obj/structure/sink/directional/west,
/obj/machinery/light/small/dim/directional/south,
/obj/machinery/dryer{
	dir = 8;
	pixel_x = 6;
	pixel_y = 17
	},
/obj/structure/disposalpipe/segment{
	dir = 10
	},
/turf/open/floor/iron/freezer,
/area/misc/hilbertshotel)
"jT" = (
/obj/structure/table/reinforced,
/turf/open/floor/iron,
/area/misc/hilbertshotel)
"mp" = (
/obj/structure/chair/stool/bar/directional/west,
/obj/structure/disposalpipe/junction{
	dir = 2
	},
/turf/open/floor/carpet/purple,
/area/misc/hilbertshotel)
"oH" = (
/obj/structure/railing{
	dir = 8
	},
/turf/open/floor/light/colour_cycle,
/area/misc/hilbertshotel)
"oN" = (
/obj/structure/table/reinforced,
/obj/structure/railing{
	dir = 10
	},
/turf/open/floor/light,
/area/misc/hilbertshotel)
"pd" = (
/obj/structure/railing,
/turf/open/floor/light/colour_cycle,
/area/misc/hilbertshotel)
"qE" = (
/obj/structure/disposalpipe/segment,
/turf/closed/indestructible/steel,
/area/misc/hilbertshotel)
"rb" = (
/obj/structure/railing{
	dir = 4
	},
/turf/open/floor/light/colour_cycle,
/area/misc/hilbertshotel)
"tH" = (
/turf/open/floor/iron/stairs{
	dir = 8
	},
/area/misc/hilbertshotel)
"uK" = (
/obj/machinery/barsign/all_access,
/turf/closed/indestructible/steel,
/area/misc/hilbertshotel)
"uM" = (
/obj/structure/chair/sofa/corp/corner{
	dir = 8
	},
/turf/open/floor/iron/dark,
/area/misc/hilbertshotel)
"vk" = (
/obj/structure/chair/comfy/brown{
	color = "#596479";
	dir = 2
	},
/turf/open/floor/iron/dark,
/area/misc/hilbertshotel)
"vz" = (
/obj/structure/table/reinforced/plasmarglass,
/obj/structure/disposalpipe/segment{
	dir = 4
	},
/turf/open/floor/light,
/area/misc/hilbertshotel)
"vM" = (
/obj/machinery/disposal/bin,
/obj/structure/disposalpipe/trunk{
	dir = 2
	},
/turf/open/floor/iron/dark,
/area/misc/hilbertshotel)
"wv" = (
/obj/machinery/chem_dispenser/drinks/fullupgrade{
	pixel_y = 32
	},
/obj/structure/table/reinforced/plasmarglass,
/obj/item/soap/deluxe,
/turf/open/floor/light,
/area/misc/hilbertshotel)
"yF" = (
/obj/structure/chair/sofa/corp/right{
	dir = 4
	},
/turf/open/floor/iron/dark,
/area/misc/hilbertshotel)
"Ah" = (
/obj/structure/disposalpipe/segment{
	dir = 5
	},
/turf/open/floor/iron/dark,
/area/misc/hilbertshotel)
"AM" = (
/obj/machinery/light/directional/west,
/obj/machinery/disposal/bin,
/obj/structure/disposalpipe/trunk{
	dir = 2
	},
/obj/item/wrench,
/turf/open/floor/carpet/purple,
/area/misc/hilbertshotel)
"Cc" = (
/obj/structure/railing{
	dir = 5
	},
/turf/open/floor/light/colour_cycle/dancefloor_b,
/area/misc/hilbertshotel)
"CZ" = (
/obj/machinery/door/airlock/bathroom{
	name = "Restroom"
	},
/obj/structure/disposalpipe/segment{
	dir = 4
	},
/turf/open/floor/iron/dark,
/area/misc/hilbertshotel)
"DR" = (
/obj/structure/table/wood/fancy/purple,
/obj/item/bdsm_candle{
	pixel_y = 6
	},
/turf/open/floor/light,
/area/misc/hilbertshotel)
"Ed" = (
/obj/structure/railing{
	dir = 4
	},
/turf/open/floor/light/colour_cycle/dancefloor_b,
/area/misc/hilbertshotel)
"Ep" = (
/obj/structure/table/reinforced/plasmarglass,
/obj/item/stack/spacecash/c5000{
	pixel_y = 15;
	pixel_x = 4
	},
/turf/open/floor/light,
/area/misc/hilbertshotel)
"ED" = (
/obj/structure/chair/stool/bar/directional/west,
/obj/structure/disposalpipe/segment,
/turf/open/floor/carpet/purple,
/area/misc/hilbertshotel)
"Fk" = (
/turf/open/floor/iron/stairs,
/area/misc/hilbertshotel)
"Fp" = (
/obj/item/food/syndicake,
/obj/item/food/syndicake,
/obj/item/food/syndicake,
/obj/item/food/syndicake,
/obj/item/food/syndicake,
/obj/item/food/syndicake,
/obj/item/food/syndicake,
/obj/item/toy/crayon/spraycan/infinite,
/obj/structure/closet/crate/freezer,
/turf/open/floor/iron/dark,
/area/misc/hilbertshotel)
"FD" = (
/obj/structure/table/reinforced/plasmarglass,
/turf/open/floor/light,
/area/misc/hilbertshotel)
"FN" = (
/turf/closed/indestructible/steel,
/area/misc/hilbertshotel)
"Gb" = (
/obj/structure/railing{
	dir = 8
	},
/turf/open/floor/light/colour_cycle/dancefloor_b,
/area/misc/hilbertshotel)
"Gv" = (
/obj/structure/table/reinforced/plasmarglass,
/obj/item/stack/spacecash/c200{
	pixel_y = -11;
	pixel_x = 7
	},
/turf/open/floor/light,
/area/misc/hilbertshotel)
"Gy" = (
/obj/structure/table/reinforced/plasmarglass,
/obj/machinery/pollution_scrubber{
	pixel_x = 9
	},
/turf/open/floor/light,
/area/misc/hilbertshotel)
"HQ" = (
/obj/machinery/vending/boozeomat{
	pixel_y = 32
	},
/obj/structure/table/reinforced/plasmarglass,
/obj/item/reagent_containers/cup/glass/shaker{
	pixel_x = 4
	},
/turf/open/floor/light,
/area/misc/hilbertshotel)
"HZ" = (
/turf/closed/wall/space{
	space_lit = 1
	},
/area/misc/hilbertshotel)
"IS" = (
/obj/structure/railing{
	dir = 1
	},
/turf/open/floor/iron/stairs{
	dir = 8;
	initial_gas_mix = "TEMP=2.7"
	},
/area/misc/hilbertshotel)
"Jc" = (
/obj/structure/railing{
	dir = 6
	},
/turf/open/floor/light/colour_cycle/dancefloor_b,
/area/misc/hilbertshotel)
"JR" = (
/obj/structure/toilet{
	pixel_y = 13
	},
/turf/open/floor/iron/freezer,
/area/misc/hilbertshotel)
"Ke" = (
/obj/structure/table/reinforced/plasmarglass,
/obj/item/storage/box/drinkingglasses,
/turf/open/floor/light,
/area/misc/hilbertshotel)
"KF" = (
/obj/structure/railing{
	dir = 1
	},
/turf/open/floor/light/colour_cycle,
/area/misc/hilbertshotel)
"KH" = (
/obj/structure/chair/sofa/corp/left{
	dir = 4
	},
/turf/open/floor/iron/dark,
/area/misc/hilbertshotel)
"KO" = (
/obj/structure/railing{
	dir = 1
	},
/turf/open/floor/iron/stairs{
	dir = 4
	},
/area/misc/hilbertshotel)
"La" = (
/obj/structure/railing{
	dir = 9
	},
/turf/open/floor/light/colour_cycle/dancefloor_b,
/area/misc/hilbertshotel)
"Mj" = (
/obj/structure/table/reinforced/plasmarglass,
/obj/item/stack/spacecash/c1000{
	pixel_x = -10
	},
/turf/open/floor/light,
/area/misc/hilbertshotel)
"Mw" = (
/obj/structure/chair/sofa/corp/left{
	dir = 1
	},
/turf/open/floor/iron/dark,
/area/misc/hilbertshotel)
"Mx" = (
/turf/open/floor/light/colour_cycle/dancefloor_b,
/area/misc/hilbertshotel)
"MA" = (
/obj/structure/chair/sofa/corp/left,
/turf/open/floor/iron/dark,
/area/misc/hilbertshotel)
"NQ" = (
/turf/open/floor/light/colour_cycle/dancefloor_a,
/area/misc/hilbertshotel)
"NW" = (
/obj/structure/disposalpipe/trunk{
	dir = 1
	},
/turf/closed/indestructible/steel,
/area/misc/hilbertshotel)
"PZ" = (
/obj/structure/chair/comfy/brown{
	color = "#596479";
	dir = 8
	},
/turf/open/floor/iron/dark,
/area/misc/hilbertshotel)
"Qd" = (
/turf/open/floor/iron,
/area/misc/hilbertshotel)
"Qu" = (
/obj/structure/table/reinforced/plasmarglass,
/obj/structure/stripper_pole,
/turf/open/floor/light,
/area/misc/hilbertshotel)
"QT" = (
/obj/machinery/door/airlock/grunge,
/turf/open/floor/iron/dark,
/area/misc/hilbertshotel)
"Rt" = (
/obj/structure/table/reinforced,
/obj/structure/railing{
	dir = 9
	},
/turf/open/floor/light,
/area/misc/hilbertshotel)
"Ry" = (
/obj/structure/table/reinforced,
/obj/item/toy/crayon/spraycan/infinite,
/turf/open/floor/iron,
/area/misc/hilbertshotel)
"Se" = (
/obj/machinery/jukebox/disco{
	anchored = 1
	},
/turf/open/floor/light/colour_cycle/dancefloor_a,
/area/misc/hilbertshotel)
"Si" = (
/obj/item/toy/plush/lizard_plushie/space,
/obj/machinery/light/dim/directional/north{
	alpha = 0
	},
/turf/open/floor/fakespace,
/area/misc/hilbertshotel)
"Sp" = (
/obj/structure/table/reinforced/plasmarglass,
/obj/item/stack/spacecash/c500{
	pixel_y = 2;
	pixel_x = -6
	},
/turf/open/floor/light,
/area/misc/hilbertshotel)
"SS" = (
/turf/closed/indestructible/hoteldoor{
	icon_state = "door_closed";
	icon = 'icons/obj/doors/puzzledoor/default.dmi'
	},
/area/misc/hilbertshotel)
"Tr" = (
/obj/machinery/vending/dorms,
/turf/open/floor/light,
/area/misc/hilbertshotel)
"UT" = (
/obj/structure/chair/sofa/corp/right{
	dir = 1
	},
/turf/open/floor/iron/dark,
/area/misc/hilbertshotel)
"VB" = (
/obj/structure/chair/sofa/corp/corner,
/turf/open/floor/iron/dark,
/area/misc/hilbertshotel)
"VK" = (
/obj/structure/chair/comfy/brown{
	color = "#596479";
	dir = 1
	},
/turf/open/floor/iron/dark,
/area/misc/hilbertshotel)
"Xz" = (
/obj/structure/railing{
	dir = 1
	},
/turf/open/floor/iron,
/area/misc/hilbertshotel)
"YN" = (
/obj/structure/chair/sofa/corp/corner{
	dir = 4
	},
/turf/open/floor/iron/dark,
/area/misc/hilbertshotel)
"Zf" = (
/obj/structure/table/reinforced/plasmarglass,
/obj/item/stack/spacecash/c500,
/turf/open/floor/light,
/area/misc/hilbertshotel)
"Zz" = (
/obj/structure/disposalpipe/segment,
/turf/open/floor/carpet/purple,
/area/misc/hilbertshotel)
"ZW" = (
/obj/machinery/chem_dispenser/drinks/beer/fullupgrade{
	pixel_y = 32
	},
/obj/structure/table/reinforced/plasmarglass,
/turf/open/floor/light,
/area/misc/hilbertshotel)

(1,1,1) = {"
FN
FN
FN
FN
FN
FN
SS
FN
FN
FN
FN
FN
FN
FN
FN
"}
(2,1,1) = {"
FN
FD
wv
aC
aC
FN
cy
cy
vk
DR
VK
vk
DR
VK
FN
"}
(3,1,1) = {"
FN
FD
ZW
aC
aC
QT
cy
cy
aC
PZ
aC
aC
PZ
aC
FN
"}
(4,1,1) = {"
FN
FD
HQ
aC
aC
FD
gL
cy
aC
aC
aC
aC
aC
aC
FN
"}
(5,1,1) = {"
FN
jc
Ke
aC
aC
bp
gL
cy
aC
La
oH
Gb
oH
cz
FN
"}
(6,1,1) = {"
FN
Fp
aC
aC
aC
FD
gL
cy
IS
KF
NQ
cs
NQ
pd
FN
"}
(7,1,1) = {"
FN
vM
Ah
aC
aC
Gy
gL
cy
Xz
Mx
cs
Se
cs
hH
FN
"}
(8,1,1) = {"
FN
FN
vz
FD
FD
uK
cy
cy
KO
KF
NQ
cs
NQ
pd
FN
"}
(9,1,1) = {"
FN
AM
mp
ED
ED
qE
Zz
Zz
Ah
Cc
rb
Ed
rb
Jc
FN
"}
(10,1,1) = {"
FN
cy
cy
cy
cy
cy
cy
cy
fJ
aC
aC
aC
aC
aC
FN
"}
(11,1,1) = {"
FN
YN
yF
tH
KH
fa
aC
aC
fJ
aC
Rt
bS
oN
aC
FN
"}
(12,1,1) = {"
FN
MA
Gv
Zf
FD
UT
aC
aC
fJ
id
Qd
Qd
Qd
Fk
FN
"}
(13,1,1) = {"
FN
aC
FD
Qu
Mj
aC
aC
Tr
fJ
FN
ep
jT
Ry
FN
FN
"}
(14,1,1) = {"
FN
eR
Sp
FD
Ep
Mw
FN
FN
CZ
FN
eG
eG
eG
FN
HZ
"}
(15,1,1) = {"
FN
VB
aF
aC
fZ
uM
FN
JR
jr
NW
Si
aq
aq
dV
HZ
"}
(16,1,1) = {"
FN
FN
FN
FN
FN
FN
FN
FN
FN
FN
HZ
HZ
HZ
HZ
HZ
"}
