//MAP CONVERTED BY dmm2tgm.py THIS HEADER COMMENT PREVENTS RECONVERSION, DO NOT REMOVE
"ak" = (
/obj/effect/turf_decal/weather/sand{
	dir = 10
	},
/obj/effect/light_emitter/interlink,
/turf/open/floor/grass,
/area/misc/hilbertshotel)
"aC" = (
/turf/closed/indestructible/sandstone,
/area/misc/hilbertshotel)
"aS" = (
/obj/structure/flora/tree/palm{
	pixel_y = 11;
	density = 0
	},
/obj/effect/turf_decal/weather/sand{
	dir = 10
	},
/obj/structure/flora/coconuts{
	pixel_y = 7
	},
/obj/effect/light_emitter/interlink,
/turf/open/floor/grass,
/area/misc/hilbertshotel)
"aU" = (
/obj/structure/flora/rock/pile/jungle/style_random,
/obj/effect/light_emitter/interlink,
/turf/open/floor/grass,
/area/misc/hilbertshotel)
"cy" = (
/obj/structure/flora/bush/jungle/b/style_random,
/obj/effect/light_emitter/interlink,
/turf/open/misc/beach/sand,
/area/misc/hilbertshotel)
"cA" = (
/obj/effect/light_emitter/interlink,
/turf/open/floor/carpet/orange,
/area/misc/hilbertshotel)
"db" = (
/obj/structure/flora/bush/sparsegrass/style_random,
/turf/open/misc/beach/sand,
/area/misc/hilbertshotel)
"dJ" = (
/obj/effect/turf_decal/weather/sand{
	dir = 9
	},
/obj/structure/flora/rock/pile/jungle/style_random,
/obj/effect/light_emitter/interlink,
/turf/open/floor/grass,
/area/misc/hilbertshotel)
"dR" = (
/obj/effect/turf_decal/weather/sand{
	dir = 6
	},
/obj/effect/light_emitter/interlink,
/turf/open/water{
	icon_state = "pool_1"
	},
/area/misc/hilbertshotel)
"ge" = (
/obj/item/kirbyplants/random,
/obj/machinery/light_switch/directional/west,
/turf/open/floor/iron/terracotta,
/area/misc/hilbertshotel)
"ha" = (
/obj/effect/turf_decal/weather/sand{
	dir = 8
	},
/obj/effect/turf_decal/weather/sand{
	dir = 4
	},
/obj/effect/light_emitter/interlink,
/turf/open/floor/grass,
/area/misc/hilbertshotel)
"hN" = (
/obj/effect/turf_decal/weather/sand{
	dir = 5
	},
/obj/effect/light_emitter/interlink,
/turf/open/water{
	icon_state = "pool_1"
	},
/area/misc/hilbertshotel)
"iZ" = (
/obj/structure/flora/tree/palm{
	pixel_y = -9;
	density = 0
	},
/obj/effect/turf_decal/weather/sand{
	dir = 5
	},
/obj/effect/light_emitter/interlink,
/turf/open/floor/grass,
/area/misc/hilbertshotel)
"jq" = (
/obj/structure/flora/bush/jungle/a/style_random,
/obj/effect/light_emitter/interlink,
/turf/open/misc/beach/sand,
/area/misc/hilbertshotel)
"jT" = (
/turf/open/misc/beach/sand,
/area/misc/hilbertshotel)
"kI" = (
/obj/effect/turf_decal/weather/sand{
	dir = 1;
	pixel_y = 1
	},
/obj/structure/flora/rock/pile/jungle/style_random,
/obj/effect/light_emitter/interlink,
/turf/open/floor/grass,
/area/misc/hilbertshotel)
"kX" = (
/obj/structure/fluff/beach_umbrella/engine{
	pixel_x = 11;
	pixel_y = 9
	},
/obj/effect/light_emitter/interlink,
/turf/open/misc/beach/sand,
/area/misc/hilbertshotel)
"lJ" = (
/turf/closed/indestructible/hoteldoor,
/area/misc/hilbertshotel)
"lO" = (
/obj/structure/flora/tree/palm{
	density = 0
	},
/obj/effect/turf_decal/weather/sand{
	dir = 5
	},
/obj/structure/flora/coconuts{
	pixel_y = -6
	},
/obj/effect/light_emitter/interlink,
/turf/open/floor/grass,
/area/misc/hilbertshotel)
"ml" = (
/obj/structure/dresser{
	pixel_y = 4
	},
/turf/open/floor/iron/terracotta,
/area/misc/hilbertshotel)
"mJ" = (
/obj/effect/turf_decal/weather/sand{
	dir = 6
	},
/obj/structure/flora/bush/jungle/a/style_random,
/obj/effect/light_emitter/interlink,
/turf/open/floor/grass,
/area/misc/hilbertshotel)
"nd" = (
/obj/structure/flora/bush/large/style_random,
/turf/open/misc/beach/sand,
/area/misc/hilbertshotel)
"nn" = (
/obj/effect/light_emitter/interlink,
/turf/open/misc/beach/sand,
/area/misc/hilbertshotel)
"nS" = (
/obj/effect/turf_decal/weather/sand,
/obj/effect/light_emitter/interlink,
/turf/open/floor/grass,
/area/misc/hilbertshotel)
"ph" = (
/obj/structure/flora/bush/jungle/a/style_random,
/obj/effect/light_emitter/interlink,
/turf/open/floor/grass,
/area/misc/hilbertshotel)
"px" = (
/obj/effect/turf_decal/weather/sand{
	dir = 9
	},
/obj/structure/flora/bush/jungle/b/style_random,
/obj/effect/light_emitter/interlink,
/turf/open/floor/grass,
/area/misc/hilbertshotel)
"qL" = (
/obj/effect/turf_decal/weather/sand{
	dir = 8
	},
/obj/structure/flora/bush/fullgrass/style_random,
/obj/effect/light_emitter/interlink,
/turf/open/floor/grass,
/area/misc/hilbertshotel)
"se" = (
/obj/effect/light_emitter/interlink,
/turf/open/water{
	icon_state = "pool_1"
	},
/area/misc/hilbertshotel)
"si" = (
/obj/structure/flora/bush/large/style_random,
/obj/effect/light_emitter/interlink,
/turf/open/misc/beach/sand,
/area/misc/hilbertshotel)
"vJ" = (
/obj/machinery/door/airlock/sandstone,
/turf/open/floor/iron/terracotta,
/area/misc/hilbertshotel)
"wI" = (
/obj/structure/flora/tree/palm/style_2{
	density = 0
	},
/obj/structure/flora/coconuts{
	pixel_y = -5;
	pixel_x = 3
	},
/turf/open/misc/beach/sand,
/area/misc/hilbertshotel)
"xp" = (
/obj/structure/flora/tree/palm/style_2{
	pixel_y = 14;
	density = 0
	},
/obj/effect/turf_decal/weather/sand{
	dir = 10
	},
/obj/effect/light_emitter/interlink,
/turf/open/floor/grass,
/area/misc/hilbertshotel)
"zh" = (
/obj/machinery/light_switch/directional/north,
/turf/open/floor/iron/terracotta,
/area/misc/hilbertshotel)
"AX" = (
/obj/structure/flora/tree/palm{
	density = 0
	},
/obj/structure/flora/coconuts{
	pixel_y = -5;
	pixel_x = 3
	},
/turf/open/misc/beach/sand,
/area/misc/hilbertshotel)
"BC" = (
/obj/structure/flora/tree/palm{
	density = 0
	},
/turf/open/misc/beach/sand,
/area/misc/hilbertshotel)
"Cc" = (
/obj/effect/turf_decal/weather/sand{
	dir = 9
	},
/obj/effect/light_emitter/interlink,
/turf/open/water{
	icon_state = "pool_1"
	},
/area/misc/hilbertshotel)
"Dj" = (
/obj/effect/turf_decal/weather/sand{
	dir = 6
	},
/obj/structure/flora/bush/jungle/c/style_random,
/obj/effect/light_emitter/interlink,
/turf/open/floor/grass,
/area/misc/hilbertshotel)
"EQ" = (
/obj/effect/turf_decal/weather/sand{
	dir = 6
	},
/obj/effect/turf_decal/weather/sand{
	dir = 8
	},
/obj/effect/light_emitter/interlink,
/turf/open/floor/grass,
/area/misc/hilbertshotel)
"Fa" = (
/obj/effect/turf_decal/weather/sand{
	dir = 10
	},
/obj/effect/light_emitter/interlink,
/turf/open/water{
	icon_state = "pool_1"
	},
/area/misc/hilbertshotel)
"FN" = (
/turf/closed/indestructible/rock,
/area/misc/hilbertshotel)
"Gc" = (
/obj/structure/flora/bush/fullgrass/style_random,
/obj/effect/light_emitter/interlink,
/turf/open/misc/beach/sand,
/area/misc/hilbertshotel)
"GW" = (
/obj/structure/flora/coconuts{
	pixel_y = 15
	},
/obj/effect/light_emitter/interlink,
/turf/open/floor/grass,
/area/misc/hilbertshotel)
"HI" = (
/obj/structure/bed/double{
	dir = 4
	},
/obj/effect/spawner/random/bedsheet/double{
	dir = 4
	},
/turf/open/floor/iron/terracotta,
/area/misc/hilbertshotel)
"IH" = (
/obj/structure/closet/mini_fridge,
/obj/structure/table/wood,
/obj/item/pizzabox/pineapple,
/obj/item/storage/cans/sixbeer,
/obj/machinery/light/warm/directional/east,
/turf/open/floor/iron/terracotta,
/area/misc/hilbertshotel)
"IQ" = (
/obj/effect/turf_decal/weather/sand{
	dir = 10
	},
/obj/structure/flora/bush/fullgrass/style_random,
/obj/effect/light_emitter/interlink,
/turf/open/floor/grass,
/area/misc/hilbertshotel)
"JA" = (
/turf/open/floor/iron/terracotta,
/area/misc/hilbertshotel)
"KG" = (
/obj/structure/flora/tree/palm/style_2{
	density = 0
	},
/obj/effect/light_emitter/interlink,
/turf/open/floor/grass,
/area/misc/hilbertshotel)
"KL" = (
/obj/structure/flora/bush/fullgrass/style_random,
/turf/open/misc/beach/sand,
/area/misc/hilbertshotel)
"Li" = (
/obj/structure/table/wood,
/obj/item/flashlight/flare/candle/infinite,
/turf/open/floor/iron/terracotta,
/area/misc/hilbertshotel)
"OK" = (
/obj/structure/flora/tree/palm/style_2{
	density = 0
	},
/turf/open/misc/beach/sand,
/area/misc/hilbertshotel)
"PW" = (
/obj/machinery/light/small/dim/directional/east,
/turf/open/misc/beach/sand,
/area/misc/hilbertshotel)
"Qg" = (
/obj/effect/turf_decal/weather/sand{
	dir = 8
	},
/obj/effect/light_emitter/interlink,
/turf/open/water{
	icon_state = "pool_1"
	},
/area/misc/hilbertshotel)
"Rq" = (
/obj/effect/turf_decal/weather/sand{
	dir = 5
	},
/obj/structure/flora/bush/jungle/c/style_random,
/obj/effect/light_emitter/interlink,
/turf/open/floor/grass,
/area/misc/hilbertshotel)
"Ry" = (
/obj/structure/curtain/cloth/fancy,
/turf/closed/indestructible/fakeglass,
/area/misc/hilbertshotel)
"SS" = (
/turf/closed/indestructible/hoteldoor{
	icon_state = "door_closed";
	icon = 'icons/obj/doors/puzzledoor/default.dmi'
	},
/area/misc/hilbertshotel)
"TD" = (
/obj/structure/chair/wood{
	dir = 4
	},
/turf/open/floor/iron/terracotta,
/area/misc/hilbertshotel)
"Uc" = (
/obj/structure/flora/tree/palm/style_2{
	pixel_y = 0;
	density = 0
	},
/obj/effect/turf_decal/weather/sand{
	dir = 1;
	pixel_y = 1
	},
/obj/structure/flora/coconuts{
	pixel_y = -7;
	pixel_x = 4
	},
/obj/effect/light_emitter/interlink,
/turf/open/floor/grass,
/area/misc/hilbertshotel)
"Ug" = (
/obj/machinery/light/warm/directional/east,
/turf/open/floor/iron/terracotta,
/area/misc/hilbertshotel)
"Ui" = (
/obj/structure/chair/wood{
	dir = 8
	},
/turf/open/floor/iron/terracotta,
/area/misc/hilbertshotel)
"Wz" = (
/obj/structure/table/wood,
/obj/item/storage/cans/sixbeer,
/obj/item/toy/plush/lizard_plushie,
/turf/open/floor/iron/terracotta,
/area/misc/hilbertshotel)
"WD" = (
/turf/open/floor/carpet/purple,
/area/misc/hilbertshotel)
"Xj" = (
/obj/structure/flora/bush/fullgrass/style_random,
/obj/effect/light_emitter/interlink,
/turf/open/floor/grass,
/area/misc/hilbertshotel)
"Ze" = (
/obj/structure/flora/bush/sparsegrass/style_random,
/obj/effect/light_emitter/interlink,
/turf/open/misc/beach/sand,
/area/misc/hilbertshotel)
"ZA" = (
/obj/effect/turf_decal/weather/sand{
	dir = 6
	},
/obj/effect/light_emitter/interlink,
/turf/open/floor/grass,
/area/misc/hilbertshotel)
"ZU" = (
/obj/structure/flora/tree/palm{
	pixel_x = 8;
	pixel_y = 4;
	density = 0
	},
/obj/effect/turf_decal/weather/sand{
	dir = 9
	},
/obj/structure/flora/coconuts{
	pixel_y = -3;
	pixel_x = 5
	},
/obj/effect/light_emitter/interlink,
/turf/open/floor/grass,
/area/misc/hilbertshotel)

(1,1,1) = {"
FN
FN
FN
FN
FN
FN
FN
lJ
FN
FN
FN
FN
FN
FN
FN
"}
(2,1,1) = {"
FN
FN
jT
wI
jT
jT
jT
KL
jT
jT
jT
jT
OK
FN
FN
"}
(3,1,1) = {"
FN
db
jT
nn
Gc
nn
cy
nn
nn
px
xp
Gc
jT
nd
FN
"}
(4,1,1) = {"
FN
jT
si
nn
ZU
ha
Cc
Qg
se
Fa
Rq
aS
nn
jT
FN
"}
(5,1,1) = {"
FN
AX
Gc
dJ
Dj
Cc
se
se
se
se
Fa
kI
IQ
jT
FN
"}
(6,1,1) = {"
FN
jT
px
Xj
Cc
se
se
se
se
se
se
Uc
mJ
jT
FN
"}
(7,1,1) = {"
FN
jT
KG
nS
se
se
se
se
se
se
dR
mJ
nn
jT
FN
"}
(8,1,1) = {"
FN
jT
iZ
GW
hN
se
se
se
se
dR
Ze
nn
si
jT
FN
"}
(9,1,1) = {"
FN
jT
Gc
ph
ak
hN
se
se
dR
Gc
nn
nn
nn
db
FN
"}
(10,1,1) = {"
FN
jT
nn
lO
aU
qL
EQ
nn
nn
jq
jT
jT
jT
AX
FN
"}
(11,1,1) = {"
FN
wI
nn
Gc
Rq
ZA
KL
jT
jT
jT
PW
aC
Ry
aC
aC
"}
(12,1,1) = {"
FN
jT
nn
kX
nn
si
jT
aC
aC
vJ
aC
aC
Wz
ml
aC
"}
(13,1,1) = {"
FN
jT
nn
cA
Ze
nn
jT
aC
TD
WD
ge
aC
zh
HI
aC
"}
(14,1,1) = {"
FN
jT
BC
cA
nn
nn
jT
Ry
Li
JA
JA
vJ
JA
Ug
aC
"}
(15,1,1) = {"
FN
FN
jT
jT
jT
AX
db
aC
Ui
JA
IH
aC
aC
aC
aC
"}
(16,1,1) = {"
FN
FN
FN
FN
FN
FN
FN
aC
aC
SS
aC
aC
FN
FN
FN
"}
