//MAP CONVERTED BY dmm2tgm.py THIS HEADER COMMENT PREVENTS RECONVERSION, DO NOT REMOVE
"aC" = (
/obj/effect/turf_decal/tile/dark_blue/half/contrasted,
/turf/open/floor/iron/white,
/area/misc/hilbertshotel)
"aM" = (
/obj/effect/turf_decal/siding/dark{
	dir = 8
	},
/obj/effect/turf_decal/tile/dark_blue/half/contrasted{
	dir = 8
	},
/obj/structure/chair{
	dir = 4
	},
/turf/open/floor/iron/white,
/area/misc/hilbertshotel)
"bI" = (
/obj/structure/chair,
/obj/item/bikehorn/airhorn,
/turf/open/floor/iron/textured,
/area/misc/hilbertshotel)
"cy" = (
/obj/effect/turf_decal/tile/dark_blue/half/contrasted{
	dir = 4
	},
/turf/open/floor/iron,
/area/misc/hilbertshotel)
"iX" = (
/obj/effect/turf_decal/siding/dark/corner,
/obj/effect/turf_decal/tile/dark_blue,
/turf/open/floor/iron/white,
/area/misc/hilbertshotel)
"jT" = (
/turf/closed/indestructible/steel,
/area/misc/hilbertshotel)
"jU" = (
/obj/structure/chair/sofa/bench/left{
	dir = 8;
	pixel_x = 8
	},
/obj/effect/turf_decal/tile/dark_blue/full,
/turf/open/floor/iron/large,
/area/misc/hilbertshotel)
"kt" = (
/obj/effect/turf_decal/siding/dark,
/obj/effect/turf_decal/tile/dark_blue/half/contrasted,
/turf/open/floor/iron/white,
/area/misc/hilbertshotel)
"kC" = (
/obj/effect/turf_decal/siding/dark{
	dir = 1
	},
/obj/effect/turf_decal/siding/dark,
/obj/effect/turf_decal/tile/dark_blue/half/contrasted,
/turf/open/floor/iron/white,
/area/misc/hilbertshotel)
"kJ" = (
/obj/effect/turf_decal/tile/dark_blue/half/contrasted{
	dir = 8
	},
/obj/machinery/shower/directional/east{
	refill_rate = 5
	},
/obj/structure/window/reinforced{
	dir = 8;
	pixel_x = -4
	},
/obj/structure/fluff/shower_drain{
	pixel_x = -8;
	pixel_y = -8
	},
/turf/open/floor/iron/white,
/area/misc/hilbertshotel)
"lT" = (
/obj/effect/turf_decal/tile/dark_blue/half/contrasted{
	dir = 8
	},
/obj/structure/closet,
/obj/item/clothing/under/misc/skyrat/gear_harness,
/obj/machinery/light/directional/west,
/turf/open/floor/iron,
/area/misc/hilbertshotel)
"mH" = (
/obj/effect/turf_decal/tile/dark_blue/half/contrasted{
	dir = 4
	},
/obj/machinery/shower/directional/west{
	refill_rate = 5
	},
/obj/structure/window/reinforced{
	dir = 4;
	pixel_x = 3
	},
/obj/structure/fluff/shower_drain{
	pixel_x = 8;
	pixel_y = -8
	},
/obj/machinery/light/directional/south,
/turf/open/floor/iron/white,
/area/misc/hilbertshotel)
"pe" = (
/obj/effect/turf_decal/siding/dark{
	dir = 8
	},
/obj/effect/turf_decal/tile/dark_blue/half/contrasted{
	dir = 8
	},
/obj/structure/table,
/obj/machinery/light/directional/west,
/obj/structure/towel_bin,
/turf/open/floor/iron/white,
/area/misc/hilbertshotel)
"qe" = (
/obj/effect/turf_decal/siding/dark{
	dir = 4
	},
/obj/effect/turf_decal/tile/dark_blue/half/contrasted{
	dir = 4
	},
/obj/structure/bed/pod{
	pixel_y = 1
	},
/turf/open/floor/iron/white,
/area/misc/hilbertshotel)
"sC" = (
/obj/effect/turf_decal/tile/dark_blue/half/contrasted{
	dir = 4
	},
/obj/structure/closet,
/obj/item/clothing/under/misc/skyrat/gear_harness,
/turf/open/floor/iron,
/area/misc/hilbertshotel)
"sF" = (
/obj/effect/turf_decal/tile/dark_blue/half/contrasted{
	dir = 4
	},
/obj/machinery/shower/directional/west{
	refill_rate = 5
	},
/obj/structure/fluff/shower_drain{
	pixel_x = 8;
	pixel_y = -8
	},
/turf/open/floor/iron/white,
/area/misc/hilbertshotel)
"sG" = (
/obj/effect/turf_decal/siding/dark{
	dir = 4
	},
/obj/effect/turf_decal/tile/dark_blue/half/contrasted{
	dir = 4
	},
/obj/structure/table,
/obj/machinery/light/directional/east,
/turf/open/floor/iron/white,
/area/misc/hilbertshotel)
"uO" = (
/turf/open/floor/iron/stairs{
	dir = 8;
	color = "AAAAAA"
	},
/area/misc/hilbertshotel)
"xw" = (
/obj/effect/turf_decal/siding/dark{
	dir = 4
	},
/obj/effect/turf_decal/tile/dark_blue/anticorner,
/turf/open/floor/iron/white,
/area/misc/hilbertshotel)
"yh" = (
/obj/structure/chair/sofa/bench/left{
	dir = 4;
	pixel_x = -8
	},
/obj/effect/turf_decal/tile/dark_blue/full,
/turf/open/floor/iron/large,
/area/misc/hilbertshotel)
"yj" = (
/turf/open/floor/iron/stairs{
	dir = 4;
	color = "AAAAAA"
	},
/area/misc/hilbertshotel)
"Bh" = (
/obj/effect/turf_decal/siding/dark{
	dir = 8
	},
/obj/effect/turf_decal/tile/dark_blue/anticorner{
	dir = 8
	},
/turf/open/floor/iron/white,
/area/misc/hilbertshotel)
"BG" = (
/obj/effect/spawner/liquids_spawner/shoulders,
/turf/open/floor/iron/pool,
/area/misc/hilbertshotel)
"BW" = (
/obj/effect/turf_decal/siding/dark{
	dir = 8
	},
/obj/effect/turf_decal/tile/dark_blue/half/contrasted{
	dir = 8
	},
/turf/open/floor/iron/white,
/area/misc/hilbertshotel)
"Cb" = (
/obj/effect/turf_decal/siding/dark{
	dir = 8
	},
/obj/effect/turf_decal/tile/dark_blue/half/contrasted{
	dir = 8
	},
/obj/structure/fluff/shower_drain{
	pixel_x = -7;
	pixel_y = 0
	},
/turf/open/floor/iron/white,
/area/misc/hilbertshotel)
"CS" = (
/obj/machinery/door/airlock/bathroom,
/turf/open/floor/iron/white,
/area/misc/hilbertshotel)
"DZ" = (
/obj/effect/turf_decal/tile/dark_blue/half/contrasted{
	dir = 8
	},
/obj/machinery/shower/directional/east{
	refill_rate = 5
	},
/obj/structure/fluff/shower_drain{
	pixel_x = -8;
	pixel_y = -8
	},
/turf/open/floor/iron/white,
/area/misc/hilbertshotel)
"Fb" = (
/obj/machinery/vending/vendcation{
	pixel_y = -6
	},
/turf/closed/indestructible/steel,
/area/misc/hilbertshotel)
"FI" = (
/obj/effect/turf_decal/siding/dark{
	dir = 8
	},
/obj/effect/turf_decal/tile/dark_blue/half/contrasted{
	dir = 8
	},
/obj/machinery/light/directional/west,
/turf/open/floor/iron/white,
/area/misc/hilbertshotel)
"FN" = (
/obj/effect/turf_decal/siding/dark{
	dir = 4
	},
/obj/effect/turf_decal/tile/dark_blue/half/contrasted{
	dir = 4
	},
/turf/open/floor/iron/white,
/area/misc/hilbertshotel)
"Ge" = (
/obj/effect/turf_decal/siding/dark{
	dir = 4
	},
/obj/effect/turf_decal/tile/dark_blue/half/contrasted{
	dir = 4
	},
/obj/structure/fluff/shower_drain{
	pixel_x = 7;
	pixel_y = 0
	},
/turf/open/floor/iron/white,
/area/misc/hilbertshotel)
"Gf" = (
/obj/effect/turf_decal/siding/dark{
	dir = 4
	},
/obj/effect/turf_decal/tile/dark_blue/anticorner{
	dir = 4
	},
/obj/machinery/light/directional/east,
/turf/open/floor/iron/white,
/area/misc/hilbertshotel)
"Gk" = (
/obj/structure/chair/sofa/bench/right{
	dir = 4;
	pixel_x = -8
	},
/obj/effect/turf_decal/tile/dark_blue/full,
/turf/open/floor/iron/large,
/area/misc/hilbertshotel)
"GI" = (
/obj/effect/turf_decal/tile/dark_blue/half/contrasted{
	dir = 4
	},
/obj/machinery/shower/directional/west{
	refill_rate = 5
	},
/obj/structure/window/reinforced{
	dir = 4;
	pixel_x = 3
	},
/obj/structure/fluff/shower_drain{
	pixel_x = 8;
	pixel_y = -8
	},
/turf/open/floor/iron/white,
/area/misc/hilbertshotel)
"JI" = (
/obj/effect/turf_decal/tile/dark_blue/half/contrasted{
	dir = 8
	},
/obj/structure/closet,
/obj/item/clothing/under/misc/skyrat/gear_harness,
/turf/open/floor/iron,
/area/misc/hilbertshotel)
"Kc" = (
/obj/effect/turf_decal/siding/dark{
	dir = 8
	},
/obj/effect/turf_decal/tile/dark_blue/half/contrasted{
	dir = 8
	},
/obj/structure/closet/secure_closet/personal/wall{
	pixel_x = -25
	},
/turf/open/floor/iron/white,
/area/misc/hilbertshotel)
"Mk" = (
/obj/effect/turf_decal/siding/dark{
	dir = 4
	},
/obj/effect/turf_decal/tile/dark_blue/half/contrasted{
	dir = 4
	},
/obj/structure/table,
/obj/structure/towel_bin,
/obj/machinery/light/directional/east,
/turf/open/floor/iron/white,
/area/misc/hilbertshotel)
"MI" = (
/obj/effect/turf_decal/tile/dark_blue/half/contrasted{
	dir = 8
	},
/obj/machinery/shower/directional/east{
	refill_rate = 5
	},
/obj/structure/window/reinforced{
	dir = 8;
	pixel_x = -4
	},
/obj/structure/fluff/shower_drain{
	pixel_x = -8;
	pixel_y = -8
	},
/obj/machinery/light/directional/south,
/turf/open/floor/iron/white,
/area/misc/hilbertshotel)
"Pc" = (
/turf/open/floor/iron/white,
/area/misc/hilbertshotel)
"Pm" = (
/obj/effect/turf_decal/siding/dark/corner{
	dir = 4
	},
/obj/effect/turf_decal/tile/dark_blue{
	dir = 4
	},
/turf/open/floor/iron/white,
/area/misc/hilbertshotel)
"PW" = (
/obj/effect/turf_decal/tile/dark_blue/half/contrasted{
	dir = 8
	},
/turf/open/floor/iron,
/area/misc/hilbertshotel)
"Qm" = (
/obj/effect/turf_decal/siding/dark{
	dir = 8
	},
/obj/effect/turf_decal/tile/dark_blue/anticorner{
	dir = 1
	},
/obj/machinery/light/directional/west,
/turf/open/floor/iron/white,
/area/misc/hilbertshotel)
"Rp" = (
/obj/effect/turf_decal/siding/dark{
	dir = 1
	},
/obj/effect/turf_decal/tile/dark_blue/half/contrasted{
	dir = 1
	},
/turf/open/floor/iron/white,
/area/misc/hilbertshotel)
"SS" = (
/turf/closed/indestructible/hoteldoor{
	icon_state = "door_closed";
	icon = 'icons/obj/doors/puzzledoor/default.dmi'
	},
/area/misc/hilbertshotel)
"Vv" = (
/obj/structure/dresser{
	pixel_y = -7
	},
/turf/closed/indestructible/steel,
/area/misc/hilbertshotel)
"Vw" = (
/obj/effect/turf_decal/tile/dark_blue/half/contrasted{
	dir = 4
	},
/obj/structure/closet,
/obj/item/clothing/under/misc/skyrat/gear_harness,
/obj/machinery/light/directional/east,
/turf/open/floor/iron,
/area/misc/hilbertshotel)
"VE" = (
/obj/effect/turf_decal/siding/dark/corner{
	dir = 8
	},
/obj/effect/turf_decal/tile/dark_blue{
	dir = 8
	},
/turf/open/floor/iron/white,
/area/misc/hilbertshotel)
"Xo" = (
/obj/effect/turf_decal/siding/dark{
	dir = 4
	},
/obj/effect/turf_decal/tile/dark_blue/half/contrasted{
	dir = 4
	},
/obj/machinery/light/directional/east,
/turf/open/floor/iron/white,
/area/misc/hilbertshotel)
"XU" = (
/obj/effect/turf_decal/tile/dark_blue/half/contrasted{
	dir = 1
	},
/turf/open/floor/iron/white,
/area/misc/hilbertshotel)
"YV" = (
/obj/effect/turf_decal/siding/dark{
	dir = 4
	},
/obj/effect/turf_decal/tile/dark_blue/half/contrasted{
	dir = 4
	},
/obj/structure/chair{
	dir = 8
	},
/turf/open/floor/iron/white,
/area/misc/hilbertshotel)
"YY" = (
/obj/effect/turf_decal/siding/dark/corner{
	dir = 1
	},
/obj/effect/turf_decal/tile/dark_blue{
	dir = 1
	},
/turf/open/floor/iron/white,
/area/misc/hilbertshotel)
"ZL" = (
/obj/structure/chair/sofa/bench/right{
	dir = 8;
	pixel_x = 8
	},
/obj/effect/turf_decal/tile/dark_blue/full,
/turf/open/floor/iron/large,
/area/misc/hilbertshotel)

(1,1,1) = {"
jT
jT
jT
jT
jT
SS
SS
jT
jT
jT
jT
jT
jT
jT
jT
"}
(2,1,1) = {"
jT
jT
JI
lT
JI
PW
PW
JI
lT
JI
jT
DZ
DZ
DZ
jT
"}
(3,1,1) = {"
jT
Fb
cy
ZL
jU
cy
cy
ZL
jU
cy
CS
Pc
GI
mH
jT
"}
(4,1,1) = {"
jT
Vv
PW
yh
Gk
PW
PW
yh
Gk
PW
CS
Pc
kJ
MI
jT
"}
(5,1,1) = {"
jT
jT
sC
Vw
sC
cy
cy
sC
Vw
sC
jT
sF
sF
sF
jT
"}
(6,1,1) = {"
jT
jT
jT
jT
jT
CS
CS
jT
jT
jT
jT
jT
jT
jT
jT
"}
(7,1,1) = {"
jT
Qm
aM
aM
FI
BW
BW
pe
Kc
Kc
Kc
Kc
FI
Bh
jT
"}
(8,1,1) = {"
jT
XU
iX
FN
Ge
Ge
FN
FN
FN
Ge
Ge
FN
Pm
aC
jT
"}
(9,1,1) = {"
jT
XU
kt
BG
BG
BG
BG
BG
BG
BG
BG
BG
Rp
aC
jT
"}
(10,1,1) = {"
jT
uO
kC
BG
BG
BG
BG
BG
BG
BG
BG
BG
Rp
aC
jT
"}
(11,1,1) = {"
jT
bI
kC
BG
BG
BG
BG
BG
BG
BG
BG
BG
Rp
aC
jT
"}
(12,1,1) = {"
jT
yj
kC
BG
BG
BG
BG
BG
BG
BG
BG
BG
Rp
aC
jT
"}
(13,1,1) = {"
jT
XU
kt
BG
BG
BG
BG
BG
BG
BG
BG
BG
Rp
aC
jT
"}
(14,1,1) = {"
jT
XU
VE
BW
Cb
Cb
BW
BW
BW
Cb
Cb
BW
YY
aC
jT
"}
(15,1,1) = {"
jT
Gf
YV
YV
Xo
FN
qe
qe
Mk
qe
qe
sG
FN
xw
jT
"}
(16,1,1) = {"
jT
jT
jT
jT
jT
jT
jT
jT
jT
jT
jT
jT
jT
jT
jT
"}
