//MAP CONVERTED BY dmm2tgm.py THIS HEADER COMMENT PREVENTS RECONVERSION, DO NOT REMOVE
"ar" = (
/obj/effect/turf_decal/tile/neutral{
	dir = 8
	},
/turf/open/floor/iron,
/area/misc/hilbertshotel)
"aC" = (
/obj/machinery/light/small/dim/directional/east,
/turf/open/floor/plating,
/area/misc/hilbertshotel)
"aG" = (
/obj/effect/mapping_helpers/broken_floor,
/obj/effect/decal/cleanable/dirt,
/turf/open/floor/wood/parquet,
/area/misc/hilbertshotel)
"aS" = (
/obj/structure/chair/stool/bar/directional/north,
/obj/effect/turf_decal/siding/wood{
	dir = 1
	},
/obj/effect/decal/cleanable/dirt,
/turf/open/floor/wood,
/area/misc/hilbertshotel)
"bw" = (
/obj/structure/disposalpipe/segment{
	dir = 9
	},
/obj/effect/turf_decal/tile/neutral,
/turf/open/floor/iron,
/area/misc/hilbertshotel)
"bz" = (
/obj/structure/table/wood/poker,
/obj/item/storage/box/drinkingglasses,
/obj/effect/decal/cleanable/dirt,
/turf/open/floor/wood/parquet,
/area/misc/hilbertshotel)
"cy" = (
/obj/effect/mapping_helpers/broken_floor,
/turf/open/floor/wood,
/area/misc/hilbertshotel)
"cz" = (
/obj/structure/chair/wood{
	dir = 4
	},
/obj/effect/decal/cleanable/dirt,
/turf/open/floor/wood,
/area/misc/hilbertshotel)
"cD" = (
/obj/structure/steam_vent,
/obj/structure/cable,
/obj/machinery/atmospherics/pipe/smart/manifold4w/supply/hidden/layer4,
/obj/machinery/atmospherics/pipe/smart/manifold4w/scrubbers/hidden/layer2,
/obj/effect/decal/cleanable/dirt,
/turf/open/floor/plating,
/area/misc/hilbertshotel)
"dw" = (
/obj/structure/cable,
/obj/machinery/atmospherics/pipe/smart/manifold4w/supply/hidden/layer4,
/obj/machinery/atmospherics/pipe/smart/manifold4w/scrubbers/hidden/layer2,
/obj/effect/decal/cleanable/dirt,
/turf/open/floor/plating,
/area/misc/hilbertshotel)
"dS" = (
/obj/structure/closet/firecloset,
/turf/open/floor/plating,
/area/misc/hilbertshotel)
"dT" = (
/obj/effect/turf_decal/tile/neutral/fourcorners,
/turf/open/floor/iron,
/area/misc/hilbertshotel)
"dZ" = (
/obj/structure/cable,
/obj/machinery/atmospherics/pipe/smart/manifold4w/supply/hidden/layer4,
/obj/machinery/atmospherics/pipe/smart/manifold4w/scrubbers/hidden/layer2,
/obj/machinery/light/small/broken/directional/north,
/turf/open/floor/plating,
/area/misc/hilbertshotel)
"eO" = (
/obj/structure/grille/broken,
/obj/structure/cable,
/obj/machinery/atmospherics/pipe/smart/manifold4w/supply/hidden/layer4,
/obj/machinery/atmospherics/pipe/smart/manifold4w/scrubbers/hidden/layer2,
/obj/effect/decal/cleanable/dirt,
/turf/open/floor/plating,
/area/misc/hilbertshotel)
"fa" = (
/obj/structure/chair/sofa/right/brown,
/turf/open/floor/wood,
/area/misc/hilbertshotel)
"fi" = (
/obj/machinery/disposal/bin,
/obj/structure/disposalpipe/trunk{
	dir = 8
	},
/obj/effect/turf_decal/tile/dark/full,
/turf/open/floor/iron/large,
/area/misc/hilbertshotel)
"gQ" = (
/obj/effect/decal/cleanable/dirt,
/turf/open/floor/iron,
/area/misc/hilbertshotel)
"ho" = (
/obj/structure/table/wood/fancy,
/obj/item/pizzabox/infinite,
/turf/open/floor/wood,
/area/misc/hilbertshotel)
"hD" = (
/obj/structure/cable,
/obj/machinery/atmospherics/pipe/smart/manifold4w/supply/hidden/layer4,
/obj/machinery/atmospherics/pipe/smart/manifold4w/scrubbers/hidden/layer2,
/turf/closed/indestructible/steel,
/area/misc/hilbertshotel)
"ik" = (
/obj/structure/chair/wood{
	dir = 8
	},
/turf/open/floor/wood,
/area/misc/hilbertshotel)
"iL" = (
/obj/structure/table/wood/poker,
/obj/effect/decal/cleanable/dirt/dust,
/turf/open/floor/wood/parquet,
/area/misc/hilbertshotel)
"jr" = (
/obj/effect/turf_decal/tile/neutral,
/turf/open/floor/iron,
/area/misc/hilbertshotel)
"jx" = (
/obj/structure/table/wood,
/turf/open/floor/wood,
/area/misc/hilbertshotel)
"jT" = (
/obj/machinery/door/firedoor,
/obj/effect/turf_decal/stripes/line,
/obj/effect/turf_decal/stripes/line{
	dir = 1
	},
/obj/effect/turf_decal/caution/stand_clear,
/turf/open/floor/iron,
/area/misc/hilbertshotel)
"kh" = (
/obj/effect/mapping_helpers/broken_floor,
/obj/effect/decal/cleanable/dirt,
/obj/machinery/light/small/broken/directional/east,
/turf/open/floor/wood,
/area/misc/hilbertshotel)
"kD" = (
/obj/structure/table/wood,
/obj/effect/decal/cleanable/dirt,
/turf/open/floor/wood,
/area/misc/hilbertshotel)
"kS" = (
/obj/effect/decal/cleanable/dirt/dust,
/turf/open/floor/wood,
/area/misc/hilbertshotel)
"kW" = (
/obj/machinery/chem_dispenser/drinks/beer/fullupgrade,
/obj/structure/table/wood/poker,
/obj/effect/mapping_helpers/broken_floor,
/obj/machinery/light/small/directional/north,
/turf/open/floor/wood/parquet,
/area/misc/hilbertshotel)
"lU" = (
/obj/machinery/door/airlock/maintenance_hatch{
	name = "Maintenance Hatch"
	},
/obj/structure/cable,
/obj/machinery/atmospherics/pipe/smart/manifold4w/supply/hidden/layer4,
/obj/machinery/atmospherics/pipe/smart/manifold4w/scrubbers/hidden/layer2,
/turf/open/floor/plating,
/area/misc/hilbertshotel)
"md" = (
/obj/machinery/door/firedoor,
/obj/effect/turf_decal/stripes/line,
/obj/effect/turf_decal/stripes/line{
	dir = 1
	},
/turf/open/floor/iron,
/area/misc/hilbertshotel)
"ne" = (
/obj/structure/table,
/obj/item/stack/spacecash/c10,
/turf/open/floor/plating,
/area/misc/hilbertshotel)
"oZ" = (
/turf/closed/indestructible/steel,
/area/misc/hilbertshotel)
"pm" = (
/obj/effect/turf_decal/siding/wood,
/obj/effect/decal/cleanable/dirt,
/turf/open/floor/wood,
/area/misc/hilbertshotel)
"pD" = (
/obj/effect/decal/cleanable/dirt,
/obj/effect/decal/cleanable/blood/old,
/turf/open/floor/wood/parquet,
/area/misc/hilbertshotel)
"qf" = (
/obj/structure/disposalpipe/segment{
	dir = 6
	},
/obj/effect/turf_decal/tile/neutral,
/turf/open/floor/iron,
/area/misc/hilbertshotel)
"st" = (
/obj/structure/sink/kitchen{
	desc = "A sink used for washing one's hands and face. It looks rusty and home-made";
	name = "old sink";
	pixel_y = 23
	},
/obj/structure/mop_bucket,
/obj/effect/decal/cleanable/dirt,
/turf/open/floor/iron,
/area/misc/hilbertshotel)
"tZ" = (
/obj/effect/decal/cleanable/dirt,
/obj/effect/decal/cleanable/blood/old,
/obj/effect/decal/cleanable/vomit/old,
/obj/structure/toilet{
	dir = 8
	},
/turf/open/floor/iron,
/area/misc/hilbertshotel)
"uX" = (
/obj/structure/closet/wardrobe/botanist,
/obj/effect/decal/cleanable/dirt,
/turf/open/floor/plating,
/area/misc/hilbertshotel)
"wb" = (
/obj/structure/chair/sofa/left/brown,
/obj/effect/decal/cleanable/dirt,
/turf/open/floor/wood,
/area/misc/hilbertshotel)
"wl" = (
/obj/machinery/vending/cigarette/beach,
/obj/effect/turf_decal/tile/dark/full,
/obj/machinery/light/warm/directional/east,
/turf/open/floor/iron/large,
/area/misc/hilbertshotel)
"wu" = (
/obj/structure/table/wood/poker,
/obj/item/stack/spacecash/c10,
/obj/effect/decal/cleanable/dirt,
/turf/open/floor/wood/parquet,
/area/misc/hilbertshotel)
"wS" = (
/obj/structure/cable,
/obj/machinery/atmospherics/pipe/smart/manifold4w/supply/hidden/layer4,
/obj/machinery/atmospherics/pipe/smart/manifold4w/scrubbers/hidden/layer2,
/obj/effect/turf_decal/tile/neutral,
/turf/open/floor/iron,
/area/misc/hilbertshotel)
"xT" = (
/turf/open/floor/wood/parquet,
/area/misc/hilbertshotel)
"zA" = (
/obj/structure/table,
/obj/item/soap/deluxe,
/obj/effect/decal/cleanable/dirt,
/obj/item/storage/box/lights/mixed,
/turf/open/floor/iron,
/area/misc/hilbertshotel)
"zY" = (
/obj/machinery/door/firedoor,
/obj/effect/turf_decal/stripes/line,
/obj/effect/turf_decal/stripes/line{
	dir = 1
	},
/obj/effect/turf_decal/caution/stand_clear{
	dir = 1
	},
/turf/open/floor/iron,
/area/misc/hilbertshotel)
"Ae" = (
/obj/structure/table/wood,
/turf/open/floor/wood/parquet,
/area/misc/hilbertshotel)
"AE" = (
/obj/structure/closet/wardrobe/botanist,
/obj/item/weldingtool/advanced,
/obj/item/wrench,
/obj/item/screwdriver,
/turf/open/floor/plating,
/area/misc/hilbertshotel)
"BR" = (
/obj/effect/decal/cleanable/dirt/dust,
/turf/open/floor/wood/parquet,
/area/misc/hilbertshotel)
"Dc" = (
/turf/open/floor/wood,
/area/misc/hilbertshotel)
"DR" = (
/obj/structure/chair/stool/bar/directional/north,
/obj/effect/turf_decal/siding/wood{
	dir = 1
	},
/turf/open/floor/wood,
/area/misc/hilbertshotel)
"DX" = (
/obj/structure/reagent_dispensers/watertank,
/obj/effect/decal/cleanable/dirt,
/turf/open/floor/iron,
/area/misc/hilbertshotel)
"Ea" = (
/obj/item/stack/cable_coil/cut,
/mob/living/basic/mouse,
/obj/machinery/atmospherics/pipe/smart/manifold4w/supply/hidden/layer4,
/obj/machinery/atmospherics/pipe/smart/manifold4w/scrubbers/hidden/layer2,
/obj/effect/decal/cleanable/dirt,
/turf/open/floor/plating,
/area/misc/hilbertshotel)
"EX" = (
/obj/effect/decal/cleanable/dirt,
/turf/open/floor/wood,
/area/misc/hilbertshotel)
"Fl" = (
/obj/effect/decal/cleanable/dirt,
/obj/structure/sink/directional/south,
/obj/structure/mirror/broken/directional/north,
/obj/machinery/light/small/dim/directional/west,
/turf/open/floor/iron,
/area/misc/hilbertshotel)
"FN" = (
/obj/effect/turf_decal/tile/neutral,
/obj/machinery/light/warm/directional/east,
/turf/open/floor/iron,
/area/misc/hilbertshotel)
"Gv" = (
/obj/machinery/atmospherics/pipe/smart/manifold4w/scrubbers/hidden/layer2,
/obj/machinery/atmospherics/pipe/smart/manifold4w/supply/hidden/layer4,
/turf/closed/indestructible/steel,
/area/misc/hilbertshotel)
"HO" = (
/obj/effect/decal/cleanable/dirt,
/obj/machinery/light/small/directional/north,
/turf/open/floor/plating,
/area/misc/hilbertshotel)
"Ib" = (
/obj/structure/chair/wood{
	dir = 8
	},
/obj/effect/decal/cleanable/dirt,
/turf/open/floor/wood/parquet,
/area/misc/hilbertshotel)
"Ix" = (
/obj/effect/turf_decal/siding/wood,
/obj/effect/decal/cleanable/dirt,
/obj/machinery/light/small/broken/directional/west,
/turf/open/floor/wood,
/area/misc/hilbertshotel)
"Je" = (
/obj/structure/closet/crate,
/obj/item/stack/sheet/iron/fifty,
/obj/item/stack/sheet/mineral/wood/fifty,
/obj/effect/decal/cleanable/dirt,
/turf/open/floor/plating,
/area/misc/hilbertshotel)
"JW" = (
/obj/machinery/vending/boozeomat/all_access,
/obj/effect/decal/cleanable/dirt,
/turf/open/floor/wood/parquet,
/area/misc/hilbertshotel)
"Lc" = (
/obj/structure/table/wood/poker,
/obj/item/stack/spacecash/c1000,
/turf/open/floor/wood/parquet,
/area/misc/hilbertshotel)
"LC" = (
/obj/machinery/portable_atmospherics/canister/air,
/turf/open/floor/plating,
/area/misc/hilbertshotel)
"Mj" = (
/obj/structure/table/wood/poker,
/obj/effect/spawner/random/trash/soap,
/turf/open/floor/wood,
/area/misc/hilbertshotel)
"Mk" = (
/obj/structure/closet/crate,
/obj/effect/decal/cleanable/dirt,
/obj/machinery/light/small/dim/directional/west,
/turf/open/floor/plating,
/area/misc/hilbertshotel)
"Mp" = (
/obj/effect/turf_decal/siding/wood,
/obj/effect/decal/cleanable/dirt/dust,
/turf/open/floor/wood,
/area/misc/hilbertshotel)
"MO" = (
/obj/effect/turf_decal/tile/neutral{
	dir = 8
	},
/obj/machinery/light/warm/directional/west,
/turf/open/floor/iron,
/area/misc/hilbertshotel)
"Oh" = (
/turf/closed/indestructible/hoteldoor{
	icon_state = "closed";
	icon = 'modular_skyrat/modules/aesthetics/airlock/icons/airlocks/station2/glass.dmi'
	},
/area/misc/hilbertshotel)
"OQ" = (
/obj/structure/chair/wood{
	dir = 4
	},
/obj/effect/mapping_helpers/broken_floor,
/obj/effect/decal/cleanable/dirt,
/turf/open/floor/wood/parquet,
/area/misc/hilbertshotel)
"Py" = (
/turf/open/floor/plating,
/area/misc/hilbertshotel)
"PK" = (
/obj/effect/spawner/structure/window/reinforced,
/turf/open/floor/plating,
/area/misc/hilbertshotel)
"PQ" = (
/obj/structure/chair/sofa/middle/brown,
/obj/effect/decal/cleanable/dirt,
/turf/open/floor/wood,
/area/misc/hilbertshotel)
"Ql" = (
/obj/structure/rack,
/obj/item/crowbar,
/obj/effect/decal/cleanable/dirt,
/turf/open/floor/plating,
/area/misc/hilbertshotel)
"QJ" = (
/turf/open/space/bluespace{
	icon_state = "space";
	opacity = 1
	},
/area/misc/hilbertshotel)
"Rr" = (
/obj/structure/disposalpipe/segment,
/obj/effect/turf_decal/tile/neutral,
/turf/open/floor/iron,
/area/misc/hilbertshotel)
"RM" = (
/obj/machinery/vending/coffee,
/obj/effect/turf_decal/tile/dark/full,
/turf/open/floor/iron/large,
/area/misc/hilbertshotel)
"RP" = (
/obj/machinery/chem_dispenser/drinks/fullupgrade,
/obj/structure/table/wood/poker,
/turf/open/floor/wood/parquet,
/area/misc/hilbertshotel)
"Sr" = (
/obj/structure/chair/wood{
	dir = 8
	},
/turf/open/floor/wood/parquet,
/area/misc/hilbertshotel)
"SS" = (
/obj/structure/chair/stool/bar/directional/west,
/obj/effect/decal/cleanable/dirt,
/turf/open/floor/plating,
/area/misc/hilbertshotel)
"SV" = (
/obj/structure/disposalpipe/trunk,
/obj/effect/turf_decal/tile/neutral/fourcorners,
/turf/open/floor/iron,
/area/misc/hilbertshotel)
"Tj" = (
/obj/effect/decal/cleanable/dirt,
/turf/open/floor/plating,
/area/misc/hilbertshotel)
"Tu" = (
/obj/effect/mapping_helpers/broken_floor,
/obj/effect/turf_decal/siding/wood{
	dir = 8
	},
/obj/machinery/light/small/directional/south,
/turf/open/floor/wood,
/area/misc/hilbertshotel)
"Ul" = (
/obj/structure/table/wood/poker,
/obj/item/stack/spacecash/c1000,
/turf/open/floor/wood,
/area/misc/hilbertshotel)
"UQ" = (
/obj/machinery/vending/boozeomat/all_access,
/turf/open/floor/wood,
/area/misc/hilbertshotel)
"UU" = (
/obj/structure/closet/emcloset,
/turf/open/floor/plating,
/area/misc/hilbertshotel)
"Wh" = (
/obj/structure/table,
/obj/item/mop/advanced,
/obj/effect/decal/cleanable/dirt,
/turf/open/floor/iron,
/area/misc/hilbertshotel)
"Wt" = (
/obj/effect/decal/cleanable/dirt,
/obj/effect/decal/cleanable/dirt/dust,
/turf/open/floor/wood,
/area/misc/hilbertshotel)
"WI" = (
/obj/machinery/door/airlock/maintenance_hatch{
	name = "Maintenance Hatch"
	},
/turf/open/floor/plating,
/area/misc/hilbertshotel)
"WN" = (
/obj/structure/disposalpipe/segment{
	dir = 5
	},
/obj/effect/turf_decal/tile/neutral/fourcorners,
/turf/open/floor/iron,
/area/misc/hilbertshotel)
"WQ" = (
/obj/structure/table/wood/poker,
/obj/item/reagent_containers/cup/glass/shaker,
/turf/open/floor/wood/parquet,
/area/misc/hilbertshotel)
"WX" = (
/obj/structure/cable,
/obj/machinery/atmospherics/pipe/smart/manifold4w/supply/hidden/layer4,
/obj/machinery/atmospherics/pipe/smart/manifold4w/scrubbers/hidden/layer2,
/turf/open/floor/plating,
/area/misc/hilbertshotel)
"YW" = (
/obj/effect/mapping_helpers/broken_floor,
/obj/effect/decal/cleanable/dirt,
/turf/open/floor/plating,
/area/misc/hilbertshotel)
"Zp" = (
/obj/structure/rack,
/obj/item/storage/pill_bottle/maintenance_pill/full,
/turf/open/floor/plating,
/area/misc/hilbertshotel)
"Zq" = (
/obj/structure/chair/wood{
	dir = 4
	},
/turf/open/floor/wood/parquet,
/area/misc/hilbertshotel)

(1,1,1) = {"
oZ
oZ
oZ
oZ
oZ
oZ
oZ
oZ
oZ
oZ
oZ
oZ
oZ
oZ
oZ
"}
(2,1,1) = {"
oZ
Oh
ar
ar
ar
MO
ar
jT
ar
ar
ar
MO
ar
Oh
oZ
"}
(3,1,1) = {"
oZ
Oh
dT
dT
dT
dT
dT
md
dT
dT
dT
SV
WN
Oh
oZ
"}
(4,1,1) = {"
oZ
Oh
FN
jr
jr
jr
wS
zY
jr
jr
qf
Rr
bw
Oh
oZ
"}
(5,1,1) = {"
oZ
oZ
oZ
oZ
oZ
oZ
lU
oZ
wl
RM
fi
oZ
oZ
oZ
oZ
"}
(6,1,1) = {"
oZ
ne
Je
Ql
oZ
Mk
cD
oZ
oZ
oZ
oZ
oZ
UQ
wu
oZ
"}
(7,1,1) = {"
oZ
SS
Tj
Py
WI
Tj
WX
LC
oZ
Ul
Mj
Ix
Zq
OQ
oZ
"}
(8,1,1) = {"
oZ
HO
Tj
Tj
oZ
Tj
WX
Py
WI
EX
cy
Mp
Ae
Ae
oZ
"}
(9,1,1) = {"
oZ
uX
AE
oZ
oZ
Tj
dw
dS
oZ
cy
cz
pm
Ib
Sr
oZ
"}
(10,1,1) = {"
oZ
oZ
oZ
oZ
eO
Ea
WX
UU
oZ
YW
jx
Dc
Tu
oZ
oZ
"}
(11,1,1) = {"
oZ
Fl
WI
dw
dw
oZ
oZ
oZ
oZ
Wt
ik
fa
kS
PK
QJ
"}
(12,1,1) = {"
oZ
tZ
hD
dZ
Zp
oZ
WQ
xT
bz
aS
cy
PQ
EX
PK
QJ
"}
(13,1,1) = {"
Gv
Gv
Gv
WI
oZ
oZ
RP
aG
iL
aS
cz
wb
cy
PK
QJ
"}
(14,1,1) = {"
oZ
st
gQ
Tj
zA
oZ
kW
pD
Lc
DR
kD
kS
ho
PK
QJ
"}
(15,1,1) = {"
oZ
DX
aC
gQ
Wh
oZ
JW
BR
Tj
kh
ik
oZ
PK
PK
QJ
"}
(16,1,1) = {"
oZ
oZ
oZ
oZ
oZ
oZ
oZ
oZ
oZ
oZ
oZ
oZ
QJ
QJ
QJ
"}
