//MAP CONVERTED BY dmm2tgm.py THIS HEADER COMMENT PREVENTS RECONVERSION, DO NOT REMOVE
"ar" = (
/obj/item/kirbyplants/random,
/obj/effect/decal/cleanable/dirt,
/turf/open/floor/wood,
/area/misc/hilbertshotel)
"aC" = (
/obj/machinery/door/airlock/public,
/obj/machinery/door/firedoor,
/turf/open/floor/iron,
/area/misc/hilbertshotel)
"aS" = (
/obj/structure/girder,
/turf/open/floor/plating,
/area/misc/hilbertshotel)
"bw" = (
/obj/machinery/disposal/bin,
/obj/effect/turf_decal/bot,
/turf/open/floor/iron,
/area/misc/hilbertshotel)
"bz" = (
/obj/effect/turf_decal/tile/neutral,
/obj/machinery/light/directional/south,
/turf/open/floor/iron,
/area/misc/hilbertshotel)
"cy" = (
/obj/effect/mapping_helpers/broken_floor,
/turf/open/floor/wood,
/area/misc/hilbertshotel)
"cz" = (
/obj/structure/cable,
/obj/effect/decal/cleanable/dirt,
/turf/open/floor/plating,
/area/misc/hilbertshotel)
"cD" = (
/obj/structure/closet/crate/bin,
/obj/item/weldingtool/experimental,
/obj/item/crowbar,
/turf/open/floor/wood,
/area/misc/hilbertshotel)
"dw" = (
/obj/machinery/vending/cigarette,
/obj/effect/turf_decal/bot,
/turf/open/floor/iron,
/area/misc/hilbertshotel)
"dS" = (
/obj/structure/closet/firecloset,
/turf/open/floor/plating,
/area/misc/hilbertshotel)
"dT" = (
/obj/effect/turf_decal/tile/neutral/fourcorners,
/turf/open/floor/iron,
/area/misc/hilbertshotel)
"eO" = (
/obj/machinery/chem_dispenser/drinks/beer{
	dir = 8
	},
/obj/structure/table/wood/poker,
/turf/open/floor/wood,
/area/misc/hilbertshotel)
"fa" = (
/obj/effect/spawner/random/structure/chair_flipped,
/turf/open/floor/plating,
/area/misc/hilbertshotel)
"fi" = (
/obj/structure/chair/stool/bar/directional/east,
/turf/open/floor/wood,
/area/misc/hilbertshotel)
"gQ" = (
/obj/effect/turf_decal/tile/neutral{
	dir = 4
	},
/obj/effect/turf_decal/stripes/line{
	dir = 4
	},
/turf/open/floor/iron,
/area/misc/hilbertshotel)
"ho" = (
/obj/structure/cable,
/obj/effect/mapping_helpers/broken_floor,
/turf/open/floor/plating,
/area/misc/hilbertshotel)
"ik" = (
/obj/machinery/door/airlock/maintenance_hatch{
	name = "Maintenance Hatch"
	},
/obj/structure/cable,
/turf/open/floor/plating,
/area/misc/hilbertshotel)
"iL" = (
/obj/structure/reagent_dispensers/watertank,
/turf/open/floor/plating,
/area/misc/hilbertshotel)
"jr" = (
/obj/effect/turf_decal/tile/neutral,
/turf/open/floor/iron,
/area/misc/hilbertshotel)
"jx" = (
/obj/effect/turf_decal/tile/neutral,
/obj/effect/turf_decal/stripes/line{
	dir = 8
	},
/turf/open/floor/iron,
/area/misc/hilbertshotel)
"jT" = (
/obj/structure/table/wood,
/obj/item/storage/fancy/cigarettes/dromedaryco,
/turf/open/floor/wood,
/area/misc/hilbertshotel)
"kh" = (
/obj/machinery/portable_atmospherics/canister/air,
/obj/machinery/light/small/directional/east,
/turf/open/floor/plating,
/area/misc/hilbertshotel)
"kD" = (
/obj/structure/cable,
/turf/open/floor/plating,
/area/misc/hilbertshotel)
"kS" = (
/obj/effect/spawner/random/trash/mopbucket,
/obj/effect/mapping_helpers/broken_floor,
/turf/open/floor/plating,
/area/misc/hilbertshotel)
"kW" = (
/obj/structure/bed/maint,
/obj/effect/decal/cleanable/dirt,
/turf/open/floor/plating,
/area/misc/hilbertshotel)
"lU" = (
/obj/machinery/light/small/directional/north,
/turf/open/floor/wood,
/area/misc/hilbertshotel)
"md" = (
/obj/structure/chair{
	dir = 1
	},
/turf/open/floor/wood,
/area/misc/hilbertshotel)
"oZ" = (
/turf/closed/indestructible/steel,
/area/misc/hilbertshotel)
"pm" = (
/obj/effect/turf_decal/tile/neutral{
	dir = 4
	},
/obj/effect/turf_decal/stripes/line{
	dir = 8
	},
/turf/open/floor/iron,
/area/misc/hilbertshotel)
"pD" = (
/obj/effect/mapping_helpers/broken_floor,
/turf/open/floor/plating,
/area/misc/hilbertshotel)
"st" = (
/obj/effect/spawner/random/engineering/atmospherics_portable,
/turf/open/floor/plating,
/area/misc/hilbertshotel)
"tZ" = (
/obj/effect/spawner/random/vending/colavend,
/obj/effect/turf_decal/bot,
/turf/open/floor/iron,
/area/misc/hilbertshotel)
"uX" = (
/obj/effect/turf_decal/stripes/line{
	dir = 4
	},
/obj/effect/turf_decal/tile/neutral/fourcorners,
/turf/open/floor/iron,
/area/misc/hilbertshotel)
"wb" = (
/obj/structure/rack,
/obj/item/stack/sheet/mineral/wood/fifty,
/turf/open/floor/plating,
/area/misc/hilbertshotel)
"wl" = (
/obj/structure/table/wood/poker,
/turf/open/floor/wood,
/area/misc/hilbertshotel)
"wu" = (
/obj/item/soap/homemade,
/obj/structure/rack,
/turf/open/floor/plating,
/area/misc/hilbertshotel)
"wS" = (
/obj/machinery/light/small/directional/west,
/obj/effect/decal/cleanable/dirt,
/turf/open/floor/wood,
/area/misc/hilbertshotel)
"xT" = (
/turf/closed/wall,
/area/misc/hilbertshotel)
"zA" = (
/obj/effect/turf_decal/tile/neutral,
/obj/effect/turf_decal/stripes/line{
	dir = 4
	},
/turf/open/floor/iron,
/area/misc/hilbertshotel)
"zY" = (
/obj/effect/mapping_helpers/broken_floor,
/obj/structure/chair/stool/bar/directional/east,
/turf/open/floor/plating,
/area/misc/hilbertshotel)
"Ae" = (
/obj/structure/toilet{
	dir = 8
	},
/obj/effect/decal/cleanable/dirt,
/turf/open/floor/plating,
/area/misc/hilbertshotel)
"AE" = (
/obj/effect/turf_decal/tile/neutral{
	dir = 4
	},
/obj/machinery/light/directional/north,
/turf/open/floor/iron,
/area/misc/hilbertshotel)
"BR" = (
/obj/structure/chair/stool/directional/north,
/obj/machinery/light/small/directional/east,
/obj/effect/decal/cleanable/dirt,
/turf/open/floor/plating,
/area/misc/hilbertshotel)
"Dc" = (
/turf/open/floor/wood,
/area/misc/hilbertshotel)
"DR" = (
/obj/structure/trash_pile,
/turf/open/floor/plating,
/area/misc/hilbertshotel)
"DX" = (
/obj/effect/turf_decal/tile/neutral,
/obj/structure/extinguisher_cabinet/directional/south,
/turf/open/floor/iron,
/area/misc/hilbertshotel)
"Ea" = (
/obj/machinery/door/airlock/maintenance_hatch{
	name = "Maintenance Hatch"
	},
/obj/structure/cable,
/turf/open/floor/iron,
/area/misc/hilbertshotel)
"EX" = (
/obj/effect/decal/cleanable/dirt,
/turf/open/floor/wood,
/area/misc/hilbertshotel)
"Fl" = (
/obj/machinery/vending/coffee,
/obj/effect/turf_decal/bot,
/turf/open/floor/iron,
/area/misc/hilbertshotel)
"FN" = (
/turf/open/space/bluespace,
/area/misc/hilbertshotel)
"Gv" = (
/obj/effect/turf_decal/tile/neutral{
	dir = 4
	},
/obj/machinery/atmospherics/components/unary/vent_pump/layer4,
/turf/open/floor/iron,
/area/misc/hilbertshotel)
"HO" = (
/obj/effect/spawner/random/structure/closet_empty/crate,
/obj/machinery/light/small/directional/west,
/turf/open/floor/plating,
/area/misc/hilbertshotel)
"Ib" = (
/obj/structure/chair,
/turf/open/floor/wood,
/area/misc/hilbertshotel)
"Ix" = (
/obj/structure/table/wood/poker,
/obj/effect/spawner/random/maintenance,
/obj/effect/decal/cleanable/dirt,
/turf/open/floor/wood,
/area/misc/hilbertshotel)
"Je" = (
/obj/effect/turf_decal/tile/neutral{
	dir = 4
	},
/turf/open/floor/iron,
/area/misc/hilbertshotel)
"JW" = (
/obj/structure/table,
/obj/effect/spawner/random/maintenance,
/turf/open/floor/plating,
/area/misc/hilbertshotel)
"LC" = (
/obj/structure/table/wood/poker,
/obj/item/reagent_containers/cup/glass/shaker,
/turf/open/floor/wood,
/area/misc/hilbertshotel)
"Mj" = (
/obj/effect/turf_decal/tile/neutral,
/obj/machinery/atmospherics/components/unary/vent_scrubber/layer2{
	dir = 1
	},
/turf/open/floor/iron,
/area/misc/hilbertshotel)
"Mk" = (
/turf/open/floor/plating{
	icon_state = "space";
	icon = 'modular_zubbers/icons/space/space.dmi'
	},
/area/misc/hilbertshotel)
"Mp" = (
/obj/structure/cable,
/turf/closed/indestructible/steel,
/area/misc/hilbertshotel)
"MO" = (
/obj/structure/chair{
	dir = 4
	},
/turf/open/floor/wood,
/area/misc/hilbertshotel)
"Oh" = (
/obj/structure/closet/emcloset,
/obj/effect/turf_decal/delivery,
/turf/open/floor/iron,
/area/misc/hilbertshotel)
"Py" = (
/turf/open/floor/plating,
/area/misc/hilbertshotel)
"PK" = (
/obj/effect/spawner/structure/window/reinforced,
/turf/open/floor/plating,
/area/misc/hilbertshotel)
"QJ" = (
/turf/open/space/bluespace{
	icon_state = "space";
	opacity = 1
	},
/area/misc/hilbertshotel)
"Rr" = (
/obj/structure/chair{
	dir = 8
	},
/obj/effect/decal/cleanable/dirt,
/turf/open/floor/wood,
/area/misc/hilbertshotel)
"RM" = (
/obj/structure/table/wood/poker,
/obj/item/storage/box/matches{
	pixel_x = -3;
	pixel_y = 5
	},
/turf/open/floor/wood,
/area/misc/hilbertshotel)
"RP" = (
/obj/structure/tank_holder/emergency_oxygen,
/turf/open/floor/plating,
/area/misc/hilbertshotel)
"SS" = (
/turf/closed/indestructible/hoteldoor{
	icon_state = "door_closed";
	icon = 'icons/obj/doors/puzzledoor/default.dmi'
	},
/area/misc/hilbertshotel)
"SV" = (
/obj/structure/table/wood,
/obj/effect/spawner/random/entertainment/money_large,
/turf/open/floor/plating,
/area/misc/hilbertshotel)
"Tj" = (
/obj/effect/decal/cleanable/dirt,
/turf/open/floor/plating,
/area/misc/hilbertshotel)
"Tu" = (
/obj/machinery/light/small/directional/west,
/obj/effect/decal/cleanable/dirt,
/turf/open/floor/plating,
/area/misc/hilbertshotel)
"Ul" = (
/obj/structure/reagent_dispensers/fueltank,
/turf/open/floor/plating,
/area/misc/hilbertshotel)
"UQ" = (
/obj/machinery/vending/boozeomat/all_access,
/turf/open/floor/wood,
/area/misc/hilbertshotel)
"UU" = (
/obj/structure/closet/emcloset,
/turf/open/floor/plating,
/area/misc/hilbertshotel)
"Wh" = (
/obj/machinery/door/airlock/maintenance_hatch{
	name = "Maintenance Hatch"
	},
/obj/structure/barricade/wooden/crude,
/turf/open/floor/plating,
/area/misc/hilbertshotel)
"Wt" = (
/obj/structure/rack,
/obj/effect/spawner/random/engineering/flashlight,
/obj/effect/spawner/random/maintenance/three,
/turf/open/floor/plating,
/area/misc/hilbertshotel)
"WI" = (
/obj/machinery/door/airlock/maintenance_hatch{
	name = "Maintenance Hatch"
	},
/turf/open/floor/plating,
/area/misc/hilbertshotel)
"WN" = (
/obj/effect/spawner/random/trash/grille_or_waste,
/turf/open/floor/plating,
/area/misc/hilbertshotel)
"WX" = (
/obj/effect/turf_decal/stripes/line{
	dir = 8
	},
/obj/effect/turf_decal/tile/neutral/fourcorners,
/turf/open/floor/iron,
/area/misc/hilbertshotel)
"YW" = (
/obj/effect/decal/cleanable/dirt,
/obj/effect/mapping_helpers/broken_floor,
/turf/open/floor/plating,
/area/misc/hilbertshotel)
"Zq" = (
/obj/structure/sink/directional/east,
/obj/machinery/light/small/directional/west,
/obj/effect/decal/cleanable/dirt,
/obj/effect/mapping_helpers/broken_floor,
/turf/open/floor/plating,
/area/misc/hilbertshotel)

(1,1,1) = {"
FN
oZ
oZ
oZ
oZ
oZ
oZ
oZ
oZ
oZ
oZ
oZ
oZ
QJ
QJ
"}
(2,1,1) = {"
FN
oZ
aC
aC
aC
oZ
Ib
jT
md
ar
wS
MO
PK
Mk
QJ
"}
(3,1,1) = {"
oZ
oZ
pm
WX
jx
oZ
cy
EX
Tj
Dc
EX
SV
PK
Mk
QJ
"}
(4,1,1) = {"
oZ
Oh
Je
dT
bz
oZ
EX
zY
fi
fi
cy
Rr
PK
Mk
QJ
"}
(5,1,1) = {"
oZ
bw
Je
dT
Mj
oZ
lU
Ix
wl
RM
EX
cD
PK
Mk
QJ
"}
(6,1,1) = {"
oZ
oZ
Je
dT
jr
oZ
pD
EX
EX
oZ
WI
oZ
oZ
oZ
QJ
"}
(7,1,1) = {"
FN
SS
Je
dT
jr
oZ
UQ
LC
eO
oZ
Py
WI
Zq
oZ
QJ
"}
(8,1,1) = {"
FN
oZ
Je
dT
DX
oZ
oZ
oZ
oZ
oZ
WN
oZ
Ae
oZ
QJ
"}
(9,1,1) = {"
oZ
oZ
AE
dT
jr
oZ
DR
UU
dS
JW
fa
oZ
oZ
oZ
oZ
"}
(10,1,1) = {"
oZ
dw
Je
dT
jr
Ea
kD
cz
cz
YW
Py
Wh
Tu
wu
oZ
"}
(11,1,1) = {"
oZ
Fl
Je
dT
jr
oZ
iL
Ul
kh
Wt
cz
oZ
kS
wb
oZ
"}
(12,1,1) = {"
oZ
tZ
Je
dT
jr
oZ
xT
xT
xT
aS
ho
oZ
oZ
oZ
oZ
"}
(13,1,1) = {"
oZ
oZ
Gv
dT
bz
oZ
RP
Tj
WI
Tj
cz
oZ
HO
st
oZ
"}
(14,1,1) = {"
FN
oZ
gQ
uX
zA
oZ
kW
pD
xT
DR
kD
cz
ho
cz
oZ
"}
(15,1,1) = {"
FN
oZ
aC
aC
aC
oZ
JW
BR
xT
oZ
oZ
oZ
oZ
ik
oZ
"}
(16,1,1) = {"
FN
oZ
oZ
oZ
oZ
oZ
xT
xT
xT
FN
FN
FN
oZ
Mp
oZ
"}
