//MAP CONVERTED BY dmm2tgm.py THIS HEADER COMMENT PREVENTS RECONVERSION, DO NOT REMOVE
"eF" = (
/obj/effect/turf_decal/trimline/dark_red/filled/line{
	dir = 8
	},
/turf/open/indestructible/dark/textured,
/area/misc/hilbertshotel)
"gj" = (
/obj/effect/turf_decal/skyrat_decals/syndicate/bottom/right,
/obj/structure/table/reinforced/plastitaniumglass,
/obj/item/paper_bin{
	pixel_y = 4
	},
/obj/item/pen/fountain{
	pixel_y = 5
	},
/turf/open/floor/mineral/plastitanium/red,
/area/misc/hilbertshotel)
"gE" = (
/obj/structure/railing/unbreakable,
/turf/open/floor/iron/stairs/right{
	dir = 8
	},
/area/misc/hilbertshotel)
"gH" = (
/obj/effect/turf_decal/siding/thinplating_new/dark{
	dir = 8
	},
/obj/effect/turf_decal/siding/dark_red/corner,
/turf/open/floor/wood/large,
/area/misc/hilbertshotel)
"hg" = (
/turf/closed/indestructible/fakedoor,
/area/misc/hilbertshotel)
"hO" = (
/obj/effect/turf_decal/siding/thinplating_new/dark/corner{
	dir = 1
	},
/obj/effect/turf_decal/trimline/dark_red/filled/line{
	dir = 4
	},
/turf/open/indestructible/dark/textured,
/area/misc/hilbertshotel)
"iG" = (
/obj/effect/turf_decal/siding/thinplating_new/dark{
	dir = 8
	},
/obj/structure/table/reinforced/plastitaniumglass,
/obj/item/flashlight/lamp{
	pixel_x = -5;
	pixel_y = 10
	},
/obj/item/phone{
	pixel_x = 7;
	pixel_y = -2;
	desc = "Standard red phone, but somehow evil-er";
	name = "BLOOD-red phone"
	},
/turf/open/floor/wood/large,
/area/misc/hilbertshotel)
"iN" = (
/obj/effect/turf_decal/siding/thinplating_new/dark{
	dir = 4
	},
/obj/machinery/light/floor,
/turf/open/indestructible/dark/textured,
/area/misc/hilbertshotel)
"jc" = (
/obj/effect/turf_decal/siding/thinplating_new/dark{
	dir = 8
	},
/obj/item/kirbyplants/organic/plant22,
/obj/effect/turf_decal/siding/dark_red{
	dir = 4
	},
/obj/machinery/light/directional/south,
/turf/open/floor/wood/large,
/area/misc/hilbertshotel)
"jM" = (
/obj/effect/turf_decal/siding/thinplating_new/dark{
	dir = 6
	},
/obj/structure/railing/unbreakable{
	dir = 6
	},
/obj/structure/showcase/cyborg{
	desc = "A stand with the empty body of a Cybersun cyborg bolted to it.";
	dir = 4;
	icon = 'icons/mob/silicon/robots.dmi';
	icon_state = "synd_sec";
	name = "syndicate cyborg showcase";
	pixel_x = -6
	},
/turf/open/floor/mineral/plastitanium/red,
/area/misc/hilbertshotel)
"jV" = (
/obj/structure/table/reinforced/plastitaniumglass,
/obj/item/reagent_containers/cup/glass/bottle/vodka/badminka{
	pixel_y = 20
	},
/obj/item/reagent_containers/cup/glass/drinkingglass/shotglass{
	pixel_x = -8;
	pixel_y = 7
	},
/obj/item/reagent_containers/cup/glass/drinkingglass/shotglass{
	pixel_x = 8;
	pixel_y = 7
	},
/obj/item/reagent_containers/cup/glass/drinkingglass/shotglass{
	pixel_y = 2
	},
/turf/open/floor/wood/large,
/area/misc/hilbertshotel)
"kS" = (
/obj/machinery/light/floor,
/turf/open/indestructible/dark/textured,
/area/misc/hilbertshotel)
"my" = (
/obj/effect/turf_decal/trimline/dark_red/filled/line,
/turf/open/indestructible/dark/textured,
/area/misc/hilbertshotel)
"nj" = (
/obj/structure/railing/unbreakable{
	dir = 1
	},
/turf/open/floor/iron/stairs/left{
	dir = 8
	},
/area/misc/hilbertshotel)
"nr" = (
/obj/effect/turf_decal/siding/thinplating_new/dark{
	dir = 8
	},
/obj/effect/turf_decal/siding/dark_red/corner{
	dir = 4
	},
/turf/open/floor/wood/large,
/area/misc/hilbertshotel)
"nS" = (
/obj/effect/turf_decal/siding/thinplating_new/dark{
	dir = 10
	},
/obj/structure/railing/unbreakable{
	dir = 10
	},
/obj/structure/showcase/cyborg{
	desc = "A stand with the empty body of a Cybersun cyborg bolted to it.";
	dir = 8;
	icon = 'icons/mob/silicon/robots.dmi';
	icon_state = "synd_sec";
	name = "syndicate cyborg showcase";
	pixel_x = 6
	},
/turf/open/floor/mineral/plastitanium/red,
/area/misc/hilbertshotel)
"nW" = (
/obj/structure/table/reinforced/plastitaniumglass,
/obj/item/storage/fancy/cigarettes/cigars/havana{
	pixel_y = 21
	},
/obj/item/storage/fancy/cigarettes/cigpack_syndicate{
	pixel_y = 2;
	pixel_x = 6
	},
/obj/item/lighter/skull{
	pixel_x = -6;
	pixel_y = -2
	},
/turf/open/floor/wood/large,
/area/misc/hilbertshotel)
"nX" = (
/obj/effect/turf_decal/trimline/dark_red/filled/corner,
/turf/open/indestructible/dark/textured,
/area/misc/hilbertshotel)
"ou" = (
/obj/effect/turf_decal/trimline/dark_red/filled/line{
	dir = 6
	},
/turf/open/indestructible/dark/textured,
/area/misc/hilbertshotel)
"qx" = (
/turf/closed/indestructible/fakeglass,
/area/misc/hilbertshotel)
"qD" = (
/obj/effect/turf_decal/skyrat_decals/syndicate/middle/right,
/obj/structure/table/reinforced/plastitaniumglass,
/obj/machinery{
	icon = 'modular_skyrat/modules/aesthetics/intercom/icons/intercom.dmi';
	icon_state = "intercom";
	name = "Intercom"
	},
/turf/open/floor/mineral/plastitanium/red,
/area/misc/hilbertshotel)
"ry" = (
/obj/effect/turf_decal/siding/thinplating_new/dark{
	dir = 9
	},
/obj/structure/railing/unbreakable{
	dir = 9
	},
/obj/structure/showcase/cyborg{
	desc = "A stand with the empty body of a Cybersun cyborg bolted to it.";
	dir = 8;
	icon = 'icons/mob/silicon/robots.dmi';
	icon_state = "synd_sec";
	name = "syndicate cyborg showcase";
	pixel_x = 6
	},
/turf/open/floor/mineral/plastitanium/red,
/area/misc/hilbertshotel)
"sx" = (
/obj/effect/turf_decal/skyrat_decals/syndicate/top/left,
/obj/structure/table/reinforced/plastitaniumglass,
/obj/item/storage/fancy/cigarettes/cigpack_syndicate{
	pixel_y = 2;
	pixel_x = -6
	},
/obj/item/lighter{
	pixel_x = 15;
	pixel_y = 4
	},
/turf/open/floor/mineral/plastitanium/red,
/area/misc/hilbertshotel)
"sW" = (
/obj/effect/turf_decal/siding/thinplating_new/dark,
/obj/structure/chair/comfy/shuttle{
	color = "#474747"
	},
/turf/open/indestructible/dark/textured,
/area/misc/hilbertshotel)
"vE" = (
/turf/open/space/basic,
/area/misc/hilbertshotel)
"vO" = (
/obj/effect/turf_decal/siding/dark_red/corner{
	dir = 1
	},
/obj/structure/secure_safe/directional/north,
/obj/item/kirbyplants/organic/plant21,
/turf/open/floor/wood/large,
/area/misc/hilbertshotel)
"vX" = (
/obj/effect/turf_decal/siding/thinplating_new/dark{
	dir = 1
	},
/turf/closed/indestructible/syndicate,
/area/misc/hilbertshotel)
"wg" = (
/obj/effect/turf_decal/siding/thinplating_new/dark{
	dir = 8
	},
/obj/effect/turf_decal/trimline/dark_red/filled/line{
	dir = 4
	},
/obj/machinery/light/floor,
/turf/open/indestructible/dark/textured,
/area/misc/hilbertshotel)
"wU" = (
/obj/effect/turf_decal/skyrat_decals/syndicate/top/right,
/obj/structure/table/reinforced/plastitaniumglass,
/obj/item/reagent_containers/cup/glass/coffee/colonial{
	pixel_x = -14;
	pixel_y = 11
	},
/obj/item/paper_bin{
	pixel_y = 4
	},
/obj/item/pen/fountain{
	pixel_y = 5
	},
/turf/open/floor/mineral/plastitanium/red,
/area/misc/hilbertshotel)
"xb" = (
/turf/closed/indestructible/syndicate,
/area/misc/hilbertshotel)
"xi" = (
/obj/effect/turf_decal/skyrat_decals/syndicate/middle/left,
/turf/open/floor/mineral/plastitanium/red,
/area/misc/hilbertshotel)
"xQ" = (
/obj/effect/turf_decal/trimline/dark_red/filled/line{
	dir = 5
	},
/turf/open/indestructible/dark/textured,
/area/misc/hilbertshotel)
"yr" = (
/obj/effect/turf_decal/skyrat_decals/syndicate/bottom/left,
/obj/structure/table/reinforced/plastitaniumglass,
/obj/item/folder/red{
	pixel_x = 4;
	pixel_y = 1
	},
/obj/item/pen/fountain{
	pixel_x = 4;
	pixel_y = 1
	},
/obj/item/reagent_containers/cup/glass/coffee/colonial{
	pixel_x = -7;
	pixel_y = 3
	},
/turf/open/floor/mineral/plastitanium/red,
/area/misc/hilbertshotel)
"yG" = (
/obj/effect/turf_decal/skyrat_decals/syndicate/top/middle,
/obj/structure/table/reinforced/plastitaniumglass,
/turf/open/floor/mineral/plastitanium/red,
/area/misc/hilbertshotel)
"BE" = (
/obj/effect/turf_decal/siding/thinplating_new/dark{
	dir = 8
	},
/obj/structure/railing/unbreakable{
	dir = 8
	},
/obj/structure/showcase/mecha/marauder{
	icon_state = "darkgygax"
	},
/turf/open/floor/mineral/plastitanium/red,
/area/misc/hilbertshotel)
"Dc" = (
/obj/effect/turf_decal/trimline/dark_red/filled/line{
	dir = 1
	},
/turf/open/indestructible/dark/textured,
/area/misc/hilbertshotel)
"EM" = (
/obj/effect/turf_decal/siding/thinplating_new/dark/corner{
	dir = 8
	},
/obj/effect/turf_decal/trimline/dark_red/filled/line{
	dir = 4
	},
/turf/open/indestructible/dark/textured,
/area/misc/hilbertshotel)
"FL" = (
/obj/item/kirbyplants/organic/plant21,
/obj/effect/turf_decal/trimline/dark_red/filled/line{
	dir = 8
	},
/turf/open/indestructible/dark/textured,
/area/misc/hilbertshotel)
"GJ" = (
/obj/effect/turf_decal/trimline/dark_red/filled/line{
	dir = 9
	},
/obj/machinery/vending/cigarette/syndicate,
/obj/machinery/light/directional/north,
/turf/open/indestructible/dark/textured,
/area/misc/hilbertshotel)
"Hc" = (
/obj/effect/turf_decal/siding/dark_red/corner{
	dir = 8
	},
/obj/item/kirbyplants/organic/plant8,
/turf/open/floor/wood/large,
/area/misc/hilbertshotel)
"Hd" = (
/obj/effect/turf_decal/trimline/dark_red/filled/corner{
	dir = 8
	},
/turf/open/indestructible/dark/textured,
/area/misc/hilbertshotel)
"Hf" = (
/obj/structure/chair/comfy{
	color = "#DD2211";
	dir = 8
	},
/turf/open/floor/carpet/royalblack,
/area/misc/hilbertshotel)
"Hq" = (
/obj/effect/turf_decal/trimline/dark_red/filled/line{
	dir = 9
	},
/turf/open/indestructible/dark/textured,
/area/misc/hilbertshotel)
"HD" = (
/obj/effect/turf_decal/siding/thinplating_new/dark/corner,
/turf/open/indestructible/dark/textured,
/area/misc/hilbertshotel)
"HI" = (
/turf/closed/indestructible/hoteldoor{
	icon_state = "door_closed";
	icon = 'icons/obj/doors/puzzledoor/default.dmi'
	},
/area/misc/hilbertshotel)
"HW" = (
/obj/effect/turf_decal/trimline/dark_red/filled/line{
	dir = 4
	},
/turf/open/indestructible/dark/textured,
/area/misc/hilbertshotel)
"IK" = (
/turf/open/indestructible/dark/textured,
/area/misc/hilbertshotel)
"Lb" = (
/obj/structure/railing/corner/end/flip{
	dir = 8
	},
/obj/effect/turf_decal/trimline/dark_red/filled/line{
	dir = 8
	},
/turf/open/indestructible/dark/textured,
/area/misc/hilbertshotel)
"Mw" = (
/turf/open/floor/carpet/black,
/area/misc/hilbertshotel)
"MC" = (
/turf/open/floor/carpet/royalblack,
/area/misc/hilbertshotel)
"MJ" = (
/obj/machinery/vending/wardrobe/syndie_wardrobe/ghost_cafe,
/obj/effect/turf_decal/delivery,
/turf/open/indestructible/dark/textured{
	icon_state = "engine"
	},
/area/misc/hilbertshotel)
"No" = (
/obj/effect/turf_decal/siding/thinplating_new/dark{
	dir = 8
	},
/obj/structure/table/reinforced/plastitaniumglass,
/obj/item/paper_bin{
	pixel_y = 6;
	pixel_x = -4
	},
/obj/item/stamp{
	pixel_x = 9;
	pixel_y = 11
	},
/obj/item/stamp/denied{
	pixel_x = 9;
	pixel_y = 7
	},
/obj/item/stamp/syndicate{
	pixel_x = 9;
	pixel_y = 3
	},
/turf/open/floor/wood/large,
/area/misc/hilbertshotel)
"NS" = (
/obj/structure/table/reinforced/plastitaniumglass,
/obj/item/sign/flag/syndicate{
	pixel_y = 3
	},
/turf/open/floor/wood/large,
/area/misc/hilbertshotel)
"OS" = (
/obj/effect/turf_decal/siding/thinplating_new/dark{
	dir = 4
	},
/obj/structure/railing/unbreakable{
	dir = 4
	},
/obj/structure/showcase/mecha/ripley{
	icon_state = "mauler"
	},
/turf/open/floor/mineral/plastitanium/red,
/area/misc/hilbertshotel)
"Qg" = (
/obj/effect/turf_decal/skyrat_decals/syndicate/middle/middle,
/turf/open/floor/mineral/plastitanium/red,
/area/misc/hilbertshotel)
"QG" = (
/obj/effect/turf_decal/siding/thinplating_new/dark{
	dir = 8
	},
/obj/structure/railing/unbreakable{
	dir = 8
	},
/obj/structure/showcase/mecha/ripley{
	icon_state = "mauler"
	},
/turf/open/floor/mineral/plastitanium/red,
/area/misc/hilbertshotel)
"QH" = (
/obj/effect/turf_decal/trimline/dark_red/filled/corner{
	dir = 1
	},
/turf/open/indestructible/dark/textured,
/area/misc/hilbertshotel)
"Rb" = (
/obj/effect/turf_decal/siding/thinplating_new/dark{
	dir = 5
	},
/obj/structure/railing/unbreakable{
	dir = 5
	},
/obj/structure/showcase/cyborg{
	desc = "A stand with the empty body of a Cybersun cyborg bolted to it.";
	dir = 4;
	icon = 'icons/mob/silicon/robots.dmi';
	icon_state = "synd_sec";
	name = "syndicate cyborg showcase";
	pixel_x = -6
	},
/turf/open/floor/mineral/plastitanium/red,
/area/misc/hilbertshotel)
"Rv" = (
/obj/structure/railing/corner/end/unbreakable{
	dir = 8
	},
/obj/effect/turf_decal/trimline/dark_red/filled/line{
	dir = 8
	},
/turf/open/indestructible/dark/textured,
/area/misc/hilbertshotel)
"Sb" = (
/obj/effect/turf_decal/siding/thinplating_new/dark{
	dir = 8
	},
/obj/effect/turf_decal/siding/dark_red{
	dir = 4
	},
/obj/machinery/light/directional/north,
/turf/open/floor/wood/large,
/area/misc/hilbertshotel)
"Sd" = (
/obj/effect/turf_decal/siding/thinplating_new/dark{
	dir = 1
	},
/obj/structure/chair/comfy/shuttle{
	color = "#474747";
	dir = 1
	},
/turf/open/indestructible/dark/textured,
/area/misc/hilbertshotel)
"Sk" = (
/obj/effect/turf_decal/siding/thinplating_new/dark{
	dir = 8
	},
/obj/effect/turf_decal/trimline/dark_red/filled/line{
	dir = 4
	},
/turf/open/indestructible/dark/textured,
/area/misc/hilbertshotel)
"Su" = (
/obj/effect/turf_decal/siding/dark_red,
/turf/open/floor/wood/large,
/area/misc/hilbertshotel)
"SJ" = (
/obj/effect/turf_decal/trimline/dark_red/filled/corner{
	dir = 4
	},
/turf/open/indestructible/dark/textured,
/area/misc/hilbertshotel)
"TM" = (
/obj/effect/turf_decal/trimline/dark_red/filled/line{
	dir = 10
	},
/obj/machinery/vending/boozeomat/syndicate,
/obj/machinery/light/directional/south,
/turf/open/indestructible/dark/textured,
/area/misc/hilbertshotel)
"TN" = (
/obj/structure/sign/flag/syndicate/directional/east,
/obj/machinery/suit_storage_unit/syndicate,
/obj/effect/turf_decal/delivery,
/turf/open/indestructible/dark/textured{
	icon_state = "engine"
	},
/area/misc/hilbertshotel)
"TY" = (
/obj/effect/turf_decal/siding/thinplating_new/dark{
	dir = 4
	},
/turf/open/indestructible/dark/textured,
/area/misc/hilbertshotel)
"Vp" = (
/obj/effect/turf_decal/siding/dark_red{
	dir = 1
	},
/turf/open/floor/wood/large,
/area/misc/hilbertshotel)
"Vz" = (
/obj/item/kirbyplants/organic/plant22,
/turf/open/floor/carpet/black,
/area/misc/hilbertshotel)
"VU" = (
/turf/open/floor/iron/stairs/medium{
	dir = 8
	},
/area/misc/hilbertshotel)
"WP" = (
/obj/effect/turf_decal/siding/thinplating_new/dark{
	dir = 4
	},
/obj/structure/railing/unbreakable{
	dir = 4
	},
/obj/structure/showcase/mecha/marauder{
	icon_state = "darkgygax"
	},
/turf/open/floor/mineral/plastitanium/red,
/area/misc/hilbertshotel)
"Xp" = (
/obj/effect/turf_decal/skyrat_decals/syndicate/bottom/middle,
/obj/structure/table/reinforced/plastitaniumglass,
/turf/open/floor/mineral/plastitanium/red,
/area/misc/hilbertshotel)
"Xu" = (
/obj/item/kirbyplants/organic/plant22,
/obj/structure/sign/warning/yes_smoking/circle/directional/north,
/turf/open/floor/carpet/black,
/area/misc/hilbertshotel)
"Yv" = (
/obj/effect/turf_decal/trimline/dark_red/filled/line{
	dir = 10
	},
/turf/open/indestructible/dark/textured,
/area/misc/hilbertshotel)
"YG" = (
/obj/item/kirbyplants/organic/plant24,
/obj/effect/turf_decal/trimline/dark_red/filled/line{
	dir = 8
	},
/turf/open/indestructible/dark/textured,
/area/misc/hilbertshotel)
"Zv" = (
/obj/effect/turf_decal/siding/thinplating_new/dark/corner{
	dir = 4
	},
/turf/open/indestructible/dark/textured,
/area/misc/hilbertshotel)
"ZW" = (
/obj/effect/turf_decal/siding/thinplating_new/dark{
	dir = 8
	},
/obj/structure/table/reinforced/plastitaniumglass,
/obj/item/folder/syndicate/blue,
/obj/item/pen/edagger,
/turf/open/floor/wood/large,
/area/misc/hilbertshotel)

(1,1,1) = {"
vE
vE
vE
vE
vE
xb
qx
HI
qx
xb
vE
vE
vE
vE
vE
vE
"}
(2,1,1) = {"
vE
vE
vE
vE
vE
xb
Xu
Mw
Vz
xb
vE
vE
vE
vE
vE
vE
"}
(3,1,1) = {"
vE
vE
xb
xb
xb
xb
nj
VU
gE
xb
xb
xb
vE
vE
vE
vE
"}
(4,1,1) = {"
vE
xb
xb
xb
GJ
FL
Rv
eF
Lb
YG
TM
vX
xb
xb
vE
vE
"}
(5,1,1) = {"
vE
xb
WP
jM
Dc
HD
TY
iN
TY
Zv
my
Rb
OS
xb
vE
vE
"}
(6,1,1) = {"
vE
xb
Hq
eF
QH
sW
sx
xi
yr
Sd
Hd
eF
Yv
xb
vE
vE
"}
(7,1,1) = {"
vE
hg
Dc
kS
IK
sW
yG
Qg
Xp
Sd
IK
kS
my
hg
vE
vE
"}
(8,1,1) = {"
vE
xb
xQ
HW
SJ
sW
wU
qD
gj
Sd
nX
HW
ou
xb
vE
vE
"}
(9,1,1) = {"
vE
xb
QG
nS
xQ
EM
Sk
wg
Sk
hO
ou
ry
BE
xb
vE
vE
"}
(10,1,1) = {"
vE
xb
xb
xb
Sb
nr
iG
ZW
No
gH
jc
xb
xb
xb
vE
vE
"}
(11,1,1) = {"
vE
vE
vE
xb
MJ
Vp
MC
Hf
MC
Su
TN
xb
vE
vE
vE
vE
"}
(12,1,1) = {"
vE
vE
vE
xb
xb
vO
MC
MC
MC
Hc
xb
xb
vE
vE
vE
vE
"}
(13,1,1) = {"
vE
vE
vE
vE
qx
qx
jV
NS
nW
qx
qx
vE
vE
vE
vE
vE
"}
(14,1,1) = {"
vE
vE
vE
vE
vE
qx
qx
qx
qx
qx
vE
vE
vE
vE
vE
vE
"}
(15,1,1) = {"
vE
vE
vE
vE
vE
vE
vE
vE
vE
vE
vE
vE
vE
vE
vE
vE
"}
