//MAP CONVERTED BY dmm2tgm.py THIS HEADER COMMENT PREVENTS RECONVERSION, DO NOT REMOVE
"aj" = (
/turf/open/floor/wood/tile,
/area/misc/hilbertshotel/winterwoods)
"aI" = (
/obj/structure/flora/bush/snow/style_random,
/mob/living/basic/pet/penguin/baby/permanent/snowdin,
/turf/open/floor/fake_snow/safe,
/area/misc/hilbertshotel/winterwoods)
"aL" = (
/obj/effect/turf_decal/siding/wood{
	dir = 1
	},
/obj/item/stack/sheet/mineral/wood/fifty{
	pixel_x = 8;
	pixel_y = -5
	},
/obj/item/assembly/igniter{
	pixel_x = -6;
	pixel_y = -6
	},
/obj/structure/fireplace,
/turf/open/floor/wood/tile,
/area/misc/hilbertshotel/winterwoods)
"by" = (
/obj/structure/flora/bush/snow/style_4,
/obj/effect/turf_decal/weather/snow/corner{
	dir = 8
	},
/turf/open/floor/fake_snow/safe,
/area/misc/hilbertshotel/winterwoods)
"cg" = (
/obj/structure/railing/wooden_fencing{
	dir = 4
	},
/turf/open/floor/fake_snow/safe,
/area/misc/hilbertshotel/winterwoods)
"cI" = (
/obj/structure/sign/flag/nri,
/turf/closed/indestructible/wood,
/area/misc/hilbertshotel/winterwoods)
"de" = (
/obj/effect/turf_decal/siding/wood{
	dir = 1
	},
/obj/effect/turf_decal/siding/wood{
	dir = 8
	},
/turf/open/floor/wood/tile,
/area/misc/hilbertshotel/winterwoods)
"eh" = (
/obj/structure/closet/crate/wooden,
/obj/item/clothing/suit/modern_winter,
/obj/item/clothing/suit/modern_winter,
/obj/item/clothing/shoes/winterboots,
/obj/item/clothing/shoes/winterboots,
/obj/item/clothing/head/costume/ushanka,
/obj/item/clothing/head/costume/ushanka,
/obj/item/clothing/head/costume/ushanka/frosty,
/obj/item/clothing/head/costume/ushanka/frosty,
/obj/item/clothing/mask/gas,
/obj/item/clothing/mask/gas,
/obj/item/tank/internals/emergency_oxygen/double,
/obj/item/tank/internals/emergency_oxygen/double,
/obj/item/clothing/under/costume/soviet,
/obj/item/clothing/under/costume/soviet,
/turf/open/floor/fake_snow/safe,
/area/misc/hilbertshotel/winterwoods)
"es" = (
/obj/item/grown/log/tree,
/turf/open/floor/fake_snow/safe,
/area/misc/hilbertshotel/winterwoods)
"fQ" = (
/obj/effect/turf_decal/weather/snow/corner,
/turf/open/floor/fake_snow/safe,
/area/misc/hilbertshotel/winterwoods)
"fS" = (
/obj/structure/chair/wood{
	dir = 4
	},
/obj/effect/turf_decal/siding/wood{
	dir = 8
	},
/obj/effect/turf_decal/siding/wood,
/turf/open/floor/wood/tile,
/area/misc/hilbertshotel/winterwoods)
"gD" = (
/obj/effect/turf_decal/weather/snow/corner,
/turf/closed/indestructible/rock/snow/ice/ore,
/area/misc/hilbertshotel/winterwoods)
"ht" = (
/obj/effect/turf_decal/siding/wood{
	dir = 8
	},
/obj/structure/bed/double{
	dir = 1
	},
/obj/item/bedsheet/runtime/double{
	dir = 1
	},
/obj/item/toy/plush/skyrat/snow_owl,
/obj/machinery/room_controller/directional/west,
/turf/open/floor/wood/tile,
/area/misc/hilbertshotel/winterwoods)
"kv" = (
/obj/structure/chair/sofa/bench/left{
	dir = 4;
	color = "#76502e";
	name = "Lover's Watch"
	},
/turf/open/floor/fake_snow/safe,
/area/misc/hilbertshotel/winterwoods)
"lf" = (
/obj/structure/flora/bush/snow/style_4,
/obj/structure/flora/tree/pine,
/turf/open/floor/fake_snow/safe,
/area/misc/hilbertshotel/winterwoods)
"mU" = (
/obj/structure/flora/bush/snow/style_4,
/turf/open/floor/fake_snow/safe,
/area/misc/hilbertshotel/winterwoods)
"pI" = (
/obj/structure/table/wood/shuttle_bar,
/obj/effect/turf_decal/siding/wood,
/obj/item/flashlight/lantern/on{
	pixel_x = -5;
	pixel_y = 15
	},
/obj/item/reagent_containers/cup/glass/bottle/vodka{
	pixel_x = 8;
	pixel_y = 17
	},
/obj/item/reagent_containers/cup/glass/drinkingglass/shotglass{
	pixel_x = 2;
	pixel_y = 3
	},
/obj/item/reagent_containers/cup/glass/drinkingglass/shotglass{
	pixel_x = -7;
	pixel_y = 0
	},
/turf/open/floor/wood/tile,
/area/misc/hilbertshotel/winterwoods)
"rB" = (
/turf/closed/indestructible/rock/snow/ice/ore,
/area/misc/hilbertshotel/winterwoods)
"tT" = (
/obj/structure/flora/bush/snow/style_random,
/turf/open/floor/fake_snow/safe,
/area/misc/hilbertshotel/winterwoods)
"ua" = (
/obj/effect/turf_decal/siding/wood{
	dir = 1
	},
/obj/effect/turf_decal/siding/wood{
	dir = 4
	},
/obj/item/storage/box/colonial_rations{
	pixel_x = 7;
	pixel_y = -6
	},
/obj/item/storage/box/colonial_rations{
	pixel_x = -6;
	pixel_y = 8
	},
/obj/item/storage/box/colonial_rations{
	pixel_x = -6;
	pixel_y = -7
	},
/obj/structure/rack/wooden,
/turf/open/floor/wood/tile,
/area/misc/hilbertshotel/winterwoods)
"uY" = (
/obj/item/flashlight/lantern/jade,
/turf/open/floor/fake_snow/safe,
/area/misc/hilbertshotel/winterwoods)
"wq" = (
/obj/effect/decal/remains/plasma,
/turf/open/floor/fakeice/slippery,
/area/misc/hilbertshotel/winterwoods)
"wK" = (
/obj/effect/spawner/structure/window/ice,
/obj/structure/barricade/wooden/crude/snow,
/obj/structure/curtain/bounty/start_closed,
/turf/open/floor/fake_snow/safe,
/area/misc/hilbertshotel/winterwoods)
"xR" = (
/obj/structure/flora/tree/pine/style_random,
/turf/open/floor/fake_snow/safe,
/area/misc/hilbertshotel/winterwoods)
"yd" = (
/turf/open/floor/fake_snow/safe,
/area/misc/hilbertshotel/winterwoods)
"yf" = (
/obj/structure/flora/tree/dead/style_random,
/turf/open/floor/fake_snow/safe,
/area/misc/hilbertshotel/winterwoods)
"AG" = (
/turf/closed/indestructible/wood,
/area/misc/hilbertshotel/winterwoods)
"AY" = (
/obj/structure/flora/grass/both/style_random,
/turf/open/floor/fake_snow/safe,
/area/misc/hilbertshotel/winterwoods)
"Cs" = (
/obj/structure/flora/tree/pine,
/turf/open/floor/fake_snow/safe,
/area/misc/hilbertshotel/winterwoods)
"CC" = (
/turf/open/lava/plasma/biodome,
/area/misc/hilbertshotel/winterwoods)
"Dx" = (
/obj/structure/barricade/wooden/snowed,
/obj/structure/curtain/bounty/start_closed,
/obj/effect/spawner/structure/window/ice,
/turf/open/floor/fake_snow/safe,
/area/misc/hilbertshotel/winterwoods)
"EN" = (
/turf/open/floor/fakeice/slippery,
/area/misc/hilbertshotel/winterwoods)
"ET" = (
/obj/structure/barricade/wooden/snowed,
/turf/open/floor/fake_snow/safe,
/area/misc/hilbertshotel/winterwoods)
"FP" = (
/obj/effect/turf_decal/siding/wood{
	dir = 8
	},
/turf/open/floor/wood/tile,
/area/misc/hilbertshotel/winterwoods)
"Hg" = (
/obj/effect/turf_decal/weather/snow/corner,
/obj/structure/statue/snow/snowman,
/turf/open/floor/fake_snow/safe,
/area/misc/hilbertshotel/winterwoods)
"HG" = (
/obj/structure/chair/wood/wings{
	dir = 8
	},
/obj/effect/turf_decal/siding/wood,
/obj/effect/turf_decal/siding/wood{
	dir = 4
	},
/turf/open/floor/wood/tile,
/area/misc/hilbertshotel/winterwoods)
"Jn" = (
/obj/structure/sign/poster/contraband/soviet_propaganda,
/turf/closed/indestructible/wood,
/area/misc/hilbertshotel/winterwoods)
"Jv" = (
/turf/open/floor/plating/snowed/smoothed{
	planetary_atmos = 0
	},
/area/misc/hilbertshotel/winterwoods)
"KZ" = (
/obj/structure/mineral_door/wood,
/obj/effect/turf_decal/weather/snow,
/turf/open/floor/fake_snow/safe,
/area/misc/hilbertshotel/winterwoods)
"Lw" = (
/obj/machinery/vending/dorms{
	pixel_y = -10
	},
/turf/closed/indestructible/wood,
/area/misc/hilbertshotel/winterwoods)
"Mr" = (
/obj/effect/turf_decal/weather/snow,
/turf/open/misc/dirt/jungle,
/area/misc/hilbertshotel/winterwoods)
"Nh" = (
/obj/effect/spawner/structure/window/ice,
/obj/structure/barricade/wooden/crude/snow,
/turf/open/floor/fake_snow/safe,
/area/misc/hilbertshotel/winterwoods)
"No" = (
/obj/effect/turf_decal/weather/snow/corner,
/turf/open/floor/plating/snowed/smoothed{
	planetary_atmos = 0
	},
/area/misc/hilbertshotel/winterwoods)
"OB" = (
/obj/structure/bonfire/prelit,
/obj/effect/turf_decal/weather/snow,
/turf/open/misc/dirt/jungle,
/area/misc/hilbertshotel/winterwoods)
"OH" = (
/mob/living/basic/pet/penguin/baby/permanent/snowdin,
/turf/open/floor/fake_snow/safe,
/area/misc/hilbertshotel/winterwoods)
"ON" = (
/obj/effect/turf_decal/weather/snow/corner{
	dir = 8
	},
/turf/open/floor/fake_snow/safe,
/area/misc/hilbertshotel/winterwoods)
"Qb" = (
/obj/structure/railing/wooden_fencing{
	dir = 4
	},
/obj/structure/railing/wooden_fencing,
/turf/open/floor/fake_snow/safe,
/area/misc/hilbertshotel/winterwoods)
"Tt" = (
/obj/structure/flora/grass/both/style_random,
/obj/effect/turf_decal/weather/snow/corner,
/obj/effect/overlay/light_snow,
/turf/open/floor/fake_snow/safe,
/area/misc/hilbertshotel/winterwoods)
"Yk" = (
/turf/closed/indestructible/hoteldoor{
	icon_state = "door_closed";
	icon = 'icons/obj/doors/puzzledoor/default.dmi'
	},
/area/misc/hilbertshotel/winterwoods)
"YY" = (
/obj/structure/chair/sofa/bench/right{
	dir = 4;
	color = "#76502e";
	name = "Lover's Watch"
	},
/obj/structure/railing/wooden_fencing,
/turf/open/floor/fake_snow/safe,
/area/misc/hilbertshotel/winterwoods)
"ZK" = (
/obj/effect/turf_decal/siding/wood{
	dir = 4
	},
/turf/open/floor/wood/tile,
/area/misc/hilbertshotel/winterwoods)

(1,1,1) = {"
rB
rB
rB
rB
rB
rB
rB
rB
rB
rB
rB
rB
rB
rB
rB
"}
(2,1,1) = {"
rB
rB
rB
yd
yd
rB
rB
gD
AG
Yk
AG
cI
AG
AG
rB
"}
(3,1,1) = {"
rB
rB
tT
yd
yf
yd
yd
fQ
Lw
de
ht
FP
fS
AG
rB
"}
(4,1,1) = {"
rB
yd
yd
yd
yd
yd
yf
Tt
AG
aL
aj
aj
pI
wK
rB
"}
(5,1,1) = {"
rB
yd
Cs
yd
lf
yd
EN
fQ
Dx
ua
ZK
ZK
HG
Nh
rB
"}
(6,1,1) = {"
rB
yd
yd
Mr
yd
yd
yf
fQ
AG
Jn
KZ
ET
AG
AG
rB
"}
(7,1,1) = {"
rB
Cs
Mr
OB
Mr
EN
Hg
by
ON
eh
Jv
yd
yd
yd
rB
"}
(8,1,1) = {"
rB
yd
es
Mr
yd
yf
No
Jv
AY
Jv
yd
yd
yd
Cs
rB
"}
(9,1,1) = {"
rB
yd
AY
EN
yd
yd
Jv
Jv
Jv
Jv
yd
Cs
EN
yd
rB
"}
(10,1,1) = {"
rB
yd
yf
yd
yf
yd
Cs
EN
yd
yf
uY
kv
YY
rB
rB
"}
(11,1,1) = {"
rB
AY
OH
yd
AY
yd
yd
yf
yd
Cs
cg
cg
Qb
CC
rB
"}
(12,1,1) = {"
rB
Cs
yd
yf
yd
yd
yf
yd
yd
EN
CC
CC
CC
CC
rB
"}
(13,1,1) = {"
rB
yd
AY
yd
AY
yd
Jv
yd
Cs
CC
CC
CC
CC
rB
rB
"}
(14,1,1) = {"
rB
yd
xR
EN
yd
Cs
yd
AY
EN
CC
CC
CC
CC
CC
rB
"}
(15,1,1) = {"
rB
yd
ET
yd
yd
yd
mU
yd
aI
wq
CC
CC
CC
rB
rB
"}
(16,1,1) = {"
rB
rB
rB
rB
rB
rB
rB
rB
rB
rB
rB
rB
rB
rB
rB
"}
