//MAP CONVERTED BY dmm2tgm.py THIS HEADER COMMENT PREVENTS RECONVERSION, DO NOT REMOVE
"a" = (
/turf/template_noop,
/area/template_noop)
"b" = (
/turf/template_noop,
/area/space)
"c" = (
/obj/effect/turf_decal/stripes/asteroid/line{
	dir = 5
	},
/turf/open/misc/asteroid/airless,
/area/space)
"d" = (
/obj/effect/turf_decal/stripes/asteroid/line{
	dir = 10
	},
/turf/open/misc/asteroid/airless,
/area/space)
"e" = (
/obj/effect/turf_decal/stripes/asteroid/line{
	dir = 4
	},
/turf/open/misc/asteroid/airless,
/area/space)
"f" = (
/obj/effect/turf_decal/sand/plating,
/obj/structure/table/reinforced,
/obj/item/flatpacked_machine/boulder_collector,
/turf/open/floor/plating/airless,
/area/space)
"i" = (
/obj/effect/turf_decal/sand/plating,
/turf/open/floor/plating/airless,
/area/space)
"m" = (
/obj/structure/ore_vent/ghost_mining/ras,
/turf/open/misc/asteroid/airless,
/area/space)
"p" = (
/turf/open/misc/asteroid/airless,
/area/space)
"q" = (
/obj/effect/turf_decal/sand/plating,
/obj/structure/table/reinforced,
/obj/item/t_scanner/adv_mining_scanner,
/turf/open/floor/plating/airless,
/area/space)
"r" = (
/mob/living/basic/trooper/pirate/ranged/space,
/turf/open/misc/asteroid/airless,
/area/space)
"s" = (
/obj/effect/turf_decal/stripes/asteroid/corner{
	dir = 4
	},
/turf/open/misc/asteroid/airless,
/area/space)
"t" = (
/obj/effect/turf_decal/stripes/asteroid/line,
/obj/effect/mob_spawn/corpse/human/engineer/mod,
/turf/open/misc/asteroid/airless,
/area/space)
"v" = (
/obj/effect/turf_decal/sand/plating,
/obj/structure/table/reinforced,
/turf/open/floor/plating/airless,
/area/space)
"y" = (
/obj/effect/turf_decal/stripes/asteroid/line{
	dir = 1
	},
/mob/living/basic/trooper/pirate/melee/space,
/turf/open/misc/asteroid/airless,
/area/space)
"z" = (
/obj/effect/turf_decal/sand/plating,
/obj/effect/turf_decal/stripes/asteroid/line,
/turf/open/misc/asteroid/airless,
/area/space)
"B" = (
/obj/effect/turf_decal/stripes/asteroid/line{
	dir = 4
	},
/mob/living/basic/trooper/pirate/ranged/space,
/turf/open/misc/asteroid/airless,
/area/space)
"C" = (
/obj/effect/turf_decal/stripes/asteroid/line,
/mob/living/basic/trooper/pirate/ranged/space,
/turf/open/misc/asteroid/airless,
/area/space)
"D" = (
/obj/effect/turf_decal/stripes/asteroid/line{
	dir = 8
	},
/turf/open/misc/asteroid/airless,
/area/space)
"F" = (
/obj/structure/lattice/catwalk,
/turf/template_noop,
/area/space)
"G" = (
/obj/effect/turf_decal/stripes/asteroid/line{
	dir = 9
	},
/turf/open/misc/asteroid/airless,
/area/space)
"H" = (
/obj/effect/turf_decal/stripes/asteroid/line{
	dir = 1
	},
/turf/open/misc/asteroid/airless,
/area/space)
"I" = (
/obj/effect/turf_decal/stripes/asteroid/line{
	dir = 4
	},
/obj/effect/mob_spawn/corpse/human/engineer/mod,
/turf/open/misc/asteroid/airless,
/area/space)
"J" = (
/obj/effect/turf_decal/stripes/asteroid/corner{
	dir = 1
	},
/turf/open/misc/asteroid/airless,
/area/space)
"O" = (
/obj/machinery/spaceship_navigation_beacon,
/obj/effect/turf_decal/sand/plating,
/turf/open/floor/plating/airless,
/area/space)
"R" = (
/obj/effect/turf_decal/stripes/asteroid/line{
	dir = 1
	},
/mob/living/basic/trooper/pirate/ranged/space,
/turf/open/misc/asteroid/airless,
/area/space)
"S" = (
/obj/effect/turf_decal/stripes/asteroid/line{
	dir = 8
	},
/obj/effect/mob_spawn/corpse/human/engineer/mod,
/turf/open/misc/asteroid/airless,
/area/space)
"U" = (
/mob/living/basic/trooper/pirate/melee/space,
/turf/open/misc/asteroid/airless,
/area/space)
"V" = (
/obj/effect/turf_decal/stripes/asteroid/line{
	dir = 6
	},
/turf/open/misc/asteroid/airless,
/area/space)
"Y" = (
/obj/structure/lattice,
/turf/template_noop,
/area/space)
"Z" = (
/obj/effect/turf_decal/stripes/asteroid/line,
/turf/open/misc/asteroid/airless,
/area/space)

(1,1,1) = {"
a
a
a
a
a
a
p
p
p
i
f
a
a
a
a
a
a
a
a
a
a
p
p
"}
(2,1,1) = {"
a
a
a
p
p
p
p
r
p
p
p
p
a
a
a
a
a
a
a
a
p
p
p
"}
(3,1,1) = {"
a
a
p
p
p
G
D
D
D
d
p
p
p
a
a
a
a
a
a
p
p
p
p
"}
(4,1,1) = {"
a
a
p
p
p
H
p
p
p
t
p
p
p
p
Y
Y
Y
Y
p
p
p
p
p
"}
(5,1,1) = {"
a
a
p
p
U
H
p
m
p
Z
D
D
D
D
F
F
F
D
D
d
p
p
p
"}
(6,1,1) = {"
a
a
a
p
p
H
p
p
p
Z
e
e
e
e
F
F
e
e
s
Z
r
p
p
"}
(7,1,1) = {"
a
a
a
p
p
c
e
e
B
V
p
p
p
Y
Y
Y
p
p
H
Z
p
p
a
"}
(8,1,1) = {"
a
a
a
a
p
p
H
Z
p
p
p
p
Y
b
b
i
p
p
H
Z
p
p
a
"}
(9,1,1) = {"
a
a
a
a
a
p
H
Z
p
p
p
b
Y
b
b
q
G
D
D
S
d
p
a
"}
(10,1,1) = {"
a
a
a
a
a
Y
F
F
Y
b
b
i
i
i
b
p
y
p
p
p
Z
p
a
"}
(11,1,1) = {"
a
a
a
a
a
Y
F
F
Y
Y
Y
i
O
i
Y
p
H
p
m
p
Z
p
a
"}
(12,1,1) = {"
a
a
v
v
i
Y
F
F
Y
b
b
i
i
i
b
p
H
p
p
p
Z
p
a
"}
(13,1,1) = {"
a
a
p
p
p
p
H
z
p
p
b
b
Y
b
b
p
c
e
e
e
V
a
a
"}
(14,1,1) = {"
a
p
p
p
p
p
H
z
p
p
p
b
Y
b
b
p
H
C
p
p
p
a
a
"}
(15,1,1) = {"
p
p
p
G
D
D
D
d
p
U
p
p
Y
b
b
p
H
Z
p
p
a
a
a
"}
(16,1,1) = {"
p
p
p
R
p
p
p
Z
p
p
p
p
p
Y
Y
p
H
Z
p
p
a
a
a
"}
(17,1,1) = {"
p
p
p
H
p
m
p
Z
D
D
D
D
D
F
F
D
J
Z
p
a
a
a
a
"}
(18,1,1) = {"
p
p
p
H
p
p
p
Z
e
e
e
e
e
F
F
e
e
V
a
a
a
a
a
"}
(19,1,1) = {"
p
p
p
c
e
e
I
V
r
p
p
p
p
Y
Y
p
p
a
a
a
a
a
a
"}
(20,1,1) = {"
p
p
p
p
p
p
p
p
p
p
p
p
a
a
a
a
a
a
a
a
a
a
a
"}
(21,1,1) = {"
a
p
p
p
p
p
p
p
p
p
p
a
a
a
a
a
a
a
a
a
a
a
a
"}
