//MAP CONVERTED BY dmm2tgm.py THIS HEADER COMMENT PREVENTS RECONVERSION, DO NOT REMOVE
"a" = (
/turf/closed/wall/r_wall,
/area/station/security/armory)
"f" = (
/obj/structure/cable,
/obj/machinery/button/door/directional/east{
	id = "armory";
	name = "Armory Shutters";
	req_access = list("armory")
	},
/obj/effect/turf_decal/siding/dark_red{
	dir = 8
	},
/obj/effect/decal/cleanable/dirt,
/turf/open/floor/iron/dark/small,
/area/station/security/armory)
"l" = (
/obj/effect/turf_decal/siding/dark_red,
/obj/item/stack/sheet/cardboard{
	pixel_x = -3;
	pixel_y = 8
	},
/obj/machinery/requests_console/directional/north{
	department = "Security";
	name = "Security Requests Console"
	},
/obj/effect/mapping_helpers/requests_console/supplies,
/obj/effect/mapping_helpers/requests_console/assistance,
/obj/effect/decal/cleanable/dirt,
/obj/item/ammo_box/c980grenade/riot{
	pixel_y = 9;
	pixel_x = -9
	},
/turf/open/floor/iron/dark/small,
/area/station/security/armory)
"m" = (
/obj/effect/turf_decal/tile/dark_red/opposingcorners,
/obj/effect/decal/cleanable/dirt,
/turf/open/floor/iron/dark,
/area/station/security/armory)
"o" = (
/obj/effect/turf_decal/siding/dark_red/corner{
	dir = 8
	},
/obj/effect/decal/cleanable/dirt,
/obj/machinery/camera/autoname/directional/north,
/turf/open/floor/iron/dark/small,
/area/station/security/armory)
"r" = (
/obj/effect/turf_decal/tile/dark_red/opposingcorners,
/turf/open/floor/iron/dark,
/area/station/security/armory)
"t" = (
/obj/effect/turf_decal/siding/dark_red,
/obj/machinery/light/small/directional/north,
/obj/item/storage/toolbox/guncase/skyrat/carwo_large_case/kiboko_magless{
	pixel_y = 8;
	pixel_x = -15
	},
/turf/open/floor/iron/dark/small,
/area/station/security/armory)
"v" = (
/obj/effect/turf_decal/siding/dark_red{
	dir = 4
	},
/obj/structure/rack,
/obj/machinery/airalarm/directional/west,
/obj/effect/spawner/armory_spawn/smg,
/turf/open/floor/iron/dark/small,
/area/station/security/armory)
"y" = (
/obj/structure/cable,
/obj/effect/turf_decal/siding/dark_red{
	dir = 1
	},
/obj/structure/table/reinforced,
/obj/machinery/recharger{
	pixel_x = -6;
	pixel_y = 2
	},
/obj/item/storage/box/teargas{
	pixel_x = 8;
	pixel_y = 6
	},
/obj/machinery/light/cold/directional/south,
/turf/open/floor/iron/dark/small,
/area/station/security/armory)
"z" = (
/obj/effect/turf_decal/siding/dark_red/corner{
	dir = 4
	},
/obj/structure/rack,
/obj/item/clothing/glasses/hud/security/sunglasses/gars{
	pixel_x = 3;
	pixel_y = -2
	},
/obj/item/clothing/glasses/hud/security/sunglasses{
	pixel_x = -3;
	pixel_y = -2
	},
/obj/item/clothing/glasses/hud/security/sunglasses{
	pixel_x = -3;
	pixel_y = 2
	},
/obj/effect/decal/cleanable/dirt,
/turf/open/floor/iron/dark/small,
/area/station/security/armory)
"A" = (
/obj/structure/cable,
/obj/effect/turf_decal/siding/dark_red{
	dir = 1
	},
/obj/effect/decal/cleanable/dirt,
/turf/open/floor/iron/dark/small,
/area/station/security/armory)
"B" = (
/obj/machinery/door/poddoor/shutters/window{
	dir = 4;
	id = "armory";
	name = "Armory Shutters"
	},
/turf/open/floor/iron/textured_half{
	dir = 8
	},
/area/station/security/armory)
"C" = (
/obj/machinery/atmospherics/pipe/smart/manifold4w/supply/hidden/layer4,
/obj/machinery/atmospherics/pipe/smart/manifold4w/scrubbers/hidden/layer2,
/obj/effect/turf_decal/tile/dark_red/opposingcorners,
/turf/open/floor/iron/dark,
/area/station/security/armory)
"E" = (
/obj/structure/cable,
/obj/effect/turf_decal/stripes/line{
	dir = 8
	},
/obj/machinery/power/apc/auto_name/directional/east,
/obj/structure/closet/crate{
	name = "Outdated Weaponry"
	},
/obj/effect/spawner/random/armory/barrier_grenades,
/obj/effect/spawner/armory_spawn/shotguns,
/turf/open/floor/plating,
/area/station/security/armory)
"G" = (
/obj/effect/turf_decal/tile/dark_red/opposingcorners,
/obj/machinery/holopad,
/obj/effect/decal/cleanable/dirt,
/turf/open/floor/iron/dark,
/area/station/security/armory)
"H" = (
/obj/structure/cable,
/obj/effect/turf_decal/siding/dark_red{
	dir = 8
	},
/turf/open/floor/iron/dark/small,
/area/station/security/armory)
"I" = (
/obj/effect/turf_decal/siding/dark_red{
	dir = 4
	},
/obj/structure/rack,
/obj/effect/spawner/random/armory/bulletproof_armor,
/obj/effect/spawner/random/armory/riot_armor,
/obj/effect/spawner/random/armory/riot_shield,
/turf/open/floor/iron/dark/small,
/area/station/security/armory)
"J" = (
/obj/effect/turf_decal/siding/dark_red{
	dir = 4
	},
/obj/structure/rack,
/obj/item/radio/intercom/directional/west,
/obj/effect/spawner/random/armory/disablers,
/turf/open/floor/iron/dark/small,
/area/station/security/armory)
"K" = (
/obj/structure/cable,
/obj/effect/turf_decal/siding/dark_red/corner{
	dir = 1
	},
/obj/structure/rack,
/obj/effect/spawner/random/armory/riot_helmet,
/obj/effect/spawner/random/armory/bulletproof_helmet,
/obj/item/gun/energy/e_gun/dragnet,
/turf/open/floor/iron/dark/small,
/area/station/security/armory)
"M" = (
/obj/structure/cable,
/obj/machinery/atmospherics/pipe/smart/manifold4w/supply/hidden/layer4,
/obj/machinery/atmospherics/pipe/smart/manifold4w/scrubbers/hidden/layer2,
/obj/effect/turf_decal/siding/dark_red{
	dir = 8
	},
/turf/open/floor/iron/dark/small,
/area/station/security/armory)
"N" = (
/obj/effect/turf_decal/siding/dark_red/corner,
/obj/structure/rack,
/obj/item/gun/energy/temperature/security,
/obj/item/gun/energy/ionrifle{
	pixel_y = 3
	},
/obj/item/clothing/suit/hooded/ablative,
/turf/open/floor/iron/dark/small,
/area/station/security/armory)
"Q" = (
/obj/effect/turf_decal/siding/dark_red{
	dir = 4
	},
/obj/structure/rack,
/obj/effect/spawner/random/armory/e_gun,
/turf/open/floor/iron/dark/small,
/area/station/security/armory)
"R" = (
/obj/structure/cable,
/obj/effect/turf_decal/siding/dark_red{
	dir = 8
	},
/obj/effect/decal/cleanable/dirt,
/turf/open/floor/iron/dark/small,
/area/station/security/armory)
"S" = (
/obj/machinery/atmospherics/pipe/smart/manifold4w/supply/hidden/layer4,
/obj/machinery/atmospherics/pipe/smart/manifold4w/scrubbers/hidden/layer2,
/obj/machinery/door/poddoor/shutters/window{
	dir = 4;
	id = "armory";
	name = "Armory Shutters"
	},
/turf/open/floor/iron/textured_half{
	dir = 8
	},
/area/station/security/armory)
"V" = (
/mob/living/simple_animal/bot/secbot/beepsky/armsky,
/obj/effect/turf_decal/tile/dark_red/opposingcorners,
/obj/effect/decal/cleanable/dirt,
/obj/machinery/atmospherics/components/unary/vent_pump/on/layer4{
	dir = 1
	},
/turf/open/floor/iron/dark,
/area/station/security/armory)
"W" = (
/obj/effect/turf_decal/stripes/line{
	dir = 8
	},
/obj/structure/closet/secure_closet{
	name = "contraband locker";
	req_access = list("armory")
	},
/obj/effect/spawner/random/maintenance/three,
/obj/effect/spawner/random/contraband/armory,
/obj/effect/decal/cleanable/dirt,
/obj/effect/decal/cleanable/cobweb/cobweb2,
/turf/open/floor/plating,
/area/station/security/armory)
"Y" = (
/obj/effect/turf_decal/tile/dark_red/opposingcorners,
/obj/effect/decal/cleanable/dirt,
/obj/machinery/atmospherics/components/unary/vent_scrubber/on/layer2,
/turf/open/floor/iron/dark,
/area/station/security/armory)

(1,1,1) = {"
a
a
a
a
a
a
a
"}
(2,1,1) = {"
a
N
Q
v
J
I
z
"}
(3,1,1) = {"
a
l
m
G
r
m
A
"}
(4,1,1) = {"
a
t
m
Y
C
V
y
"}
(5,1,1) = {"
a
o
R
f
M
H
K
"}
(6,1,1) = {"
a
W
E
a
S
B
a
"}
