//MAP CONVERTED BY dmm2tgm.py THIS HEADER COMMENT PREVENTS RECONVERSION, DO NOT REMOVE
"a" = (
/turf/template_noop,
/area/template_noop)
"d" = (
/obj/structure/rack/gunrack,
/obj/item/gun/energy/laser{
	pixel_x = 1;
	pixel_y = -5
	},
/obj/item/gun/energy/laser,
/obj/item/gun/energy/laser{
	pixel_y = 5
	},
/obj/item/gun/energy/laser/carbine,
/obj/effect/turf_decal/bot,
/obj/effect/spawner/armory_spawn/microfusion,
/turf/open/floor/iron/dark/textured_large,
/area/station/ai_monitored/security/armory)
"h" = (
/obj/item/gun/energy/e_gun/dragnet,
/obj/item/gun/energy/e_gun/dragnet,
/turf/template_noop,
/area/template_noop)
"j" = (
/obj/effect/turf_decal/bot,
/obj/structure/closet/secure_closet/armory_kiboko,
/turf/open/floor/iron/dark/textured_large,
/area/station/ai_monitored/security/armory)
"k" = (
/obj/effect/turf_decal/bot,
/obj/structure/secure_safe/directional/east,
/obj/machinery/camera/autoname/motion/directional/east,
/obj/machinery/ammo_workbench,
/turf/open/floor/iron/dark/textured_large,
/area/station/ai_monitored/security/armory)
"v" = (
/obj/item/storage/belt/sheath/sabre/cargo,
/obj/item/storage/belt/sheath/sabre/cargo{
	pixel_x = -7
	},
/turf/template_noop,
/area/template_noop)
"x" = (
/obj/structure/rack/gunrack,
/obj/effect/turf_decal/bot,
/obj/effect/spawner/armory_spawn/shotguns,
/turf/open/floor/iron/dark/textured_large,
/area/station/ai_monitored/security/armory)
"y" = (
/obj/structure/rack,
/obj/effect/turf_decal/bot/right,
/obj/machinery/airalarm/directional/north,
/obj/effect/spawner/random/armory/rubbershot,
/turf/open/floor/iron/dark/textured_large,
/area/station/ai_monitored/security/armory)
"z" = (
/obj/effect/turf_decal/bot,
/obj/item/radio/intercom/directional/east,
/obj/machinery/dish_drive/bullet,
/turf/open/floor/iron/dark/textured_large,
/area/station/ai_monitored/security/armory)
"N" = (
/obj/effect/turf_decal/bot,
/obj/structure/closet/secure_closet/armory2,
/turf/open/floor/iron/dark/textured_large,
/area/station/ai_monitored/security/armory)
"T" = (
/obj/effect/spawner/random/armory/barrier_grenades,
/turf/template_noop,
/area/template_noop)
"V" = (
/obj/item/storage/box/flashes{
	pixel_x = -2;
	pixel_y = -2
	},
/obj/item/storage/box/handcuffs,
/obj/item/vending_refill/security,
/turf/template_noop,
/area/template_noop)
"Z" = (
/obj/structure/table/reinforced,
/obj/effect/spawner/armory_spawn/smg,
/obj/structure/cable,
/obj/machinery/atmospherics/pipe/smart/manifold4w/scrubbers/hidden/layer2,
/turf/open/floor/iron/dark/textured_large,
/area/station/ai_monitored/security/armory)

(1,1,1) = {"
a
a
a
a
a
a
a
a
a
a
a
"}
(2,1,1) = {"
a
a
a
a
a
h
a
a
a
a
a
"}
(3,1,1) = {"
a
a
j
T
a
a
a
a
a
a
a
"}
(4,1,1) = {"
a
a
a
a
a
a
a
d
a
a
a
"}
(5,1,1) = {"
a
a
a
a
a
a
Z
a
a
a
a
"}
(6,1,1) = {"
a
a
a
a
a
a
a
x
a
a
a
"}
(7,1,1) = {"
a
a
N
V
a
y
a
a
a
a
a
"}
(8,1,1) = {"
a
a
a
a
a
v
a
a
a
a
a
"}
(9,1,1) = {"
a
a
a
a
a
a
a
k
z
a
a
"}
(10,1,1) = {"
a
a
a
a
a
a
a
a
a
a
a
"}
(11,1,1) = {"
a
a
a
a
a
a
a
a
a
a
a
"}
