//MAP CONVERTED BY dmm2tgm.py THIS HEADER COMMENT PREVENTS RECONVERSION, DO NOT REMOVE
"aF" = (
/obj/effect/turf_decal/siding/dark{
	dir = 4
	},
/obj/effect/turf_decal/trimline/dark/filled/line{
	dir = 4
	},
/turf/open/floor/iron/dark/small,
/area/station/service/theater)
"bu" = (
/turf/open/space/openspace,
/area/space)
"bZ" = (
/obj/effect/turf_decal/tile/neutral{
	dir = 4
	},
/obj/effect/turf_decal/tile/neutral{
	dir = 1
	},
/obj/machinery/light/warm/directional/north,
/turf/open/floor/iron/dark,
/area/station/hallway/secondary/dock)
"dS" = (
/obj/structure/window/reinforced/spawner/directional/north,
/turf/open/space/openspace,
/area/space/nearstation)
"eQ" = (
/obj/effect/turf_decal/trimline/yellow,
/obj/effect/turf_decal/trimline/yellow/corner{
	dir = 8
	},
/obj/effect/turf_decal/trimline/yellow/corner,
/obj/machinery/light/floor,
/obj/effect/turf_decal/siding/dark,
/turf/open/floor/iron/dark/small,
/area/station/service/theater)
"fv" = (
/turf/closed/wall,
/area/station/service/theater)
"gl" = (
/obj/effect/turf_decal/siding/wideplating_new/dark{
	dir = 8
	},
/obj/machinery/firealarm/directional/north,
/turf/open/floor/iron/dark/side{
	dir = 4
	},
/area/station/hallway/secondary/dock)
"iy" = (
/turf/open/floor/iron/dark,
/area/station/hallway/secondary/dock)
"iK" = (
/obj/machinery/atmospherics/components/unary/vent_pump/on/layer4,
/obj/structure/extinguisher_cabinet/directional/north,
/turf/open/floor/iron/dark,
/area/station/hallway/secondary/dock)
"iO" = (
/obj/effect/turf_decal/tile/neutral{
	dir = 4
	},
/obj/effect/turf_decal/tile/neutral{
	dir = 1
	},
/obj/machinery/door/firedoor,
/turf/open/floor/iron/dark,
/area/station/hallway/secondary/dock)
"kv" = (
/obj/effect/turf_decal/trimline/yellow,
/obj/effect/turf_decal/trimline/yellow/corner{
	dir = 4
	},
/obj/effect/turf_decal/trimline/yellow/corner,
/obj/machinery/light/floor,
/obj/effect/turf_decal/siding/dark{
	dir = 4
	},
/obj/structure/cable,
/obj/structure/disposalpipe/segment{
	dir = 4
	},
/turf/open/floor/iron/dark/small,
/area/station/service/theater)
"lw" = (
/obj/structure/window/reinforced/spawner/directional/south,
/obj/structure/lattice/catwalk,
/obj/structure/marker_beacon/cerulean,
/turf/open/space/openspace,
/area/space/nearstation)
"mD" = (
/obj/effect/turf_decal/trimline/yellow/corner{
	dir = 1
	},
/obj/effect/turf_decal/siding/dark/corner{
	dir = 1
	},
/obj/effect/turf_decal/siding/dark/corner,
/obj/effect/turf_decal/trimline/dark/filled/corner,
/obj/structure/disposalpipe/segment,
/turf/open/floor/iron/dark/small,
/area/station/service/theater)
"nr" = (
/obj/structure/window/reinforced/spawner/directional/north,
/obj/structure/lattice,
/turf/open/space/openspace,
/area/space/nearstation)
"ns" = (
/obj/structure/window/reinforced/spawner/directional/north,
/obj/effect/turf_decal/tile/neutral{
	dir = 4
	},
/obj/effect/turf_decal/tile/neutral{
	dir = 1
	},
/turf/open/floor/iron/dark,
/area/station/hallway/secondary/dock)
"nI" = (
/obj/effect/turf_decal/trimline/yellow/corner{
	dir = 4
	},
/obj/effect/turf_decal/siding/dark/corner{
	dir = 4
	},
/obj/effect/turf_decal/siding/dark/corner{
	dir = 8
	},
/obj/effect/turf_decal/trimline/dark/filled/corner{
	dir = 8
	},
/obj/structure/cable,
/turf/open/floor/iron/dark/small,
/area/station/service/theater)
"rS" = (
/obj/structure/window/reinforced/spawner/directional/south,
/obj/structure/lattice,
/turf/open/space/openspace,
/area/space/nearstation)
"ss" = (
/obj/effect/turf_decal/tile/neutral{
	dir = 8
	},
/obj/effect/turf_decal/tile/neutral,
/obj/machinery/light/warm/directional/south,
/turf/open/floor/iron/dark,
/area/station/hallway/secondary/dock)
"sM" = (
/turf/open/space/openspace,
/area/space/nearstation)
"ul" = (
/turf/closed/wall,
/area/station/hallway/secondary/dock)
"uv" = (
/obj/structure/cable,
/obj/structure/disposalpipe/segment{
	dir = 4
	},
/obj/machinery/atmospherics/pipe/smart/manifold4w/supply/hidden/layer4,
/obj/machinery/atmospherics/pipe/smart/manifold4w/scrubbers/hidden/layer2,
/turf/open/floor/iron/dark,
/area/station/hallway/secondary/dock)
"uB" = (
/obj/structure/cable,
/obj/effect/turf_decal/siding/wideplating_new/dark{
	dir = 8
	},
/obj/machinery/atmospherics/pipe/smart/manifold4w/supply/hidden/layer4,
/obj/machinery/atmospherics/pipe/smart/manifold4w/scrubbers/hidden/layer2,
/obj/structure/disposalpipe/segment{
	dir = 4
	},
/turf/open/floor/iron/dark/side{
	dir = 4
	},
/area/station/hallway/secondary/dock)
"vt" = (
/obj/effect/turf_decal/trimline/yellow,
/obj/effect/turf_decal/trimline/yellow/corner{
	dir = 4
	},
/obj/effect/turf_decal/trimline/yellow/corner{
	dir = 1
	},
/obj/machinery/light/floor,
/obj/effect/turf_decal/siding/dark{
	dir = 1
	},
/turf/open/floor/iron/dark/small,
/area/station/service/theater)
"vS" = (
/obj/docking_port/stationary{
	dheight = 3;
	dir = 8;
	dwidth = 8;
	height = 11;
	shuttle_id = "ferry_home";
	name = "Secondary Station Dock";
	width = 20
	},
/turf/open/space/openspace,
/area/space)
"xw" = (
/turf/template_noop,
/area/template_noop)
"xy" = (
/obj/effect/turf_decal/siding/dark{
	dir = 9
	},
/obj/effect/turf_decal/trimline/dark/filled/line{
	dir = 9
	},
/turf/open/floor/iron/dark/small,
/area/station/service/theater)
"ym" = (
/obj/effect/spawner/structure/window/reinforced,
/turf/open/floor/plating,
/area/station/hallway/secondary/dock)
"yI" = (
/obj/structure/cable,
/obj/effect/turf_decal/trimline/dark,
/obj/machinery/light/floor,
/obj/machinery/atmospherics/pipe/smart/manifold4w/supply/hidden/layer4,
/obj/machinery/atmospherics/pipe/smart/manifold4w/scrubbers/hidden/layer2,
/obj/structure/disposalpipe/junction{
	dir = 1
	},
/turf/open/floor/iron/dark/textured_large,
/area/station/hallway/secondary/dock)
"AM" = (
/obj/effect/turf_decal/siding/wideplating_new/dark{
	dir = 4
	},
/obj/effect/turf_decal/tile/neutral{
	dir = 1
	},
/obj/structure/cable,
/obj/machinery/power/apc/auto_name/directional/north,
/turf/open/floor/iron/dark/side{
	dir = 8
	},
/area/station/hallway/secondary/dock)
"Ei" = (
/obj/effect/turf_decal/siding/wideplating_new/dark{
	dir = 4
	},
/obj/effect/turf_decal/tile/neutral{
	dir = 8
	},
/obj/machinery/airalarm/directional/south,
/obj/machinery/camera/autoname/directional/south,
/turf/open/floor/iron/dark/side{
	dir = 8
	},
/area/station/hallway/secondary/dock)
"ET" = (
/obj/effect/turf_decal/siding/wideplating_new/dark{
	dir = 8
	},
/turf/open/floor/iron/dark/side{
	dir = 4
	},
/area/station/hallway/secondary/dock)
"Fj" = (
/obj/effect/turf_decal/siding/dark{
	dir = 10
	},
/obj/effect/turf_decal/trimline/dark/filled/line{
	dir = 10
	},
/obj/item/kirbyplants/organic/plant10,
/obj/structure/cable,
/turf/open/floor/iron/dark/small,
/area/station/service/theater)
"GH" = (
/obj/effect/turf_decal/stripes/line{
	dir = 8
	},
/turf/open/floor/iron/dark,
/area/station/hallway/secondary/dock)
"Hz" = (
/obj/structure/disposalpipe/segment{
	dir = 4
	},
/turf/open/floor/iron/dark/small,
/area/station/service/theater)
"Ia" = (
/obj/structure/cable,
/obj/machinery/atmospherics/pipe/smart/manifold4w/supply/hidden/layer4,
/obj/machinery/atmospherics/pipe/smart/manifold4w/scrubbers/hidden/layer2,
/obj/structure/disposalpipe/segment,
/obj/machinery/door/airlock/maintenance{
	name = "Theater Maintenance"
	},
/obj/effect/mapping_helpers/airlock/access/any/service/maintenance,
/obj/effect/mapping_helpers/airlock/unres,
/obj/machinery/door/firedoor,
/turf/open/floor/catwalk_floor/iron_dark,
/area/station/hallway/secondary/dock)
"IE" = (
/obj/effect/turf_decal/tile/neutral,
/obj/effect/turf_decal/tile/neutral{
	dir = 8
	},
/obj/machinery/door/firedoor,
/turf/open/floor/iron/dark,
/area/station/hallway/secondary/dock)
"Jn" = (
/obj/structure/cable,
/obj/machinery/atmospherics/pipe/smart/manifold4w/supply/hidden/layer4,
/obj/machinery/atmospherics/pipe/smart/manifold4w/scrubbers/hidden/layer2,
/obj/structure/disposalpipe/segment,
/obj/effect/mapping_helpers/airlock/access/any/service/maintenance,
/obj/machinery/door/airlock/maintenance{
	name = "Theater Maintenance"
	},
/obj/effect/mapping_helpers/airlock/unres{
	dir = 1
	},
/obj/machinery/door/firedoor,
/turf/open/floor/catwalk_floor/iron_dark,
/area/station/hallway/secondary/dock)
"Jp" = (
/obj/structure/window/reinforced/spawner/directional/north,
/obj/structure/lattice/catwalk,
/obj/structure/marker_beacon/cerulean,
/turf/open/space/openspace,
/area/space/nearstation)
"Ko" = (
/obj/machinery/atmospherics/components/unary/vent_scrubber/on/layer2{
	dir = 1
	},
/turf/open/floor/iron/dark,
/area/station/hallway/secondary/dock)
"Lv" = (
/obj/effect/turf_decal/siding/wideplating_new/dark{
	dir = 4
	},
/obj/structure/cable,
/turf/open/floor/iron/dark/side{
	dir = 8
	},
/area/station/hallway/secondary/dock)
"LP" = (
/obj/effect/turf_decal/trimline/dark/filled/corner,
/obj/effect/turf_decal/trimline/dark/filled/corner{
	dir = 8
	},
/obj/effect/turf_decal/siding/dark/corner,
/obj/effect/turf_decal/siding/dark/corner{
	dir = 8
	},
/obj/structure/cable,
/turf/open/floor/iron/dark/small,
/area/station/service/theater)
"MB" = (
/obj/effect/turf_decal/trimline/yellow/corner{
	dir = 8
	},
/obj/effect/turf_decal/siding/dark/corner{
	dir = 8
	},
/obj/effect/turf_decal/siding/dark/corner{
	dir = 4
	},
/obj/effect/turf_decal/trimline/dark/filled/corner{
	dir = 4
	},
/turf/open/floor/iron/dark/small,
/area/station/service/theater)
"Nj" = (
/obj/structure/cable,
/obj/effect/decal/cleanable/dirt/dust,
/obj/machinery/atmospherics/pipe/smart/manifold4w/supply/hidden/layer4,
/obj/machinery/atmospherics/pipe/smart/manifold4w/scrubbers/hidden/layer2,
/obj/structure/disposalpipe/segment,
/turf/open/floor/catwalk_floor/iron_dark,
/area/station/hallway/secondary/dock)
"NF" = (
/obj/structure/window/reinforced/spawner/directional/south,
/obj/effect/turf_decal/tile/neutral,
/obj/effect/turf_decal/tile/neutral{
	dir = 8
	},
/obj/effect/turf_decal/stripes/line{
	dir = 8
	},
/turf/open/floor/iron/dark,
/area/station/hallway/secondary/dock)
"OI" = (
/obj/structure/cable,
/obj/machinery/atmospherics/pipe/smart/manifold4w/supply/hidden/layer4,
/obj/machinery/atmospherics/pipe/smart/manifold4w/scrubbers/hidden/layer2,
/obj/structure/disposalpipe/segment,
/turf/open/floor/catwalk_floor/iron_dark,
/area/station/hallway/secondary/dock)
"OW" = (
/obj/structure/cable,
/obj/structure/disposalpipe/segment{
	dir = 4
	},
/obj/effect/turf_decal/siding/dark{
	dir = 8
	},
/obj/effect/turf_decal/trimline/dark/filled/line{
	dir = 8
	},
/turf/open/floor/iron/dark/small,
/area/station/service/theater)
"PI" = (
/obj/effect/turf_decal/stripes/line{
	dir = 8
	},
/obj/effect/turf_decal/stripes/line{
	dir = 4
	},
/obj/effect/mapping_helpers/airlock/cyclelink_helper_multi{
	cycle_id = "ert-lz-starboard"
	},
/obj/machinery/door/airlock/external/glass{
	name = "Secondary Station Dock"
	},
/turf/open/floor/iron/dark,
/area/station/hallway/secondary/dock)
"UH" = (
/obj/effect/turf_decal/siding/dark{
	dir = 5
	},
/obj/effect/turf_decal/trimline/dark/filled/line{
	dir = 5
	},
/turf/open/floor/iron/dark/small,
/area/station/service/theater)
"UO" = (
/obj/structure/closet/emcloset/wall,
/turf/closed/wall,
/area/station/hallway/secondary/dock)
"VM" = (
/obj/effect/turf_decal/trimline/yellow/corner,
/obj/effect/turf_decal/siding/dark/corner,
/obj/effect/turf_decal/siding/dark/corner{
	dir = 1
	},
/obj/effect/turf_decal/trimline/dark/filled/corner{
	dir = 1
	},
/turf/open/floor/iron/dark/small,
/area/station/service/theater)
"VN" = (
/obj/structure/window/reinforced/spawner/directional/south,
/obj/effect/turf_decal/tile/neutral,
/obj/effect/turf_decal/tile/neutral{
	dir = 8
	},
/turf/open/floor/iron/dark,
/area/station/hallway/secondary/dock)
"WM" = (
/obj/machinery/door/firedoor,
/turf/open/floor/iron/dark,
/area/station/hallway/secondary/dock)
"Xd" = (
/obj/structure/closet/firecloset/wall,
/turf/closed/wall,
/area/station/hallway/secondary/dock)
"Yj" = (
/obj/effect/turf_decal/siding/dark{
	dir = 6
	},
/obj/effect/turf_decal/trimline/dark/filled/line{
	dir = 6
	},
/obj/structure/extinguisher_cabinet/directional/south,
/turf/open/floor/iron/dark/small,
/area/station/service/theater)
"Yt" = (
/obj/effect/turf_decal/trimline/yellow,
/obj/effect/turf_decal/trimline/yellow/corner{
	dir = 8
	},
/obj/effect/turf_decal/trimline/yellow/corner{
	dir = 1
	},
/obj/machinery/light/floor,
/obj/effect/turf_decal/siding/dark{
	dir = 8
	},
/obj/structure/disposalpipe/segment{
	dir = 10
	},
/turf/open/floor/iron/dark/small,
/area/station/service/theater)
"YV" = (
/obj/effect/turf_decal/siding/dark{
	dir = 6
	},
/obj/effect/turf_decal/trimline/dark/filled/line{
	dir = 6
	},
/obj/machinery/disposal/bin,
/obj/structure/disposalpipe/trunk{
	dir = 1
	},
/turf/open/floor/iron/dark/small,
/area/station/service/theater)
"Zv" = (
/obj/effect/turf_decal/siding/dark{
	dir = 10
	},
/obj/effect/turf_decal/trimline/dark/filled/line{
	dir = 10
	},
/turf/open/floor/iron/dark/small,
/area/station/service/theater)

(1,1,1) = {"
bu
bu
bu
bu
vS
bu
bu
"}
(2,1,1) = {"
bu
sM
ym
PI
PI
dS
bu
"}
(3,1,1) = {"
bu
lw
ns
GH
NF
Jp
bu
"}
(4,1,1) = {"
bu
rS
ns
iy
VN
nr
bu
"}
(5,1,1) = {"
bu
rS
ym
PI
PI
nr
bu
"}
(6,1,1) = {"
bu
rS
ns
iy
VN
nr
bu
"}
(7,1,1) = {"
bu
rS
ns
iy
VN
nr
bu
"}
(8,1,1) = {"
xw
ul
iO
WM
IE
ul
bu
"}
(9,1,1) = {"
xw
Xd
bZ
iy
ss
UO
xw
"}
(10,1,1) = {"
xw
ul
AM
Lv
Ei
ul
xw
"}
(11,1,1) = {"
xw
Jn
OI
yI
Nj
Ia
xw
"}
(12,1,1) = {"
xw
ul
gl
uB
ET
ul
xw
"}
(13,1,1) = {"
xw
ul
iK
uv
Ko
ul
xw
"}
(14,1,1) = {"
xw
xw
xy
OW
Zv
fv
xw
"}
(15,1,1) = {"
xw
xw
VM
kv
nI
Fj
xw
"}
(16,1,1) = {"
xw
xw
eQ
Hz
vt
LP
xw
"}
(17,1,1) = {"
xw
xw
MB
Yt
mD
YV
xw
"}
(18,1,1) = {"
xw
xw
UH
aF
Yj
fv
xw
"}
(19,1,1) = {"
xw
xw
xw
xw
xw
xw
xw
"}
(20,1,1) = {"
xw
xw
xw
xw
xw
xw
xw
"}
