//MAP CONVERTED BY dmm2tgm.py THIS HEADER COMMENT PREVENTS RECONVERSION, DO NOT REMOVE
"a" = (
/turf/closed/wall,
/area/station/commons/locker)
"b" = (
/obj/machinery/cryopod,
/obj/effect/turf_decal/bot_blue,
/turf/open/floor/iron/dark/herringbone,
/area/station/commons/locker)
"d" = (
/obj/machinery/cryopod{
	dir = 1
	},
/obj/effect/turf_decal/bot_blue,
/turf/open/floor/iron/dark/herringbone,
/area/station/commons/locker)
"e" = (
/obj/effect/turf_decal/tile/neutral{
	dir = 1
	},
/obj/structure/hedge,
/obj/structure/railing{
	dir = 10
	},
/obj/effect/turf_decal/siding/thinplating_new/dark{
	dir = 8
	},
/turf/open/floor/iron/dark/side{
	dir = 4
	},
/area/station/commons/locker)
"h" = (
/obj/machinery/vending/clothing,
/obj/effect/turf_decal/bot_white,
/turf/open/floor/iron/dark/herringbone,
/area/station/commons/locker)
"i" = (
/obj/machinery/cryopod{
	dir = 1
	},
/obj/structure/sign/poster/timeclock_psa/directional/east,
/obj/effect/turf_decal/bot_blue,
/turf/open/floor/iron/dark/herringbone,
/area/station/commons/locker)
"j" = (
/obj/machinery/cryopod,
/obj/machinery/digital_clock/directional/north,
/obj/effect/turf_decal/bot_blue,
/turf/open/floor/iron/dark/herringbone,
/area/station/commons/locker)
"k" = (
/obj/effect/turf_decal/siding/thinplating_new/dark{
	dir = 1
	},
/obj/effect/turf_decal/siding/thinplating_new/dark/corner{
	dir = 8
	},
/turf/open/floor/iron/dark/side{
	dir = 5
	},
/area/station/commons/locker)
"l" = (
/obj/effect/turf_decal/siding/thinplating_new/dark{
	dir = 1
	},
/obj/effect/turf_decal/tile/neutral{
	dir = 1
	},
/obj/effect/turf_decal/siding/thinplating_new/dark,
/turf/open/floor/iron/dark/side,
/area/station/commons/locker)
"o" = (
/obj/effect/turf_decal/siding/thinplating_new/dark{
	dir = 1
	},
/obj/effect/turf_decal/siding/thinplating_new/dark/corner,
/obj/effect/turf_decal/tile/neutral/opposingcorners,
/turf/open/floor/iron/dark/corner{
	dir = 4
	},
/area/station/commons/locker)
"p" = (
/obj/effect/turf_decal/siding/thinplating_new/dark{
	dir = 8
	},
/obj/structure/hedge,
/obj/structure/railing{
	dir = 9
	},
/turf/open/floor/iron/dark,
/area/station/commons/locker)
"t" = (
/obj/effect/turf_decal/siding/thinplating_new/dark,
/obj/effect/turf_decal/siding/thinplating_new/dark/corner{
	dir = 1
	},
/obj/effect/turf_decal/tile/neutral{
	dir = 1
	},
/turf/open/floor/iron/dark/side{
	dir = 6
	},
/area/station/commons/locker)
"u" = (
/obj/effect/turf_decal/tile/neutral{
	dir = 1
	},
/obj/effect/turf_decal/siding/thinplating_new/dark,
/obj/effect/turf_decal/siding/thinplating_new/dark{
	dir = 1
	},
/turf/open/floor/iron/dark/side,
/area/station/commons/locker)
"y" = (
/obj/machinery/cryopod{
	dir = 1
	},
/obj/machinery/digital_clock/directional/south,
/obj/effect/turf_decal/bot_blue,
/turf/open/floor/iron/dark/herringbone,
/area/station/commons/locker)
"z" = (
/obj/effect/spawner/structure/window,
/turf/open/floor/plating,
/area/station/commons/locker)
"B" = (
/obj/structure/chair/sofa/bench/tram/right{
	dir = 8
	},
/obj/effect/turf_decal/siding/thinplating_new/dark{
	dir = 4
	},
/turf/open/floor/iron/dark,
/area/station/commons/locker)
"E" = (
/obj/effect/turf_decal/siding/thinplating_new/dark,
/obj/effect/turf_decal/siding/thinplating_new/dark{
	dir = 1
	},
/obj/effect/turf_decal/tile/neutral,
/turf/open/floor/iron/dark/side{
	dir = 1
	},
/area/station/commons/locker)
"F" = (
/obj/effect/turf_decal/siding/thinplating_new/dark{
	dir = 8
	},
/obj/effect/turf_decal/tile/neutral{
	dir = 1
	},
/turf/open/floor/iron/dark/side{
	dir = 4
	},
/area/station/commons/locker)
"G" = (
/obj/effect/turf_decal/siding/thinplating_new/dark{
	dir = 4
	},
/obj/structure/disposalpipe/segment{
	dir = 4
	},
/turf/open/floor/iron/dark/herringbone,
/area/station/commons/locker)
"J" = (
/obj/effect/turf_decal/delivery,
/obj/structure/disposalpipe/trunk{
	dir = 8
	},
/obj/machinery/disposal/bin/tagger,
/turf/open/floor/iron/dark/herringbone,
/area/station/commons/locker)
"N" = (
/obj/effect/turf_decal/siding/thinplating_new/dark{
	dir = 4
	},
/turf/open/floor/iron/dark/herringbone,
/area/station/commons/locker)
"O" = (
/obj/effect/turf_decal/bot_white,
/obj/machinery/vending/autodrobe,
/turf/open/floor/iron/dark/herringbone,
/area/station/commons/locker)
"Q" = (
/obj/structure/chair/sofa/bench/tram{
	dir = 8
	},
/obj/effect/turf_decal/siding/thinplating_new/dark{
	dir = 4
	},
/turf/open/floor/iron/dark,
/area/station/commons/locker)
"U" = (
/obj/machinery/computer/cryopod/directional/east,
/obj/effect/turf_decal/siding/thinplating_new/dark{
	dir = 6
	},
/obj/machinery/light/directional/east,
/turf/open/floor/iron/dark,
/area/station/commons/locker)
"V" = (
/obj/machinery/cryopod,
/obj/structure/sign/poster/timeclock_psa/directional/east,
/obj/effect/turf_decal/bot_blue,
/turf/open/floor/iron/dark/herringbone,
/area/station/commons/locker)
"W" = (
/obj/effect/turf_decal/siding/thinplating_new/dark{
	dir = 8
	},
/obj/effect/turf_decal/tile/neutral{
	dir = 1
	},
/obj/effect/landmark/navigate_destination/cryo_west,
/turf/open/floor/iron/dark/side{
	dir = 4
	},
/area/station/commons/locker)
"X" = (
/obj/structure/chair/sofa/bench/tram/left{
	dir = 8
	},
/obj/effect/turf_decal/siding/thinplating_new/dark{
	dir = 4
	},
/turf/open/floor/iron/dark,
/area/station/commons/locker)
"Y" = (
/obj/machinery/time_clock/directional/east,
/obj/effect/turf_decal/siding/thinplating_new/dark{
	dir = 5
	},
/obj/machinery/light/directional/east,
/turf/open/floor/iron/dark,
/area/station/commons/locker)

(1,1,1) = {"
z
e
o
N
G
N
u
p
a
"}
(2,1,1) = {"
a
b
E
h
J
O
l
d
a
"}
(3,1,1) = {"
a
j
k
F
W
F
t
y
a
"}
(4,1,1) = {"
a
V
Y
B
Q
X
U
i
a
"}
(5,1,1) = {"
a
a
a
z
z
z
a
a
a
"}
