//MAP CONVERTED BY dmm2tgm.py THIS HEADER COMMENT PREVENTS RECONVERSION, DO NOT REMOVE
"a" = (
/obj/structure/chair/office/tactical{
	dir = 4
	},
/obj/effect/landmark/start/nanotrasen_consultant,
/obj/effect/turf_decal/siding/wood/corner{
	dir = 4
	},
/turf/open/floor/carpet/green,
/area/station/command/heads_quarters/nt_rep)
"b" = (
/obj/structure/sign/calendar/directional/south,
/obj/machinery/light/warm/directional/south,
/obj/machinery/atmospherics/components/unary/vent_scrubber/on/layer2{
	dir = 1
	},
/turf/open/floor/wood,
/area/station/command/heads_quarters/nt_rep)
"c" = (
/obj/machinery/modular_computer/preset/command{
	dir = 1
	},
/obj/machinery/button/door/directional/south{
	pixel_x = -8;
	id = "nt_rep_priv";
	name = "Privacy Shutters"
	},
/turf/open/floor/carpet/green,
/area/station/command/heads_quarters/nt_rep)
"f" = (
/turf/open/floor/carpet/green,
/area/station/command/heads_quarters/nt_rep)
"g" = (
/turf/closed/wall,
/area/station/command/heads_quarters/nt_rep)
"h" = (
/obj/machinery/atmospherics/components/unary/vent_scrubber/on/layer2,
/obj/machinery/firealarm/directional/north,
/turf/open/floor/carpet/green,
/area/station/command/heads_quarters/nt_rep)
"i" = (
/obj/item/kirbyplants/random,
/obj/machinery/atmospherics/pipe/smart/manifold4w/supply/hidden/layer4,
/obj/machinery/atmospherics/pipe/smart/manifold4w/scrubbers/hidden/layer2,
/turf/open/floor/wood,
/area/station/command/heads_quarters/nt_rep)
"j" = (
/obj/machinery/atmospherics/pipe/smart/manifold4w/supply/hidden/layer4,
/obj/machinery/atmospherics/pipe/smart/manifold4w/scrubbers/hidden/layer2,
/turf/open/floor/carpet/green,
/area/station/command/heads_quarters/nt_rep)
"k" = (
/obj/effect/turf_decal/siding/wood{
	dir = 5
	},
/obj/machinery/atmospherics/pipe/smart/manifold4w/supply/hidden/layer4,
/obj/machinery/atmospherics/pipe/smart/manifold4w/scrubbers/hidden/layer2,
/turf/open/floor/carpet/green,
/area/station/command/heads_quarters/nt_rep)
"l" = (
/obj/structure/cable,
/obj/machinery/atmospherics/pipe/smart/manifold4w/supply/hidden/layer4,
/obj/machinery/atmospherics/pipe/smart/manifold4w/scrubbers/hidden/layer2,
/obj/structure/disposalpipe/segment,
/obj/effect/turf_decal/tile/neutral{
	dir = 8
	},
/turf/open/floor/iron,
/area/station/hallway/primary/central)
"n" = (
/obj/machinery/atmospherics/components/unary/vent_pump/on/layer4{
	dir = 8
	},
/turf/open/floor/carpet/green,
/area/station/command/heads_quarters/nt_rep)
"o" = (
/obj/machinery/door/poddoor/preopen{
	id = "nt_rep_priv";
	name = "Privacy Shutter"
	},
/obj/effect/spawner/structure/window/reinforced,
/obj/structure/cable,
/obj/machinery/door/poddoor/shutters/preopen{
	id = "nt_rep_priv"
	},
/turf/open/floor/plating,
/area/station/command/heads_quarters/nt_rep)
"p" = (
/obj/structure/chair/comfy/beige{
	dir = 8
	},
/obj/machinery/firealarm/directional/south,
/turf/open/floor/wood,
/area/station/command/heads_quarters/nt_rep)
"q" = (
/obj/structure/table/wood,
/obj/effect/turf_decal/siding/wood{
	dir = 5
	},
/turf/open/floor/carpet/green,
/area/station/command/heads_quarters/nt_rep)
"r" = (
/obj/machinery/status_display/evac/directional/west,
/obj/structure/cable,
/obj/machinery/atmospherics/pipe/smart/manifold4w/supply/hidden/layer4,
/obj/machinery/atmospherics/pipe/smart/manifold4w/scrubbers/hidden/layer2,
/obj/structure/disposalpipe/segment,
/turf/open/floor/iron,
/area/station/hallway/primary/central)
"t" = (
/obj/machinery/airalarm/directional/north,
/turf/open/floor/wood,
/area/station/command/heads_quarters/nt_rep)
"u" = (
/obj/machinery/door/airlock/maintenance,
/obj/effect/mapping_helpers/airlock/access/all/cent_com/rep_door,
/turf/open/floor/plating,
/area/station/command/heads_quarters/nt_rep)
"v" = (
/obj/machinery/modular_computer/preset/time_clock/directional/south,
/turf/template_noop,
/area/station/hallway/primary/central)
"w" = (
/obj/machinery/atmospherics/components/unary/vent_pump/on/layer4,
/turf/open/floor/wood,
/area/station/command/heads_quarters/nt_rep)
"x" = (
/obj/structure/table/wood,
/obj/item/paper_bin/carbon{
	pixel_y = 4;
	pixel_x = -4
	},
/obj/item/pen/fountain{
	pixel_x = -4;
	pixel_y = 6
	},
/obj/item/stamp/granted{
	pixel_x = 8;
	pixel_y = 8
	},
/obj/item/stamp/denied{
	pixel_x = 8
	},
/obj/item/radio/intercom/command/directional/south,
/obj/item/stamp/centcom{
	pixel_y = 10
	},
/turf/open/floor/carpet/green,
/area/station/command/heads_quarters/nt_rep)
"y" = (
/turf/template_noop,
/area/template_noop)
"z" = (
/obj/machinery/photocopier/prebuilt,
/turf/open/floor/wood,
/area/station/command/heads_quarters/nt_rep)
"A" = (
/obj/machinery/atmospherics/pipe/smart/manifold4w/supply/hidden/layer4,
/obj/machinery/atmospherics/pipe/smart/manifold4w/scrubbers/hidden/layer2,
/turf/open/floor/wood,
/area/station/command/heads_quarters/nt_rep)
"B" = (
/obj/effect/turf_decal/tile/neutral{
	dir = 8
	},
/obj/structure/cable,
/obj/machinery/atmospherics/pipe/smart/manifold4w/supply/hidden/layer4,
/obj/machinery/atmospherics/pipe/smart/manifold4w/scrubbers/hidden/layer2,
/obj/structure/disposalpipe/segment{
	dir = 5
	},
/turf/open/floor/iron,
/area/station/hallway/primary/central)
"C" = (
/obj/effect/turf_decal/siding/wood{
	dir = 1
	},
/obj/machinery/atmospherics/pipe/smart/manifold4w/supply/hidden/layer4,
/obj/machinery/atmospherics/pipe/smart/manifold4w/scrubbers/hidden/layer2,
/turf/open/floor/carpet/green,
/area/station/command/heads_quarters/nt_rep)
"D" = (
/turf/closed/wall/r_wall,
/area/station/command/heads_quarters/nt_rep)
"E" = (
/obj/structure/extinguisher_cabinet/directional/south,
/obj/machinery/power/apc/auto_name/directional/east,
/obj/structure/cable,
/turf/open/floor/wood,
/area/station/command/heads_quarters/nt_rep)
"F" = (
/obj/effect/turf_decal/siding/wood{
	dir = 1
	},
/obj/structure/filingcabinet/medical{
	pixel_x = -10
	},
/obj/structure/filingcabinet,
/obj/structure/filingcabinet/security{
	pixel_x = 10
	},
/obj/machinery/light_switch/directional/west,
/turf/open/floor/carpet/green,
/area/station/command/heads_quarters/nt_rep)
"G" = (
/obj/machinery/atmospherics/pipe/smart/manifold4w/supply/hidden/layer4,
/obj/machinery/atmospherics/pipe/smart/manifold4w/scrubbers/hidden/layer2,
/obj/structure/cable,
/obj/machinery/light_switch/directional/east,
/turf/open/floor/wood,
/area/station/command/heads_quarters/nt_rep)
"I" = (
/obj/structure/table/wood,
/turf/open/floor/carpet/green,
/area/station/command/heads_quarters/nt_rep)
"J" = (
/obj/structure/chair/comfy/beige{
	dir = 8
	},
/turf/open/floor/wood,
/area/station/command/heads_quarters/nt_rep)
"K" = (
/obj/machinery/door/firedoor,
/obj/structure/cable,
/obj/machinery/atmospherics/pipe/smart/manifold4w/scrubbers/hidden/layer2,
/obj/machinery/atmospherics/pipe/smart/manifold4w/supply/hidden/layer4,
/obj/machinery/door/airlock/corporate{
	name = "NT Consultant's Office"
	},
/obj/effect/mapping_helpers/airlock/access/all/cent_com/rep_door,
/obj/machinery/door/poddoor/shutters/preopen{
	id = "nt_rep_priv"
	},
/turf/open/floor/wood/large,
/area/station/command/heads_quarters/nt_rep)
"L" = (
/obj/machinery/vending/boozeomat,
/turf/open/floor/wood,
/area/station/command/heads_quarters/nt_rep)
"M" = (
/obj/machinery/holopad,
/obj/effect/turf_decal/bot,
/turf/open/floor/wood,
/area/station/command/heads_quarters/nt_rep)
"O" = (
/obj/structure/bed/double,
/obj/item/bedsheet/centcom/double,
/obj/machinery/light/small/blacklight/directional/east{
	desc = "A small lighting fixture. Why is this here?"
	},
/turf/open/floor/carpet/green,
/area/station/command/heads_quarters/nt_rep)
"P" = (
/obj/structure/filingcabinet/chestdrawer,
/obj/machinery/newscaster/directional/west,
/obj/machinery/light/small/blacklight/directional/north,
/turf/open/floor/carpet/green,
/area/station/command/heads_quarters/nt_rep)
"Q" = (
/obj/structure/table/wood,
/obj/machinery/fax{
	fax_name = "Nanotrasen Consultant's Office";
	name = "Nanotrasen Consultant's Fax Machine"
	},
/turf/open/floor/carpet/green,
/area/station/command/heads_quarters/nt_rep)
"S" = (
/turf/template_noop,
/area/station/hallway/primary/port)
"T" = (
/obj/structure/table/wood,
/obj/effect/turf_decal/siding/wood{
	dir = 4
	},
/obj/item/table_clock{
	pixel_y = 1
	},
/turf/open/floor/carpet/green,
/area/station/command/heads_quarters/nt_rep)
"U" = (
/obj/machinery/light_switch/directional/north,
/turf/open/floor/carpet/green,
/area/station/command/heads_quarters/nt_rep)
"V" = (
/turf/open/floor/wood,
/area/station/command/heads_quarters/nt_rep)
"W" = (
/obj/machinery/atmospherics/pipe/smart/manifold4w/supply/hidden/layer4,
/obj/machinery/atmospherics/pipe/smart/manifold4w/scrubbers/hidden/layer2,
/obj/structure/cable,
/turf/open/floor/wood,
/area/station/command/heads_quarters/nt_rep)
"X" = (
/obj/structure/closet/secure_closet/nanotrasen_consultant,
/turf/open/floor/carpet/green,
/area/station/command/heads_quarters/nt_rep)
"Y" = (
/obj/machinery/door/airlock/corporate{
	name = "NT Consultant's Office"
	},
/obj/machinery/door/firedoor,
/obj/effect/mapping_helpers/airlock/access/all/cent_com/rep_door,
/obj/effect/mapping_helpers/airlock/unres/delayed{
	dir = 1
	},
/obj/machinery/atmospherics/pipe/smart/manifold4w/supply/hidden/layer4,
/obj/machinery/atmospherics/pipe/smart/manifold4w/scrubbers/hidden/layer2,
/turf/open/floor/carpet/green,
/area/station/command/heads_quarters/nt_rep)
"Z" = (
/obj/machinery/light/warm/directional/north,
/obj/machinery/newscaster/directional/north,
/turf/open/floor/wood,
/area/station/command/heads_quarters/nt_rep)

(1,1,1) = {"
y
D
D
D
D
u
D
D
D
y
y
"}
(2,1,1) = {"
S
D
P
X
g
t
F
Q
D
D
y
"}
(3,1,1) = {"
S
D
h
j
Y
A
C
f
x
D
y
"}
(4,1,1) = {"
S
D
U
n
g
Z
k
a
c
D
y
"}
(5,1,1) = {"
S
D
I
O
g
w
A
q
T
D
y
"}
(6,1,1) = {"
S
D
D
D
D
L
A
J
p
D
D
"}
(7,1,1) = {"
y
r
l
B
o
o
A
M
V
z
D
"}
(8,1,1) = {"
y
y
y
y
y
o
i
A
b
D
D
"}
(9,1,1) = {"
y
y
y
y
y
o
o
W
E
D
y
"}
(10,1,1) = {"
y
y
y
y
y
y
K
G
D
D
y
"}
(11,1,1) = {"
y
y
y
y
y
v
D
D
D
y
y
"}
