//MAP CONVERTED BY dmm2tgm.py THIS HEADER COMMENT PREVENTS RECONVERSION, DO NOT REMOVE
"aX" = (
/obj/structure/disposalpipe/trunk{
	dir = 1
	},
/obj/machinery/disposal/bin,
/obj/effect/turf_decal/delivery,
/turf/open/floor/iron/dark/textured,
/area/station/commons/dock/aux)
"ba" = (
/obj/effect/turf_decal/bot_white,
/obj/effect/decal/cleanable/dirt,
/obj/machinery/power/port_gen/pacman/pre_loaded,
/obj/structure/railing,
/turf/open/floor/iron/dark/textured_large,
/area/station/maintenance/aft/lesser)
"bK" = (
/obj/structure/cable,
/obj/machinery/atmospherics/pipe/smart/manifold4w/scrubbers/hidden/layer2,
/obj/machinery/atmospherics/pipe/smart/manifold4w/supply/hidden/layer4,
/obj/structure/disposalpipe/segment{
	dir = 4
	},
/obj/machinery/holopad,
/obj/effect/turf_decal/bot,
/obj/effect/turf_decal/siding/thinplating_new/dark/corner{
	dir = 4
	},
/turf/open/floor/iron/dark/textured,
/area/station/commons/dock/aux)
"cK" = (
/obj/structure/flora/bush/sparsegrass/style_2,
/obj/structure/flora/bush/grassy/style_2,
/obj/structure/flora/bush/flowers_yw,
/obj/structure/flora/bush/sunny/style_random,
/obj/structure/flora/grass/jungle,
/obj/structure/flora/bush/flowers_pp,
/obj/structure/flora/bush/large{
	pixel_y = -4
	},
/obj/structure/marker_beacon/lime,
/turf/open/floor/grass,
/area/station/commons/dock/aux)
"cQ" = (
/obj/structure/window/reinforced/spawner/directional/west,
/obj/structure/lattice/catwalk,
/obj/structure/marker_beacon/cerulean,
/turf/open/space/basic,
/area/space/nearstation)
"dl" = (
/obj/structure/disposalpipe/segment,
/obj/effect/turf_decal/siding/thinplating_new/dark{
	dir = 9
	},
/obj/machinery/power/apc/auto_name/directional/west,
/obj/structure/cable,
/turf/open/floor/iron/dark/textured,
/area/station/commons/dock/aux)
"dQ" = (
/obj/structure/chair/sofa/bench/right{
	dir = 1
	},
/obj/effect/landmark/start/hangover,
/obj/effect/landmark/start/assistant,
/turf/open/floor/glass/reinforced,
/area/station/commons/dock/aux)
"fK" = (
/obj/structure/disposalpipe/segment,
/obj/effect/turf_decal/siding/thinplating_new/dark,
/turf/open/floor/iron/dark/textured,
/area/station/commons/dock/aux)
"gq" = (
/obj/effect/turf_decal/siding/thinplating_new/dark,
/obj/effect/landmark/navigate_destination/dockaux,
/turf/open/floor/iron/dark/textured,
/area/station/commons/dock/aux)
"gt" = (
/obj/structure/disposalpipe/segment{
	dir = 9
	},
/obj/machinery/atmospherics/pipe/smart/manifold4w/scrubbers/hidden/layer2,
/obj/machinery/atmospherics/pipe/smart/manifold4w/supply/hidden/layer4,
/obj/structure/cable,
/obj/effect/turf_decal/siding/thinplating_new/dark{
	dir = 5
	},
/obj/effect/landmark/start/assistant,
/turf/open/floor/iron/dark/textured,
/area/station/commons/dock/aux)
"gD" = (
/obj/structure/lattice/catwalk,
/obj/structure/marker_beacon/cerulean,
/turf/open/space/basic,
/area/space/nearstation)
"gS" = (
/obj/structure/window/reinforced/spawner/directional/east,
/obj/structure/window/reinforced/spawner/directional/west,
/obj/structure/flora/bush/sparsegrass/style_3,
/obj/structure/flora/bush/grassy/style_2,
/obj/structure/flora/bush/flowers_br/style_3,
/obj/structure/flora/bush/ferny/style_random,
/obj/structure/window/reinforced/spawner/directional/north,
/obj/structure/marker_beacon/lime,
/obj/structure/marker_beacon/lime,
/turf/open/floor/grass,
/area/station/commons/dock/aux)
"gY" = (
/obj/structure/window/reinforced/spawner/directional/west,
/obj/structure/lattice,
/turf/open/space/basic,
/area/space/nearstation)
"hC" = (
/obj/structure/toilet{
	dir = 8;
	pixel_x = 5
	},
/obj/machinery/light/small/dim/directional/north,
/obj/effect/decal/cleanable/dirt,
/obj/machinery/atmospherics/components/unary/vent_pump/on/layer4,
/obj/machinery/button/door/directional/north{
	normaldoorcontrol = 1;
	specialfunctions = 4;
	name = "Toilet Lock";
	id = "ToiletAux"
	},
/obj/effect/landmark/start/hangover,
/turf/open/floor/iron/showroomfloor,
/area/station/commons/dock/aux)
"hK" = (
/obj/effect/turf_decal/siding/thinplating_new/dark{
	dir = 4
	},
/obj/effect/turf_decal/trimline/dark_green/corner{
	dir = 4
	},
/obj/structure/sign/warning/vacuum/external/directional/east,
/obj/effect/turf_decal/stripes/corner,
/turf/open/floor/iron/dark/textured,
/area/station/commons/dock/aux)
"if" = (
/obj/machinery/digital_clock/directional/north,
/obj/structure/cable,
/obj/machinery/atmospherics/pipe/smart/manifold4w/scrubbers/hidden/layer2,
/obj/machinery/atmospherics/pipe/smart/manifold4w/supply/hidden/layer4,
/obj/structure/disposalpipe/junction/flip{
	dir = 8
	},
/obj/effect/turf_decal/siding/thinplating_new/dark{
	dir = 1
	},
/turf/open/floor/iron/dark/textured,
/area/station/commons/dock/aux)
"jm" = (
/obj/effect/turf_decal/siding/thinplating_new/dark,
/turf/open/floor/iron/dark/textured,
/area/station/commons/dock/aux)
"kc" = (
/obj/structure/cable,
/obj/effect/decal/cleanable/dirt,
/obj/structure/broken_flooring/singular/directional/east{
	color = "#73737a"
	},
/obj/machinery/light/small/directional/north,
/obj/machinery/atmospherics/pipe/smart/manifold4w/scrubbers/hidden/layer2,
/obj/machinery/atmospherics/pipe/smart/manifold4w/supply/hidden/layer4,
/obj/structure/disposalpipe/segment{
	dir = 6
	},
/turf/open/floor/plating,
/area/station/maintenance/aft/lesser)
"ke" = (
/obj/structure/cable,
/obj/effect/decal/cleanable/dirt,
/obj/effect/spawner/random/maintenance,
/obj/machinery/atmospherics/pipe/smart/manifold4w/scrubbers/hidden/layer2,
/obj/machinery/atmospherics/pipe/smart/manifold4w/supply/hidden/layer4,
/obj/structure/disposalpipe/segment{
	dir = 4
	},
/turf/open/floor/plating,
/area/station/maintenance/aft/lesser)
"kJ" = (
/turf/template_noop,
/area/template_noop)
"kU" = (
/obj/effect/turf_decal/siding/thinplating_new/dark,
/obj/effect/landmark/event_spawn,
/obj/effect/landmark/generic_maintenance_landmark,
/obj/effect/landmark/blobstart,
/turf/open/floor/iron/dark/textured,
/area/station/commons/dock/aux)
"li" = (
/obj/structure/lattice/catwalk,
/obj/structure/railing{
	dir = 1
	},
/obj/structure/marker_beacon/yellow,
/obj/structure/railing,
/turf/open/space/basic,
/area/space/nearstation)
"lr" = (
/turf/closed/wall,
/area/station/maintenance/aft/lesser)
"mD" = (
/obj/structure/cable,
/obj/structure/railing{
	dir = 8
	},
/obj/structure/railing{
	dir = 4
	},
/obj/machinery/atmospherics/pipe/smart/manifold4w/scrubbers/hidden/layer2,
/obj/machinery/atmospherics/pipe/smart/manifold4w/supply/hidden/layer4,
/obj/structure/disposalpipe/segment,
/turf/open/floor/iron/stairs/right{
	dir = 1;
	color = "#3d3e42"
	},
/area/station/maintenance/aft/lesser)
"mE" = (
/obj/structure/disposalpipe/junction/flip{
	dir = 2
	},
/obj/effect/turf_decal/siding/thinplating_new/dark{
	dir = 8
	},
/obj/machinery/status_display/evac/directional/west,
/obj/effect/spawner/random/engineering/tracking_beacon,
/turf/open/floor/iron/dark/textured,
/area/station/commons/dock/aux)
"nF" = (
/obj/structure/window/reinforced/spawner/directional/east,
/turf/open/floor/glass/reinforced,
/area/station/commons/dock/aux)
"pl" = (
/obj/structure/cable,
/obj/structure/broken_flooring/pile/directional/east{
	color = "#73737a"
	},
/obj/machinery/atmospherics/pipe/smart/manifold4w/scrubbers/hidden/layer2,
/obj/machinery/atmospherics/pipe/smart/manifold4w/supply/hidden/layer4,
/obj/structure/disposalpipe/segment{
	dir = 4
	},
/turf/open/floor/plating,
/area/station/maintenance/aft/lesser)
"ps" = (
/turf/closed/wall,
/area/station/commons/fitness/recreation)
"pE" = (
/obj/docking_port/stationary{
	dir = 2;
	dwidth = 11;
	height = 24;
	name = "Auxiliary Station Dock";
	shuttle_id = "whiteship_home";
	width = 35
	},
/turf/open/space/basic,
/area/space)
"pF" = (
/obj/structure/disposalpipe/segment,
/obj/machinery/door/airlock/public/glass{
	name = "Auxiliary Ship Dock"
	},
/obj/machinery/door/firedoor,
/turf/open/floor/iron/dark/textured,
/area/station/commons/fitness/recreation)
"sC" = (
/obj/structure/cable,
/obj/effect/mapping_helpers/broken_floor,
/obj/machinery/atmospherics/pipe/smart/manifold4w/scrubbers/hidden/layer2,
/obj/machinery/atmospherics/pipe/smart/manifold4w/supply/hidden/layer4,
/obj/structure/disposalpipe/segment{
	dir = 4
	},
/turf/open/floor/plating,
/area/station/maintenance/aft/lesser)
"sD" = (
/obj/structure/closet/emcloset/wall,
/turf/closed/wall,
/area/station/maintenance/aft/lesser)
"sW" = (
/obj/machinery/light/floor,
/obj/effect/turf_decal/box,
/turf/open/floor/plating,
/area/station/commons/dock/aux)
"tn" = (
/obj/effect/turf_decal/bot_white,
/obj/effect/decal/cleanable/dirt/dust,
/obj/effect/landmark/start/assistant,
/turf/open/floor/iron/dark/textured_large,
/area/station/maintenance/aft/lesser)
"tt" = (
/obj/structure/cable,
/obj/machinery/atmospherics/pipe/smart/manifold4w/scrubbers/hidden/layer2,
/obj/machinery/atmospherics/pipe/smart/manifold4w/supply/hidden/layer4,
/obj/structure/disposalpipe/segment{
	dir = 9
	},
/obj/effect/turf_decal/siding/thinplating_new/dark{
	dir = 8
	},
/turf/open/floor/iron/dark/textured,
/area/station/commons/dock/aux)
"uo" = (
/obj/effect/turf_decal/siding/thinplating_new/dark/corner{
	dir = 4
	},
/obj/effect/decal/cleanable/dirt,
/turf/open/floor/iron/dark/side{
	dir = 10
	},
/area/station/maintenance/aft/lesser)
"wn" = (
/obj/structure/closet/emcloset/wall,
/turf/closed/wall,
/area/station/commons/dock/aux)
"wJ" = (
/obj/machinery/atmospherics/pipe/smart/manifold4w/scrubbers/hidden/layer2,
/obj/machinery/atmospherics/pipe/smart/manifold4w/supply/hidden/layer4,
/obj/structure/cable,
/obj/effect/turf_decal/siding/thinplating_new/dark{
	dir = 4
	},
/obj/effect/turf_decal/trimline/dark_green/corner,
/turf/open/floor/iron/dark/textured,
/area/station/commons/dock/aux)
"wN" = (
/obj/structure/lattice/catwalk,
/obj/structure/window/reinforced/spawner/directional/east,
/obj/structure/marker_beacon/cerulean,
/turf/open/space/basic,
/area/space/nearstation)
"xf" = (
/obj/structure/closet/firecloset/wall,
/turf/closed/wall,
/area/station/commons/dock/aux)
"xr" = (
/obj/structure/cable,
/obj/structure/broken_flooring/singular/directional/east{
	color = "#73737a"
	},
/obj/machinery/atmospherics/pipe/smart/manifold4w/scrubbers/hidden/layer2,
/obj/machinery/atmospherics/pipe/smart/manifold4w/supply/hidden/layer4,
/obj/structure/disposalpipe/segment{
	dir = 4
	},
/obj/machinery/door/airlock/maintenance{
	name = "Laser Tag Maintenance"
	},
/obj/effect/mapping_helpers/airlock/access/all/engineering/maintenance,
/obj/machinery/door/firedoor,
/turf/open/floor/plating,
/area/station/commons/dock/aux)
"xs" = (
/turf/open/space/basic,
/area/space)
"xw" = (
/obj/structure/disposalpipe/segment,
/obj/effect/turf_decal/siding/thinplating_new/dark{
	dir = 8
	},
/obj/machinery/atmospherics/components/unary/vent_scrubber/on/layer2{
	dir = 4
	},
/obj/machinery/light/dim/directional/west,
/obj/machinery/firealarm/directional/west,
/turf/open/floor/iron/dark/textured,
/area/station/commons/dock/aux)
"xz" = (
/obj/structure/chair/sofa/bench/left{
	dir = 1
	},
/obj/effect/landmark/start/hangover,
/obj/effect/landmark/start/assistant,
/turf/open/floor/glass/reinforced,
/area/station/commons/dock/aux)
"yb" = (
/obj/structure/window/reinforced/spawner/directional/south,
/obj/structure/window/reinforced/spawner/directional/east,
/obj/structure/window/reinforced/spawner/directional/west,
/obj/structure/flora/bush/sparsegrass/style_3,
/obj/structure/flora/grass/jungle/a/style_3,
/obj/structure/flora/bush/flowers_br,
/obj/structure/flora/bush/ferny/style_random,
/obj/structure/marker_beacon/lime,
/turf/open/floor/grass,
/area/station/commons/dock/aux)
"yh" = (
/obj/structure/cable,
/obj/machinery/atmospherics/pipe/smart/manifold4w/scrubbers/hidden/layer2,
/obj/machinery/atmospherics/pipe/smart/manifold4w/supply/hidden/layer4,
/obj/structure/disposalpipe/segment{
	dir = 4
	},
/obj/effect/turf_decal/siding/thinplating_new/dark{
	dir = 1
	},
/obj/item/radio/intercom/directional/north,
/obj/machinery/camera/autoname/directional/north,
/turf/open/floor/iron/dark/textured,
/area/station/commons/dock/aux)
"yN" = (
/obj/structure/sign/poster/random/directional/north,
/obj/effect/turf_decal/siding/thinplating_new/dark/corner,
/obj/effect/decal/cleanable/dirt,
/obj/effect/turf_decal/trimline/dark/corner{
	dir = 4
	},
/obj/structure/flatpack_cart,
/turf/open/floor/iron/dark/side{
	dir = 9
	},
/area/station/maintenance/aft/lesser)
"zA" = (
/obj/structure/window/reinforced/spawner/directional/west,
/turf/open/floor/glass/reinforced,
/area/station/commons/dock/aux)
"Aj" = (
/obj/structure/cable,
/obj/machinery/atmospherics/pipe/smart/manifold4w/scrubbers/hidden/layer2,
/obj/machinery/atmospherics/pipe/smart/manifold4w/supply/hidden/layer4,
/obj/effect/turf_decal/siding/thinplating_new/dark{
	dir = 4
	},
/turf/open/floor/iron/dark/textured,
/area/station/commons/dock/aux)
"AG" = (
/obj/effect/turf_decal/stripes/line{
	dir = 10
	},
/turf/open/floor/iron/dark/textured,
/area/station/commons/dock/aux)
"Br" = (
/obj/effect/turf_decal/siding/thinplating_new/dark{
	dir = 6
	},
/obj/effect/landmark/start/assistant,
/turf/open/floor/iron/dark/textured,
/area/station/commons/dock/aux)
"Cn" = (
/obj/effect/turf_decal/stripes/line,
/obj/effect/turf_decal/stripes/line{
	dir = 6
	},
/turf/open/floor/iron/dark/textured,
/area/station/commons/dock/aux)
"Cy" = (
/obj/structure/cable,
/obj/machinery/atmospherics/pipe/smart/manifold4w/supply/hidden/layer4,
/obj/machinery/atmospherics/pipe/smart/manifold4w/scrubbers/hidden/layer2,
/obj/machinery/door/airlock/public/glass{
	name = "Auxiliary Ship Dock"
	},
/obj/machinery/door/firedoor,
/turf/open/floor/iron/dark/textured,
/area/station/commons/fitness/recreation)
"CC" = (
/obj/structure/disposalpipe/segment,
/obj/effect/turf_decal/siding/thinplating_new/dark{
	dir = 8
	},
/obj/structure/sign/poster/contraband/random/directional/west,
/turf/open/floor/iron/dark/textured,
/area/station/commons/dock/aux)
"DU" = (
/obj/machinery/atmospherics/pipe/smart/manifold4w/scrubbers/hidden/layer2,
/obj/machinery/atmospherics/pipe/smart/manifold4w/supply/hidden/layer4,
/obj/structure/cable,
/obj/effect/turf_decal/siding/thinplating_new/dark{
	dir = 5
	},
/obj/structure/sign/poster/contraband/random/directional/east,
/turf/open/floor/iron/dark/textured,
/area/station/commons/dock/aux)
"DX" = (
/obj/effect/turf_decal/bot_blue,
/obj/effect/spawner/random/structure/crate_loot,
/turf/open/floor/iron/dark/textured_large,
/area/station/maintenance/aft/lesser)
"DY" = (
/turf/closed/wall,
/area/station/commons/dock/aux)
"Eq" = (
/obj/structure/sign/nanotrasen,
/turf/closed/wall,
/area/station/commons/dock/aux)
"Et" = (
/obj/machinery/atmospherics/pipe/smart/manifold4w/scrubbers/hidden/layer2,
/obj/machinery/atmospherics/pipe/smart/manifold4w/supply/hidden/layer4,
/obj/structure/cable,
/obj/effect/turf_decal/siding/thinplating_new/dark{
	dir = 4
	},
/obj/effect/turf_decal/trimline/dark_green/corner{
	dir = 4
	},
/obj/effect/turf_decal/trimline/dark_green/corner,
/turf/open/floor/iron/dark/textured,
/area/station/commons/dock/aux)
"Iy" = (
/obj/machinery/door/airlock/external/glass{
	name = "Engineering External Access"
	},
/obj/effect/mapping_helpers/airlock/cyclelink_helper{
	dir = 4
	},
/obj/effect/mapping_helpers/airlock/access/all/engineering/general,
/turf/open/floor/plating,
/area/station/commons/dock/aux)
"Jy" = (
/obj/structure/cable,
/obj/machinery/atmospherics/pipe/smart/manifold4w/scrubbers/hidden/layer2,
/obj/machinery/atmospherics/pipe/smart/manifold4w/supply/hidden/layer4,
/obj/structure/disposalpipe/segment{
	dir = 4
	},
/obj/effect/turf_decal/siding/thinplating_new/dark{
	dir = 1
	},
/turf/open/floor/iron/dark/textured,
/area/station/commons/dock/aux)
"JA" = (
/obj/effect/turf_decal/bot_white,
/obj/effect/spawner/random/engineering/atmospherics_portable,
/obj/effect/decal/cleanable/dirt/dust,
/turf/open/floor/iron/dark/textured_large,
/area/station/maintenance/aft/lesser)
"Lv" = (
/obj/structure/sink/directional/west,
/obj/structure/mirror/directional/east,
/obj/effect/decal/cleanable/dirt,
/obj/machinery/atmospherics/pipe/smart/manifold4w/supply/hidden/layer4,
/obj/machinery/atmospherics/components/unary/vent_scrubber/on/layer2,
/obj/effect/landmark/start/assistant,
/obj/effect/mapping_helpers/broken_floor,
/turf/open/floor/iron/showroomfloor,
/area/station/commons/dock/aux)
"Qg" = (
/obj/structure/flora/bush/fullgrass,
/obj/structure/flora/bush/grassy/style_random,
/obj/structure/flora/bush/flowers_br/style_2,
/obj/structure/marker_beacon/lime,
/obj/machinery/computer/security/telescreen/entertainment/directional/north,
/obj/structure/railing{
	dir = 10
	},
/obj/machinery/camera/autoname/directional/north,
/turf/open/floor/grass,
/area/station/commons/dock/aux)
"Rn" = (
/obj/structure/window/reinforced/spawner/directional/east,
/obj/structure/lattice,
/turf/open/space/basic,
/area/space/nearstation)
"RI" = (
/obj/effect/turf_decal/siding/thinplating_new/dark{
	dir = 4
	},
/obj/effect/decal/cleanable/dirt/dust,
/obj/machinery/atmospherics/components/unary/vent_pump/on/layer4{
	dir = 4
	},
/turf/open/floor/iron/dark/side{
	dir = 8
	},
/area/station/maintenance/aft/lesser)
"SU" = (
/obj/machinery/door/airlock/external/glass{
	name = "Auxiliary Ship Dock"
	},
/obj/effect/mapping_helpers/airlock/cyclelink_helper_multi{
	cycle_id = "ferry_upper"
	},
/turf/open/floor/iron/dark/textured_large,
/area/station/commons/dock/aux)
"SY" = (
/obj/structure/disposalpipe/segment,
/obj/machinery/airalarm/directional/west,
/obj/effect/turf_decal/siding/thinplating_new/dark{
	dir = 8
	},
/obj/effect/landmark/event_spawn,
/obj/effect/landmark/generic_maintenance_landmark,
/turf/open/floor/iron/dark/textured,
/area/station/commons/dock/aux)
"Tq" = (
/obj/structure/cable,
/obj/machinery/door/airlock/maintenance{
	name = "Engineering Maintenance"
	},
/obj/machinery/atmospherics/pipe/smart/manifold4w/scrubbers/hidden/layer2,
/obj/machinery/atmospherics/pipe/smart/manifold4w/supply/hidden/layer4,
/obj/structure/disposalpipe/segment,
/obj/effect/mapping_helpers/airlock/access/all/engineering/maintenance,
/obj/machinery/door/firedoor,
/turf/open/floor/iron/dark/textured_large,
/area/station/maintenance/aft/lesser)
"TA" = (
/obj/machinery/door/airlock/silver{
	name = "Bathroom/Shower";
	id_tag = "ToiletAux"
	},
/obj/effect/decal/cleanable/dirt,
/obj/machinery/atmospherics/pipe/smart/manifold4w/supply/hidden/layer4,
/obj/machinery/atmospherics/pipe/smart/manifold4w/scrubbers/hidden/layer2,
/obj/machinery/door/firedoor,
/turf/open/floor/iron/showroomfloor,
/area/station/commons/dock/aux)
"TG" = (
/obj/effect/spawner/random/vending/snackvend,
/obj/effect/turf_decal/bot_white,
/turf/open/floor/iron/dark/textured,
/area/station/commons/dock/aux)
"Uq" = (
/obj/machinery/door/airlock/external/glass{
	name = "Engineering External Access"
	},
/obj/effect/mapping_helpers/airlock/cyclelink_helper{
	dir = 8
	},
/obj/effect/mapping_helpers/airlock/access/all/engineering/general,
/turf/open/floor/plating,
/area/station/commons/dock/aux)
"Uw" = (
/obj/structure/curtain,
/obj/machinery/shower/directional/south,
/obj/effect/decal/cleanable/dirt,
/obj/structure/drain,
/turf/open/floor/noslip/tram{
	name = "shower tile";
	color = "#6e9eb4"
	},
/area/station/commons/dock/aux)
"UI" = (
/obj/structure/lattice,
/turf/open/space/basic,
/area/space/nearstation)
"VS" = (
/turf/closed/wall/r_wall,
/area/station/maintenance/aft/lesser)
"Wa" = (
/obj/effect/spawner/random/vending/colavend,
/obj/effect/turf_decal/bot_white,
/obj/effect/decal/cleanable/dirt,
/obj/machinery/newscaster/directional/south,
/turf/open/floor/iron/dark/textured,
/area/station/commons/dock/aux)
"We" = (
/obj/effect/turf_decal/siding/thinplating_new/dark{
	dir = 8
	},
/obj/effect/turf_decal/stripes/corner{
	dir = 8
	},
/obj/effect/landmark/event_spawn,
/obj/effect/landmark/generic_maintenance_landmark,
/turf/open/floor/iron/dark/textured,
/area/station/commons/dock/aux)
"WA" = (
/obj/structure/cable,
/obj/machinery/atmospherics/pipe/smart/manifold4w/scrubbers/hidden/layer2,
/obj/machinery/atmospherics/pipe/smart/manifold4w/supply/hidden/layer4,
/obj/effect/turf_decal/siding/thinplating_new/dark/corner,
/turf/open/floor/iron/dark/textured,
/area/station/commons/dock/aux)
"Xw" = (
/obj/structure/disposalpipe/segment,
/obj/effect/turf_decal/siding/thinplating_new/dark{
	dir = 8
	},
/obj/machinery/atmospherics/components/unary/vent_pump/on/layer4{
	dir = 4
	},
/turf/open/floor/iron/dark/textured,
/area/station/commons/dock/aux)
"XV" = (
/obj/effect/spawner/structure/window/reinforced,
/turf/open/floor/plating,
/area/station/maintenance/aft/lesser)
"YK" = (
/obj/effect/spawner/structure/window/reinforced,
/turf/open/floor/plating,
/area/station/commons/dock/aux)
"YX" = (
/obj/structure/window/reinforced/spawner/directional/east,
/obj/structure/window/reinforced/spawner/directional/west,
/obj/structure/flora/bush/sparsegrass/style_3,
/obj/structure/flora/bush/grassy/style_2,
/obj/structure/flora/grass/jungle/a/style_3,
/obj/structure/flora/bush/flowers_br,
/obj/structure/marker_beacon/lime,
/turf/open/floor/grass,
/area/station/commons/dock/aux)
"ZQ" = (
/obj/structure/closet/firecloset/wall,
/turf/closed/wall,
/area/station/maintenance/aft/lesser)

(1,1,1) = {"
kJ
kJ
kJ
kJ
kJ
kJ
kJ
kJ
kJ
kJ
lr
xs
xs
xs
xs
"}
(2,1,1) = {"
kJ
kJ
kJ
kJ
kJ
kJ
kJ
kJ
kJ
kJ
lr
xs
xs
xs
xs
"}
(3,1,1) = {"
kJ
kJ
kJ
kJ
kJ
kJ
kJ
kJ
kJ
kJ
lr
xs
xs
xs
xs
"}
(4,1,1) = {"
kJ
kJ
kJ
kJ
kJ
kJ
kJ
kJ
kJ
kJ
lr
xs
xs
xs
xs
"}
(5,1,1) = {"
kJ
kJ
kJ
kJ
kJ
kJ
kJ
kJ
kJ
kJ
kJ
xs
xs
xs
xs
"}
(6,1,1) = {"
kJ
kJ
kJ
kJ
kJ
kJ
kJ
kJ
kJ
kJ
kJ
xs
xs
xs
xs
"}
(7,1,1) = {"
kJ
kJ
kJ
kJ
kJ
kJ
kJ
kJ
kJ
kJ
kJ
UI
gD
xs
xs
"}
(8,1,1) = {"
kJ
kJ
kJ
kJ
kJ
kJ
kJ
kJ
kJ
kJ
kJ
xs
xs
xs
xs
"}
(9,1,1) = {"
kJ
kJ
kJ
kJ
kJ
kJ
kJ
kJ
kJ
kJ
kJ
UI
UI
gD
xs
"}
(10,1,1) = {"
kJ
kJ
kJ
kJ
kJ
kJ
kJ
kJ
kJ
kJ
kJ
xs
xs
xs
xs
"}
(11,1,1) = {"
kJ
kJ
kJ
kJ
kJ
kJ
kJ
kJ
kJ
kJ
kJ
UI
gD
xs
xs
"}
(12,1,1) = {"
kJ
kJ
kJ
kJ
kJ
kJ
kJ
kJ
kJ
kJ
kJ
xs
xs
xs
xs
"}
(13,1,1) = {"
kJ
kJ
kJ
DY
DY
DY
Eq
xr
xf
wn
DY
Rn
Rn
wN
xs
"}
(14,1,1) = {"
pF
dl
CC
SY
mE
xw
Xw
tt
We
AG
SU
zA
zA
SU
pE
"}
(15,1,1) = {"
Cy
DU
Aj
Aj
bK
WA
wJ
Et
hK
Cn
SU
nF
nF
SU
xs
"}
(16,1,1) = {"
ps
DY
DY
Qg
Jy
kU
xz
cK
DY
Iy
DY
gY
gY
cQ
xs
"}
(17,1,1) = {"
DY
Uw
DY
DY
yh
gq
dQ
cK
DY
sW
DY
xs
xs
xs
xs
"}
(18,1,1) = {"
DY
hC
Lv
TA
Jy
jm
Wa
DY
DY
Uq
DY
xs
kJ
kJ
kJ
"}
(19,1,1) = {"
DY
DY
DY
DY
if
fK
aX
YK
UI
li
UI
xs
kJ
kJ
kJ
"}
(20,1,1) = {"
sD
kc
mD
Tq
gt
Br
TG
YK
kJ
kJ
kJ
kJ
kJ
kJ
kJ
"}
(21,1,1) = {"
ZQ
pl
DX
lr
gS
YX
yb
YK
kJ
kJ
kJ
kJ
kJ
kJ
kJ
"}
(22,1,1) = {"
lr
sC
lr
lr
ba
tn
JA
XV
kJ
li
kJ
kJ
kJ
kJ
kJ
"}
(23,1,1) = {"
lr
ke
lr
yN
RI
uo
lr
VS
kJ
kJ
kJ
kJ
kJ
kJ
kJ
"}
