//MAP CONVERTED BY dmm2tgm.py THIS HEADER COMMENT PREVENTS RECONVERSION, DO NOT REMOVE
"a" = (
/turf/template_noop,
/area/template_noop)
"b" = (
/obj/structure/curtain/cloth/fancy,
/obj/effect/turf_decal/siding/wood/end{
	dir = 4
	},
/turf/open/floor/wood/tile,
/area/station/service/barber)
"c" = (
/obj/effect/turf_decal/siding/wood{
	dir = 8
	},
/obj/effect/turf_decal/siding/wood/corner,
/obj/effect/turf_decal/siding/wood/corner{
	dir = 4
	},
/turf/open/floor/wood/tile,
/area/station/service/barber)
"d" = (
/obj/structure/table/wood/fancy/blue,
/obj/item/razor{
	pixel_x = -3
	},
/obj/item/dyespray{
	pixel_x = 5;
	pixel_y = 6
	},
/obj/machinery/status_display/ai/directional/south,
/obj/effect/turf_decal/siding/wood{
	dir = 10
	},
/turf/open/floor/wood/tile,
/area/station/service/barber)
"e" = (
/obj/machinery/door/airlock/multi_tile/public/glass{
	name = "Barber Shop"
	},
/obj/machinery/door/firedoor,
/obj/machinery/door/poddoor/shutters/preopen{
	name = "Barber Shop Shutters";
	id = "arrivalbarber"
	},
/obj/structure/cable,
/obj/machinery/atmospherics/pipe/smart/manifold4w/scrubbers/hidden/layer2,
/obj/machinery/atmospherics/pipe/smart/manifold4w/supply/hidden/layer4,
/turf/open/floor/iron/dark/herringbone,
/area/station/service/barber)
"f" = (
/obj/machinery/door/firedoor,
/obj/machinery/door/poddoor/shutters/preopen{
	name = "Barber Shop Shutters";
	id = "arrivalbarber"
	},
/turf/open/floor/iron/dark/herringbone,
/area/station/service/barber)
"i" = (
/obj/effect/turf_decal/siding/wood{
	dir = 4
	},
/obj/effect/turf_decal/siding/wood{
	dir = 8
	},
/turf/open/floor/wood/tile,
/area/station/service/barber)
"l" = (
/obj/structure/table/reinforced,
/obj/structure/desk_bell,
/obj/machinery/door/firedoor/border_only{
	dir = 1
	},
/obj/machinery/door/poddoor/shutters/preopen{
	name = "Barber Shop Shutters";
	id = "arrivalbarber"
	},
/turf/open/floor/wood/tile,
/area/station/service/barber)
"m" = (
/obj/effect/turf_decal/siding/wood,
/obj/structure/chair/office/light{
	dir = 1
	},
/turf/open/floor/wood/tile,
/area/station/service/barber)
"n" = (
/obj/machinery/holopad,
/obj/effect/turf_decal/siding/wood{
	dir = 1
	},
/turf/open/floor/wood/tile,
/area/station/service/barber)
"o" = (
/obj/structure/table/reinforced,
/obj/machinery/door/firedoor/border_only{
	dir = 1
	},
/obj/item/flashlight/lamp{
	pixel_y = 5
	},
/obj/effect/turf_decal/siding/wood{
	dir = 9
	},
/obj/machinery/door/poddoor/shutters/preopen{
	name = "Barber Shop Shutters";
	id = "arrivalbarber"
	},
/turf/open/floor/wood/tile,
/area/station/service/barber)
"p" = (
/obj/machinery/status_display/evac/directional/south,
/obj/effect/turf_decal/siding/wood{
	dir = 6
	},
/obj/structure/railing{
	dir = 4
	},
/obj/machinery/vending/barbervend,
/turf/open/floor/wood/tile,
/area/station/service/barber)
"q" = (
/obj/effect/turf_decal/siding/wood,
/obj/effect/turf_decal/siding/wood/corner{
	dir = 1
	},
/obj/structure/cable,
/obj/machinery/atmospherics/pipe/smart/manifold4w/scrubbers/hidden/layer2,
/obj/machinery/atmospherics/pipe/smart/manifold4w/supply/hidden/layer4,
/turf/open/floor/wood/tile,
/area/station/service/barber)
"r" = (
/obj/effect/landmark/start/barber,
/turf/open/floor/carpet/blue,
/area/station/service/barber)
"s" = (
/obj/effect/turf_decal/siding/wood{
	dir = 8
	},
/obj/structure/cable,
/obj/machinery/atmospherics/pipe/smart/manifold4w/scrubbers/hidden/layer2,
/obj/machinery/atmospherics/pipe/smart/manifold4w/supply/hidden/layer4,
/turf/open/floor/wood/tile,
/area/station/service/barber)
"t" = (
/obj/effect/turf_decal/siding/wood{
	dir = 1
	},
/turf/open/floor/wood/tile,
/area/station/service/barber)
"u" = (
/obj/structure/window/reinforced/spawner/directional/east,
/obj/structure/chair/sofa/bench/right{
	dir = 8
	},
/turf/open/floor/iron/dark/small,
/area/station/service/barber)
"v" = (
/turf/open/floor/carpet/blue,
/area/station/service/barber)
"w" = (
/obj/structure/table/reinforced,
/obj/effect/turf_decal/siding/wood/corner{
	dir = 8
	},
/obj/effect/turf_decal/siding/wood{
	dir = 5
	},
/obj/item/newspaper,
/obj/machinery/button/door/directional/east{
	id = "arrivalbarber";
	name = "Barber Shop Shutters Control"
	},
/obj/machinery/light/small/directional/north,
/turf/open/floor/wood/tile,
/area/station/service/barber)
"x" = (
/obj/structure/hedge,
/obj/structure/sign/poster/official/love_ian/directional/north,
/obj/effect/turf_decal/siding/wood,
/obj/effect/turf_decal/siding/wood{
	dir = 1
	},
/obj/structure/railing{
	dir = 4
	},
/obj/machinery/atmospherics/pipe/smart/manifold4w/scrubbers/hidden/layer2,
/turf/open/floor/wood/tile,
/area/station/service/barber)
"y" = (
/obj/effect/turf_decal/siding/wood,
/obj/effect/turf_decal/siding/wood/corner{
	dir = 4
	},
/turf/open/floor/wood/tile,
/area/station/service/barber)
"A" = (
/obj/effect/turf_decal/siding/wood{
	dir = 1
	},
/obj/effect/turf_decal/siding/wood/corner,
/obj/structure/railing{
	dir = 4
	},
/obj/structure/closet/secure_closet/barber,
/turf/open/floor/wood/tile,
/area/station/service/barber)
"B" = (
/turf/closed/wall,
/area/station/service/barber)
"C" = (
/obj/machinery/atmospherics/components/unary/vent_scrubber/on/layer2{
	dir = 1
	},
/obj/effect/landmark/event_spawn,
/turf/open/floor/carpet/blue,
/area/station/service/barber)
"F" = (
/obj/machinery/firealarm/directional/east,
/obj/effect/turf_decal/siding/wood{
	dir = 4
	},
/turf/open/floor/wood/tile,
/area/station/service/barber)
"G" = (
/obj/structure/chair/comfy,
/obj/structure/mirror/directional/south,
/obj/effect/turf_decal/siding/wood,
/turf/open/floor/wood/tile,
/area/station/service/barber)
"H" = (
/obj/structure/chair/sofa/corp/left{
	dir = 1
	},
/obj/effect/turf_decal/siding/wood{
	dir = 1
	},
/obj/effect/turf_decal/siding/wood,
/obj/structure/cable,
/obj/machinery/power/apc/auto_name/directional/south,
/obj/machinery/camera/autoname/directional/south,
/turf/open/floor/wood/tile,
/area/station/service/barber)
"I" = (
/obj/effect/turf_decal/siding/wood,
/obj/effect/turf_decal/siding/wood/corner{
	dir = 4
	},
/obj/structure/chair/office/light{
	dir = 1
	},
/obj/machinery/atmospherics/pipe/smart/manifold4w/scrubbers/hidden/layer2,
/turf/open/floor/wood/tile,
/area/station/service/barber)
"J" = (
/obj/structure/chair/stool/directional/south{
	pixel_y = 21
	},
/obj/machinery/digital_clock/directional/north{
	pixel_y = 34
	},
/obj/structure/mirror/directional/east,
/obj/machinery/light/small/dim/directional/south,
/turf/open/floor/carpet/red,
/area/station/service/barber)
"L" = (
/obj/structure/window/reinforced/spawner/directional/west,
/obj/structure/window/reinforced/spawner/directional/east,
/obj/structure/window/reinforced/spawner/directional/south,
/obj/structure/flora/grass/jungle/a/style_random,
/obj/structure/flora/bush/grassy/style_random,
/obj/structure/window/reinforced/spawner/directional/north,
/turf/open/floor/grass,
/area/station/service/barber)
"M" = (
/obj/effect/turf_decal/siding/wood/corner,
/obj/effect/turf_decal/siding/wood{
	dir = 8
	},
/turf/open/floor/wood/tile,
/area/station/service/barber)
"N" = (
/obj/structure/table/wood/fancy/blue,
/obj/item/razor{
	pixel_x = -3
	},
/obj/item/dyespray{
	pixel_x = 5;
	pixel_y = 6
	},
/obj/effect/turf_decal/siding/wood,
/obj/machinery/light/directional/south,
/obj/item/radio/intercom/directional/south,
/turf/open/floor/wood/tile,
/area/station/service/barber)
"O" = (
/obj/effect/turf_decal/siding/wood/corner{
	dir = 4
	},
/obj/effect/turf_decal/siding/wood{
	dir = 8
	},
/turf/open/floor/wood/tile,
/area/station/service/barber)
"R" = (
/obj/machinery/atmospherics/components/unary/vent_pump/on/layer4{
	dir = 1
	},
/obj/structure/cable,
/turf/open/floor/carpet/blue,
/area/station/service/barber)
"S" = (
/obj/structure/chair/sofa/corp/right{
	dir = 1
	},
/obj/effect/turf_decal/siding/wood/corner{
	dir = 1
	},
/obj/effect/turf_decal/siding/wood{
	dir = 6
	},
/obj/machinery/light_switch/directional/east,
/obj/machinery/airalarm/directional/south,
/turf/open/floor/wood/tile,
/area/station/service/barber)
"T" = (
/obj/effect/turf_decal/siding/wood,
/obj/machinery/atmospherics/pipe/smart/manifold4w/scrubbers/hidden/layer2,
/turf/open/floor/wood/tile,
/area/station/service/barber)
"U" = (
/obj/structure/window/reinforced/spawner/directional/east,
/obj/structure/chair/sofa/bench/left{
	dir = 8
	},
/obj/effect/landmark/start/hangover,
/turf/open/floor/iron/dark/small,
/area/station/service/barber)
"V" = (
/obj/structure/table/reinforced,
/obj/machinery/door/firedoor/border_only{
	dir = 1
	},
/obj/item/paper_bin{
	pixel_x = 4;
	pixel_y = 4
	},
/obj/effect/turf_decal/siding/wood{
	dir = 6
	},
/obj/machinery/door/poddoor/shutters/preopen{
	name = "Barber Shop Shutters";
	id = "arrivalbarber"
	},
/turf/open/floor/wood/tile,
/area/station/service/barber)
"W" = (
/obj/structure/chair/sofa/corp{
	dir = 1
	},
/obj/machinery/newscaster/directional/south,
/obj/effect/turf_decal/siding/wood{
	dir = 1
	},
/obj/effect/turf_decal/siding/wood,
/turf/open/floor/wood/tile,
/area/station/service/barber)
"X" = (
/obj/structure/window/reinforced/spawner/directional/west,
/obj/structure/window/reinforced/spawner/directional/east,
/obj/structure/window/reinforced/spawner/directional/north,
/obj/structure/flora/grass/jungle/a/style_random,
/obj/structure/flora/bush/sparsegrass/style_random,
/obj/structure/flora/bush/generic/style_random,
/obj/structure/window/reinforced/spawner/directional/south,
/obj/structure/flora/bush/flowers_pp/style_random,
/obj/structure/flora/bush/flowers_yw/style_random,
/turf/open/floor/grass,
/area/station/service/barber)
"Y" = (
/obj/structure/table/reinforced,
/obj/machinery/door/poddoor/shutters/preopen{
	name = "Barber Shop Shutters";
	id = "arrivalbarber"
	},
/obj/machinery/door/firedoor/border_only{
	dir = 1
	},
/turf/open/floor/wood/tile,
/area/station/service/barber)

(1,1,1) = {"
a
B
X
u
U
L
B
"}
(2,1,1) = {"
a
o
M
i
O
d
B
"}
(3,1,1) = {"
a
l
m
r
t
G
B
"}
(4,1,1) = {"
a
Y
T
C
n
N
B
"}
(5,1,1) = {"
a
V
I
r
t
G
B
"}
(6,1,1) = {"
B
B
x
v
A
p
B
"}
(7,1,1) = {"
e
s
q
R
H
B
B
"}
(8,1,1) = {"
f
F
y
v
W
B
a
"}
(9,1,1) = {"
B
B
w
c
S
B
a
"}
(10,1,1) = {"
a
B
B
b
B
B
a
"}
(11,1,1) = {"
a
a
B
J
B
a
a
"}
