//MAP CONVERTED BY dmm2tgm.py THIS HEADER COMMENT PREVENTS RECONVERSION, DO NOT REMOVE
"a" = (
/turf/template_noop,
/area/template_noop)
"b" = (
/obj/structure/flora/bush/fullgrass,
/obj/structure/flora/bush/large{
	pixel_y = -2
	},
/turf/open/floor/grass,
/area/station/service/library/upper)
"c" = (
/obj/effect/turf_decal/siding/thinplating_new/dark{
	dir = 4
	},
/obj/structure/disposalpipe/segment{
	dir = 4
	},
/turf/open/floor/iron/dark/herringbone,
/area/station/commons/locker)
"d" = (
/obj/machinery/vending/clothing,
/obj/effect/turf_decal/bot_white,
/turf/open/floor/iron/dark/herringbone,
/area/station/commons/locker)
"e" = (
/obj/effect/spawner/structure/window,
/turf/open/floor/plating,
/area/station/commons/locker)
"f" = (
/obj/structure/chair/sofa/bench/tram{
	dir = 8
	},
/obj/effect/turf_decal/siding/thinplating_new/dark{
	dir = 4
	},
/turf/open/floor/iron/dark,
/area/station/commons/locker)
"h" = (
/obj/structure/flora/bush/grassy/style_random,
/obj/structure/flora/bush/fullgrass,
/turf/open/floor/grass,
/area/station/service/library/upper)
"i" = (
/obj/structure/flora/bush/grassy/style_random,
/obj/structure/flora/bush/flowers_br/style_2,
/turf/open/floor/grass,
/area/station/service/library/upper)
"j" = (
/obj/machinery/cryopod,
/obj/machinery/digital_clock/directional/north,
/obj/effect/turf_decal/bot_blue,
/turf/open/floor/iron/dark/herringbone,
/area/station/commons/locker)
"k" = (
/obj/effect/turf_decal/siding/thinplating_new/dark{
	dir = 8
	},
/obj/effect/turf_decal/tile/neutral{
	dir = 1
	},
/obj/effect/landmark/navigate_destination/cryo_west,
/turf/open/floor/iron/dark/side{
	dir = 4
	},
/area/station/commons/locker)
"l" = (
/obj/structure/chair/sofa/bench/tram/left{
	dir = 8
	},
/obj/effect/turf_decal/siding/thinplating_new/dark{
	dir = 4
	},
/turf/open/floor/iron/dark,
/area/station/commons/locker)
"n" = (
/obj/structure/flora/bush/fullgrass,
/obj/structure/flora/bush/grassy/style_random,
/obj/structure/flora/bush/lavendergrass/style_random,
/turf/open/floor/grass,
/area/station/service/library/upper)
"o" = (
/obj/structure/flora/bush/fullgrass,
/obj/structure/flora/bush/lavendergrass/style_random,
/obj/structure/flora/bush/flowers_br/style_2,
/turf/open/floor/grass,
/area/station/service/library/upper)
"q" = (
/obj/machinery/cryopod,
/obj/structure/sign/poster/timeclock_psa/directional/east,
/obj/effect/turf_decal/bot_blue,
/obj/machinery/status_display/evac/directional/north,
/turf/open/floor/iron/dark/herringbone,
/area/station/commons/locker)
"s" = (
/obj/machinery/camera/autoname/directional/west,
/turf/template_noop,
/area/template_noop)
"u" = (
/obj/machinery/computer/cryopod/directional/east,
/obj/effect/turf_decal/siding/thinplating_new/dark{
	dir = 6
	},
/obj/machinery/light/cold/directional/east,
/turf/open/floor/iron/dark,
/area/station/commons/locker)
"v" = (
/obj/machinery/time_clock/directional/east,
/obj/effect/turf_decal/siding/thinplating_new/dark{
	dir = 5
	},
/obj/machinery/light/cold/directional/east,
/turf/open/floor/iron/dark,
/area/station/commons/locker)
"x" = (
/obj/effect/turf_decal/siding/thinplating_new/dark{
	dir = 4
	},
/turf/open/floor/iron/dark/herringbone,
/area/station/commons/locker)
"y" = (
/obj/effect/turf_decal/tile/neutral{
	dir = 1
	},
/obj/structure/hedge,
/obj/structure/railing{
	dir = 10
	},
/obj/effect/turf_decal/siding/thinplating_new/dark{
	dir = 8
	},
/turf/open/floor/iron/dark/side{
	dir = 4
	},
/area/station/commons/locker)
"z" = (
/obj/effect/turf_decal/siding/thinplating_new/dark{
	dir = 1
	},
/obj/effect/turf_decal/siding/thinplating_new/dark/corner{
	dir = 8
	},
/turf/open/floor/iron/dark/side{
	dir = 5
	},
/area/station/commons/locker)
"A" = (
/obj/effect/turf_decal/siding/thinplating_new/dark{
	dir = 1
	},
/obj/effect/turf_decal/siding/thinplating_new/dark/corner,
/obj/effect/turf_decal/tile/neutral/opposingcorners,
/turf/open/floor/iron/dark/corner{
	dir = 4
	},
/area/station/commons/locker)
"B" = (
/obj/machinery/vending/dorms,
/obj/effect/turf_decal/bot_white,
/obj/item/radio/intercom/directional/south,
/turf/open/floor/iron/dark/herringbone,
/area/station/commons/locker)
"C" = (
/obj/effect/turf_decal/siding/thinplating_new/dark,
/obj/effect/turf_decal/siding/thinplating_new/dark/corner{
	dir = 1
	},
/obj/effect/turf_decal/tile/neutral{
	dir = 1
	},
/turf/open/floor/iron/dark/side{
	dir = 6
	},
/area/station/commons/locker)
"D" = (
/obj/effect/turf_decal/delivery,
/obj/structure/disposalpipe/trunk{
	dir = 8
	},
/obj/machinery/disposal/bin/tagger,
/turf/open/floor/iron/dark/herringbone,
/area/station/commons/locker)
"F" = (
/obj/effect/turf_decal/bot_white,
/obj/machinery/vending/autodrobe,
/turf/open/floor/iron/dark/herringbone,
/area/station/commons/locker)
"G" = (
/obj/machinery/cryopod,
/obj/effect/turf_decal/bot_blue,
/turf/open/floor/iron/dark/herringbone,
/area/station/commons/locker)
"H" = (
/obj/machinery/cryopod{
	dir = 1
	},
/obj/effect/turf_decal/bot_blue,
/obj/machinery/newscaster/directional/south,
/turf/open/floor/iron/dark/herringbone,
/area/station/commons/locker)
"I" = (
/obj/structure/flora/bush/fullgrass,
/obj/structure/flora/bush/grassy/style_random,
/obj/structure/flora/bush/flowers_yw,
/obj/structure/flora/bush/flowers_br/style_2,
/turf/open/floor/grass,
/area/station/service/library/upper)
"J" = (
/obj/structure/flora/bush/fullgrass,
/obj/structure/flora/bush/lavendergrass/style_random,
/obj/structure/flora/bush/flowers_br/style_2,
/obj/machinery/camera/autoname/directional/west,
/turf/open/floor/grass,
/area/station/service/library/upper)
"K" = (
/obj/effect/spawner/structure/window/reinforced/tinted,
/turf/open/floor/plating,
/area/station/commons/locker)
"M" = (
/turf/closed/wall,
/area/station/commons/locker)
"N" = (
/obj/effect/turf_decal/tile/neutral{
	dir = 1
	},
/obj/effect/turf_decal/siding/thinplating_new/dark,
/obj/effect/turf_decal/siding/thinplating_new/dark{
	dir = 1
	},
/turf/open/floor/iron/dark/side,
/area/station/commons/locker)
"O" = (
/obj/structure/chair/sofa/bench/tram/right{
	dir = 8
	},
/obj/effect/turf_decal/siding/thinplating_new/dark{
	dir = 4
	},
/turf/open/floor/iron/dark,
/area/station/commons/locker)
"R" = (
/obj/structure/flora/bush/fullgrass,
/obj/structure/flora/bush/grassy/style_random,
/obj/structure/flora/bush/lavendergrass/style_random,
/obj/structure/flora/bush/flowers_yw,
/turf/open/floor/grass,
/area/station/service/library/upper)
"T" = (
/obj/effect/turf_decal/siding/thinplating_new/dark{
	dir = 8
	},
/obj/effect/turf_decal/tile/neutral{
	dir = 1
	},
/turf/open/floor/iron/dark/side{
	dir = 4
	},
/area/station/commons/locker)
"U" = (
/obj/effect/turf_decal/siding/thinplating_new/dark{
	dir = 1
	},
/obj/effect/turf_decal/tile/neutral{
	dir = 1
	},
/obj/effect/turf_decal/siding/thinplating_new/dark,
/turf/open/floor/iron/dark/side,
/area/station/commons/locker)
"V" = (
/obj/effect/turf_decal/siding/thinplating_new/dark,
/obj/effect/turf_decal/siding/thinplating_new/dark{
	dir = 1
	},
/obj/effect/turf_decal/tile/neutral,
/turf/open/floor/iron/dark/side{
	dir = 1
	},
/area/station/commons/locker)
"Y" = (
/obj/machinery/cryopod{
	dir = 1
	},
/obj/effect/turf_decal/bot_blue,
/obj/structure/extinguisher_cabinet/directional/south,
/turf/open/floor/iron/dark/herringbone,
/area/station/commons/locker)
"Z" = (
/obj/machinery/cryopod{
	dir = 1
	},
/obj/structure/sign/poster/timeclock_psa/directional/east,
/obj/effect/turf_decal/bot_blue,
/obj/machinery/firealarm/directional/south,
/turf/open/floor/iron/dark/herringbone,
/area/station/commons/locker)

(1,1,1) = {"
e
y
A
x
c
x
N
B
M
"}
(2,1,1) = {"
M
G
V
d
D
F
U
H
M
"}
(3,1,1) = {"
M
j
z
T
k
T
C
Y
M
"}
(4,1,1) = {"
M
q
v
O
f
l
u
Z
M
"}
(5,1,1) = {"
M
M
M
K
K
K
M
M
M
"}

(1,1,2) = {"
a
a
a
a
a
a
a
a
a
"}
(2,1,2) = {"
a
a
o
a
a
a
n
a
a
"}
(3,1,2) = {"
s
b
n
I
a
R
h
J
a
"}
(4,1,2) = {"
a
a
a
b
n
i
a
a
a
"}
(5,1,2) = {"
a
a
a
a
a
a
a
a
a
"}
