//MAP CONVERTED BY dmm2tgm.py THIS HEADER COMMENT PREVENTS RECONVERSION, DO NOT REMOVE
"a" = (
/turf/template_noop,
/area/template_noop)
"b" = (
/obj/effect/turf_decal/stripes/line{
	dir = 9
	},
/turf/template_noop,
/area/station/engineering/supermatter/room)
"c" = (
/obj/effect/turf_decal/stripes/line{
	dir = 5
	},
/turf/template_noop,
/area/station/engineering/supermatter/room)
"n" = (
/turf/closed/wall/r_wall,
/area/station/engineering/supermatter/room)
"o" = (
/obj/machinery/shower/directional/east,
/turf/open/floor/noslip,
/area/station/engineering/supermatter/room)
"w" = (
/obj/machinery/button/delam_scram,
/turf/closed/wall/r_wall,
/area/station/engineering/supermatter/room)
"C" = (
/obj/effect/turf_decal/stripes/line{
	dir = 1
	},
/turf/template_noop,
/area/station/engineering/supermatter/room)
"E" = (
/obj/machinery/shower/directional/west,
/turf/open/floor/noslip,
/area/station/engineering/supermatter/room)
"O" = (
/obj/machinery/atmospherics/components/unary/delam_scram/directional/east{
	dir = 8
	},
/turf/template_noop,
/area/station/engineering/supermatter)
"Q" = (
/obj/structure/cable,
/obj/machinery/atmospherics/components/unary/vent_scrubber/on/layer2{
	dir = 1
	},
/obj/effect/turf_decal/stripes/corner{
	dir = 4
	},
/turf/open/floor/engine,
/area/station/engineering/supermatter/room)
"T" = (
/obj/effect/turf_decal/stripes/line{
	dir = 1
	},
/obj/structure/sign/delam_procedure/directional/north,
/turf/template_noop,
/area/station/engineering/supermatter/room)
"V" = (
/obj/structure/cable,
/turf/open/floor/noslip,
/area/station/engineering/supermatter/room)
"Y" = (
/obj/structure/cable,
/obj/machinery/atmospherics/components/unary/vent_pump/on/layer4{
	dir = 1
	},
/obj/effect/turf_decal/stripes/corner{
	dir = 1
	},
/turf/open/floor/engine,
/area/station/engineering/supermatter/room)

(1,1,1) = {"
a
c
Q
a
a
a
a
a
a
a
"}
(2,1,1) = {"
a
w
C
a
a
a
a
a
a
a
"}
(3,1,1) = {"
a
o
C
a
a
a
a
O
a
a
"}
(4,1,1) = {"
a
V
C
a
a
a
a
a
a
a
"}
(5,1,1) = {"
a
E
C
a
a
a
a
a
a
a
"}
(6,1,1) = {"
a
n
T
a
a
a
a
a
a
a
"}
(7,1,1) = {"
a
b
Y
a
a
a
a
a
a
a
"}
