//MAP CONVERTED BY dmm2tgm.py THIS HEADER COMMENT PREVENTS RECONVERSION, DO NOT REMOVE
"a" = (
/turf/template_noop,
/area/template_noop)
"c" = (
/obj/structure/lattice/catwalk,
/obj/structure/marker_beacon/teal,
/turf/open/floor/engine/hull/reinforced,
/area/space/nearstation)
"d" = (
/obj/item/beacon,
/obj/effect/turf_decal/delivery,
/obj/machinery/newscaster/directional/north,
/turf/open/floor/iron,
/area/station/hallway/secondary/entry)
"f" = (
/obj/structure/window/reinforced/spawner/directional/north,
/obj/structure/window/reinforced/spawner/directional/south,
/obj/structure/window/reinforced/spawner/directional/west,
/obj/structure/flora/bush/sparsegrass/style_3,
/obj/structure/flora/grass/jungle,
/obj/structure/flora/bush/ferny/style_random,
/obj/structure/marker_beacon/lime,
/turf/open/floor/grass,
/area/station/hallway/secondary/entry)
"h" = (
/obj/structure/closet/emcloset,
/obj/effect/turf_decal/delivery,
/obj/effect/landmark/start/hangover/closet,
/turf/open/floor/iron,
/area/station/hallway/secondary/entry)
"i" = (
/obj/docking_port/stationary{
	dir = 8;
	dwidth = 1;
	height = 13;
	shuttle_id = "arrivals_stationary";
	name = "arrivals";
	roundstart_template = null;
	width = 5
	},
/turf/open/openspace,
/area/space)
"k" = (
/obj/structure/window/reinforced/spawner/directional/north,
/obj/structure/window/reinforced/spawner/directional/south,
/obj/structure/window/reinforced/spawner/directional/east,
/obj/structure/flora/bush/sparsegrass/style_3,
/obj/structure/flora/bush/grassy/style_2,
/obj/structure/flora/grass/jungle/b,
/obj/structure/marker_beacon/lime,
/turf/open/floor/grass,
/area/station/hallway/secondary/entry)
"m" = (
/turf/closed/wall,
/area/station/hallway/secondary/entry)
"p" = (
/obj/structure/closet/firecloset,
/obj/effect/turf_decal/delivery,
/obj/effect/landmark/start/hangover/closet,
/turf/open/floor/iron,
/area/station/hallway/secondary/entry)
"t" = (
/obj/machinery/computer/shuttle/arrivals/recall,
/turf/open/floor/iron,
/area/station/hallway/secondary/entry)
"B" = (
/obj/structure/window/reinforced/spawner/directional/north,
/obj/structure/window/reinforced/spawner/directional/south,
/obj/structure/flora/bush/sparsegrass/style_2,
/obj/structure/flora/bush/grassy/style_2,
/obj/structure/flora/bush/flowers_yw,
/obj/structure/window/reinforced/spawner/directional/east,
/turf/open/floor/grass,
/area/station/hallway/secondary/entry)
"J" = (
/obj/structure/window/reinforced/spawner/directional/north,
/obj/structure/window/reinforced/spawner/directional/south,
/obj/structure/flora/grass/jungle,
/obj/structure/flora/bush/sunny/style_random,
/obj/structure/window/reinforced/spawner/directional/west,
/turf/open/floor/grass,
/area/station/hallway/secondary/entry)
"N" = (
/obj/structure/lattice,
/turf/open/floor/engine/hull/reinforced,
/area/space/nearstation)
"P" = (
/turf/open/openspace,
/area/space)
"S" = (
/turf/open/floor/glass/reinforced/airless,
/area/space/nearstation)
"Z" = (
/obj/effect/spawner/random/vending/colavend,
/obj/effect/turf_decal/delivery,
/turf/open/floor/iron,
/area/station/hallway/secondary/entry)

(1,1,1) = {"
a
a
a
a
a
a
a
"}
(2,1,1) = {"
a
a
a
a
a
a
a
"}
(3,1,1) = {"
a
a
a
P
a
a
a
"}
(4,1,1) = {"
a
a
a
a
a
a
a
"}
(5,1,1) = {"
a
a
a
a
a
a
a
"}
(6,1,1) = {"
a
a
a
a
a
a
a
"}
(7,1,1) = {"
a
a
a
P
N
f
Z
"}
(8,1,1) = {"
a
a
a
P
c
B
t
"}
(9,1,1) = {"
a
a
a
P
N
m
d
"}
(10,1,1) = {"
a
a
a
P
c
J
h
"}
(11,1,1) = {"
a
a
a
P
N
k
p
"}
(12,1,1) = {"
a
a
a
a
a
a
a
"}
(13,1,1) = {"
a
a
a
a
a
a
a
"}
(14,1,1) = {"
a
a
a
a
a
a
a
"}
(15,1,1) = {"
a
a
i
P
a
a
a
"}
(16,1,1) = {"
a
a
a
a
a
a
a
"}
(17,1,1) = {"
S
a
a
a
a
a
a
"}
