//MAP CONVERTED BY dmm2tgm.py THIS HEADER COMMENT PREVENTS RECONVERSION, DO NOT REMOVE
"a" = (
/obj/effect/mapping_helpers/airlock/access/all/engineering/construction,
/obj/machinery/atmospherics/pipe/smart/manifold4w/supply/hidden/layer4,
/obj/machinery/atmospherics/pipe/smart/manifold4w/scrubbers/hidden/layer2,
/obj/structure/disposalpipe/segment{
	dir = 4
	},
/obj/machinery/door/airlock/maintenance_hatch{
	name = "Grav Gen Maintenance"
	},
/turf/open/floor/plating,
/area/station/engineering/gravity_generator)

(1,1,1) = {"
a
"}
