//MAP CONVERTED BY dmm2tgm.py THIS HEADER COMMENT PREVENTS RECONVERSION, DO NOT REMOVE
"a" = (
/obj/structure/lattice,
/turf/open/floor/engine/hull/reinforced,
/area/space/nearstation)
"e" = (
/obj/structure/lattice/catwalk,
/obj/structure/marker_beacon/teal,
/turf/open/floor/engine/hull/reinforced,
/area/space/nearstation)
"f" = (
/obj/structure/lattice,
/turf/open/space/basic,
/area/space/nearstation)
"j" = (
/obj/machinery/status_display/shuttle{
	shuttle_id = "arrivals_shuttle"
	},
/turf/closed/wall/r_wall,
/area/station/hallway/secondary/entry)
"p" = (
/turf/closed/wall/r_wall,
/area/station/hallway/secondary/entry)
"v" = (
/obj/machinery/door/airlock/external{
	name = "Arrival Airlock";
	space_dir = 2
	},
/obj/effect/mapping_helpers/airlock/cyclelink_helper{
	dir = 1
	},
/turf/open/floor/plating,
/area/station/hallway/secondary/entry)
"y" = (
/obj/docking_port/stationary{
	dir = 4;
	dwidth = 1;
	height = 13;
	shuttle_id = "arrivals_stationary";
	name = "arrivals";
	roundstart_template = null;
	width = 5
	},
/turf/open/openspace,
/area/space)
"A" = (
/obj/effect/turf_decal/plaque{
	icon_state = "L14"
	},
/obj/effect/turf_decal/stripes/corner{
	dir = 8
	},
/obj/machinery/time_clock/directional/south,
/turf/open/floor/iron,
/area/station/hallway/primary/central)
"C" = (
/turf/template_noop,
/area/template_noop)
"D" = (
/turf/open/floor/glass/reinforced/airless,
/area/space/nearstation)
"E" = (
/turf/open/floor/iron,
/area/station/hallway/primary/central)
"N" = (
/obj/effect/turf_decal/plaque{
	icon_state = "L2"
	},
/obj/effect/turf_decal/stripes/corner,
/obj/structure/sign/poster/timeclock_psa/directional/south,
/turf/open/floor/iron,
/area/station/hallway/primary/central)
"O" = (
/obj/structure/lattice/catwalk,
/obj/structure/marker_beacon/teal,
/turf/open/space/basic,
/area/space/nearstation)
"S" = (
/turf/open/floor/engine/hull/reinforced,
/area/space/nearstation)
"T" = (
/obj/machinery/door/airlock/external{
	name = "Arrival Airlock";
	space_dir = 2
	},
/obj/effect/mapping_helpers/airlock/cyclelink_helper,
/turf/open/floor/plating,
/area/station/hallway/secondary/entry)
"V" = (
/obj/machinery/computer/shuttle/arrivals/recall{
	dir = 1
	},
/turf/open/floor/glass/reinforced,
/area/station/hallway/secondary/entry)
"Y" = (
/turf/open/openspace,
/area/space)

(1,1,1) = {"
C
C
C
C
C
C
C
C
C
C
C
C
C
C
C
"}
(2,1,1) = {"
C
C
C
C
C
C
C
C
C
C
C
C
C
C
C
"}
(3,1,1) = {"
C
C
C
C
C
y
C
C
C
C
C
C
C
C
C
"}
(4,1,1) = {"
C
j
C
C
C
C
C
C
C
C
C
C
C
C
C
"}
(5,1,1) = {"
C
T
C
v
C
C
C
C
C
C
C
T
C
v
E
"}
(6,1,1) = {"
N
p
C
C
C
C
C
C
C
C
C
C
C
C
C
"}
(7,1,1) = {"
C
V
C
a
Y
C
C
C
C
C
C
a
C
C
C
"}
(8,1,1) = {"
C
C
C
e
S
C
C
C
C
O
a
a
C
C
C
"}
(9,1,1) = {"
C
C
C
a
S
C
C
C
C
f
a
a
C
C
C
"}
(10,1,1) = {"
C
C
C
e
S
C
C
C
C
O
a
a
C
C
C
"}
(11,1,1) = {"
C
C
C
a
Y
C
C
C
C
C
C
a
C
C
C
"}
(12,1,1) = {"
A
p
C
C
C
C
C
C
C
C
C
C
C
C
C
"}
(13,1,1) = {"
C
T
C
v
C
C
C
C
C
C
C
T
C
v
E
"}
(14,1,1) = {"
C
j
C
C
C
C
C
C
C
C
C
C
C
C
C
"}
(15,1,1) = {"
C
C
C
C
C
C
C
C
C
C
C
C
C
C
C
"}
(16,1,1) = {"
C
C
C
C
C
C
C
C
C
C
C
C
C
C
C
"}
(17,1,1) = {"
C
C
C
C
C
C
C
D
C
C
C
C
C
C
C
"}
