//MAP CONVERTED BY dmm2tgm.py THIS HEADER COMMENT PREVENTS RECONVERSION, DO NOT REMOVE
"a" = (
/turf/template_noop,
/area/template_noop)
"e" = (
/obj/machinery/camera/autoname/directional/west,
/turf/template_noop,
/area/template_noop)
"f" = (
/obj/structure/flora/bush/fullgrass,
/obj/structure/flora/bush/grassy/style_random,
/obj/structure/flora/bush/flowers_yw,
/obj/structure/flora/bush/flowers_br/style_2,
/turf/open/floor/grass,
/area/station/service/library/upper)
"o" = (
/obj/structure/flora/bush/fullgrass,
/obj/structure/flora/bush/large{
	pixel_y = -2
	},
/obj/structure/marker_beacon/lime,
/turf/open/floor/grass,
/area/station/service/library/upper)
"p" = (
/obj/structure/flora/bush/grassy/style_random,
/obj/structure/flora/bush/flowers_br/style_2,
/turf/open/floor/grass,
/area/station/service/library/upper)
"t" = (
/obj/structure/flora/bush/fullgrass,
/obj/structure/flora/bush/grassy/style_random,
/obj/structure/flora/bush/lavendergrass/style_random,
/turf/open/floor/grass,
/area/station/service/library/upper)
"D" = (
/obj/structure/flora/bush/grassy/style_random,
/obj/structure/flora/bush/fullgrass,
/obj/structure/marker_beacon/lime,
/turf/open/floor/grass,
/area/station/service/library/upper)
"T" = (
/obj/structure/flora/bush/fullgrass,
/obj/structure/flora/bush/grassy/style_random,
/obj/structure/flora/bush/lavendergrass/style_random,
/obj/structure/flora/bush/flowers_yw,
/turf/open/floor/grass,
/area/station/service/library/upper)
"V" = (
/obj/structure/flora/bush/fullgrass,
/obj/structure/flora/bush/lavendergrass/style_random,
/obj/structure/flora/bush/flowers_br/style_2,
/obj/machinery/camera/autoname/directional/west,
/turf/open/floor/grass,
/area/station/service/library/upper)
"X" = (
/obj/structure/flora/bush/fullgrass,
/obj/structure/flora/bush/grassy/style_random,
/obj/structure/flora/bush/flowers_br/style_2,
/turf/open/floor/grass,
/area/station/service/library/upper)

(1,1,1) = {"
a
a
o
a
a
a
D
a
"}
(2,1,1) = {"
e
X
t
f
a
T
t
V
"}
(3,1,1) = {"
a
a
a
p
t
p
a
a
"}
