//MAP CONVERTED BY dmm2tgm.py THIS HEADER COMMENT PREVENTS RECONVERSION, DO NOT REMOVE
"aF" = (
/obj/effect/turf_decal/siding/dark{
	dir = 4
	},
/obj/effect/turf_decal/trimline/dark/filled/line{
	dir = 4
	},
/turf/open/floor/iron/dark/small,
/area/station/commons/dock/secondary)
"bg" = (
/obj/structure/window/reinforced/spawner/directional/south,
/obj/effect/turf_decal/tile/neutral,
/obj/effect/turf_decal/tile/neutral{
	dir = 8
	},
/obj/effect/turf_decal/stripes/line{
	dir = 8
	},
/obj/machinery/light/floor,
/turf/open/floor/iron/dark,
/area/station/commons/dock/secondary)
"bu" = (
/turf/open/space/openspace,
/area/space)
"bZ" = (
/obj/effect/turf_decal/tile/neutral{
	dir = 4
	},
/obj/effect/turf_decal/tile/neutral{
	dir = 1
	},
/obj/machinery/light/floor,
/turf/open/floor/iron/dark,
/area/station/commons/dock/secondary)
"cB" = (
/obj/structure/window/reinforced/spawner/directional/north,
/obj/effect/turf_decal/tile/neutral{
	dir = 4
	},
/obj/effect/turf_decal/tile/neutral{
	dir = 1
	},
/obj/effect/turf_decal/stripes/corner{
	dir = 8
	},
/obj/machinery/light/floor,
/turf/open/floor/iron/dark,
/area/station/commons/dock/secondary)
"dS" = (
/obj/structure/window/reinforced/spawner/directional/north,
/turf/open/space/openspace,
/area/space/nearstation)
"eQ" = (
/obj/effect/turf_decal/siding/dark,
/obj/effect/turf_decal/siding/dark{
	dir = 1
	},
/obj/effect/turf_decal/trimline/dark/filled/line{
	dir = 1
	},
/obj/effect/turf_decal/trimline/yellow/line,
/obj/effect/landmark/start/hangover,
/obj/effect/landmark/start/assistant,
/obj/effect/spawner/random/engineering/tracking_beacon,
/turf/open/floor/iron/dark/small,
/area/station/commons/dock/secondary)
"fv" = (
/turf/closed/wall,
/area/station/commons/dock/secondary)
"fZ" = (
/obj/effect/landmark/event_spawn,
/obj/machinery/atmospherics/pipe/smart/manifold4w/supply/hidden/layer4,
/obj/machinery/atmospherics/pipe/smart/manifold4w/scrubbers/hidden/layer2,
/turf/open/floor/iron/dark,
/area/station/commons/dock/secondary)
"gl" = (
/obj/effect/turf_decal/siding/wideplating_new/dark{
	dir = 8
	},
/obj/machinery/digital_clock/directional/north,
/obj/effect/turf_decal/tile/neutral{
	dir = 1
	},
/obj/effect/turf_decal/tile/neutral{
	dir = 4
	},
/turf/open/floor/iron/dark,
/area/station/commons/dock/secondary)
"iy" = (
/obj/machinery/atmospherics/pipe/smart/manifold4w/scrubbers/hidden/layer2,
/obj/machinery/atmospherics/pipe/smart/manifold4w/supply/hidden/layer4,
/turf/open/floor/iron/dark,
/area/station/commons/dock/secondary)
"iK" = (
/obj/structure/railing{
	color = "#36373a";
	dir = 1
	},
/obj/structure/railing{
	color = "#36373a"
	},
/turf/open/floor/iron/stairs/right{
	dir = 4;
	color = "#3d3e42"
	},
/area/station/commons/dock/secondary)
"iO" = (
/obj/effect/turf_decal/tile/neutral{
	dir = 4
	},
/obj/effect/turf_decal/tile/neutral{
	dir = 1
	},
/obj/machinery/door/firedoor,
/turf/open/floor/iron/dark,
/area/station/commons/dock/secondary)
"kv" = (
/obj/effect/turf_decal/trimline/yellow,
/obj/effect/turf_decal/trimline/yellow/corner{
	dir = 4
	},
/obj/effect/turf_decal/trimline/yellow/corner,
/obj/machinery/light/floor,
/obj/effect/turf_decal/siding/dark{
	dir = 4
	},
/obj/structure/cable,
/obj/structure/disposalpipe/segment{
	dir = 4
	},
/obj/effect/landmark/start/hangover,
/obj/effect/landmark/start/assistant,
/obj/machinery/atmospherics/pipe/smart/manifold4w/supply/hidden/layer4,
/obj/machinery/atmospherics/pipe/smart/manifold4w/scrubbers/hidden/layer2,
/turf/open/floor/iron/dark/small,
/area/station/commons/dock/secondary)
"kU" = (
/obj/structure/window/reinforced/spawner/directional/south,
/obj/effect/turf_decal/tile/neutral,
/obj/effect/turf_decal/tile/neutral{
	dir = 8
	},
/obj/machinery/atmospherics/components/unary/vent_scrubber/on/layer2{
	dir = 1
	},
/turf/open/floor/iron/dark,
/area/station/commons/dock/secondary)
"lw" = (
/obj/structure/window/reinforced/spawner/directional/south,
/obj/structure/lattice/catwalk,
/obj/structure/marker_beacon/cerulean,
/turf/open/space/openspace,
/area/space/nearstation)
"mD" = (
/obj/effect/turf_decal/trimline/yellow/corner{
	dir = 1
	},
/obj/effect/turf_decal/siding/dark/corner{
	dir = 1
	},
/obj/effect/turf_decal/siding/dark/corner,
/obj/effect/turf_decal/trimline/dark/filled/corner,
/obj/structure/disposalpipe/segment,
/turf/open/floor/iron/dark/small,
/area/station/commons/dock/secondary)
"nr" = (
/obj/structure/window/reinforced/spawner/directional/north,
/obj/structure/lattice,
/turf/open/space/openspace,
/area/space/nearstation)
"ns" = (
/obj/structure/window/reinforced/spawner/directional/north,
/obj/effect/turf_decal/tile/neutral{
	dir = 4
	},
/obj/effect/turf_decal/tile/neutral{
	dir = 1
	},
/turf/open/floor/iron/dark,
/area/station/commons/dock/secondary)
"nI" = (
/obj/effect/turf_decal/trimline/yellow/corner{
	dir = 4
	},
/obj/effect/turf_decal/siding/dark/corner{
	dir = 4
	},
/obj/effect/turf_decal/siding/dark/corner{
	dir = 8
	},
/obj/effect/turf_decal/trimline/dark/filled/corner{
	dir = 8
	},
/obj/structure/cable,
/obj/effect/landmark/event_spawn,
/obj/machinery/atmospherics/pipe/smart/manifold4w/supply/hidden/layer4,
/obj/machinery/atmospherics/pipe/smart/manifold4w/scrubbers/hidden/layer2,
/turf/open/floor/iron/dark/small,
/area/station/commons/dock/secondary)
"rS" = (
/obj/structure/window/reinforced/spawner/directional/south,
/obj/structure/lattice,
/turf/open/space/openspace,
/area/space/nearstation)
"ss" = (
/obj/effect/turf_decal/tile/neutral{
	dir = 8
	},
/obj/effect/turf_decal/tile/neutral,
/obj/machinery/light/floor,
/turf/open/floor/iron/dark,
/area/station/commons/dock/secondary)
"sM" = (
/turf/open/space/openspace,
/area/space/nearstation)
"tm" = (
/obj/structure/displaycase/trophy,
/turf/open/floor/iron/dark/textured_large,
/area/station/commons/dock/secondary)
"ul" = (
/obj/structure/sign/nanotrasen,
/turf/closed/wall,
/area/station/commons/dock/secondary)
"uv" = (
/obj/structure/cable,
/obj/structure/disposalpipe/segment{
	dir = 4
	},
/obj/machinery/atmospherics/pipe/smart/manifold4w/supply/hidden/layer4,
/obj/machinery/atmospherics/pipe/smart/manifold4w/scrubbers/hidden/layer2,
/turf/open/floor/iron/stairs/medium{
	color = "#3d3e42";
	dir = 4
	},
/area/station/commons/dock/secondary)
"uB" = (
/obj/structure/cable,
/obj/effect/turf_decal/siding/wideplating_new/dark{
	dir = 8
	},
/obj/structure/disposalpipe/segment{
	dir = 4
	},
/obj/machinery/atmospherics/pipe/smart/manifold4w/supply/hidden/layer4,
/obj/machinery/atmospherics/pipe/smart/manifold4w/scrubbers/hidden/layer2,
/turf/open/floor/iron/dark,
/area/station/commons/dock/secondary)
"vt" = (
/obj/effect/turf_decal/trimline/yellow,
/obj/effect/turf_decal/trimline/yellow/corner{
	dir = 4
	},
/obj/effect/turf_decal/trimline/yellow/corner{
	dir = 1
	},
/obj/machinery/light/floor,
/obj/effect/turf_decal/siding/dark{
	dir = 1
	},
/obj/effect/landmark/start/hangover,
/obj/effect/landmark/start/assistant,
/turf/open/floor/iron/dark/small,
/area/station/commons/dock/secondary)
"vS" = (
/obj/docking_port/stationary{
	dheight = 3;
	dir = 8;
	dwidth = 8;
	height = 11;
	shuttle_id = "ferry_home";
	name = "Secondary Station Dock";
	width = 20
	},
/turf/open/space/openspace,
/area/space)
"xw" = (
/turf/template_noop,
/area/template_noop)
"xy" = (
/obj/effect/turf_decal/siding/dark{
	dir = 9
	},
/obj/effect/turf_decal/trimline/dark/filled/line{
	dir = 9
	},
/obj/machinery/status_display/evac/directional/north,
/turf/open/floor/iron/dark/small,
/area/station/commons/dock/secondary)
"ym" = (
/obj/effect/spawner/structure/window/reinforced,
/turf/open/floor/plating,
/area/station/commons/dock/secondary)
"yI" = (
/obj/structure/cable,
/obj/machinery/atmospherics/pipe/smart/manifold4w/supply/hidden/layer4,
/obj/machinery/atmospherics/pipe/smart/manifold4w/scrubbers/hidden/layer2,
/obj/structure/disposalpipe/junction{
	dir = 1
	},
/obj/effect/landmark/start/hangover,
/obj/effect/landmark/start/assistant,
/turf/open/floor/iron/dark/textured_large,
/area/station/commons/dock/secondary)
"AM" = (
/obj/effect/turf_decal/siding/wideplating_new/dark{
	dir = 4
	},
/obj/effect/turf_decal/tile/neutral{
	dir = 1
	},
/obj/structure/cable,
/obj/machinery/power/apc/auto_name/directional/north,
/obj/effect/turf_decal/tile/neutral{
	dir = 4
	},
/turf/open/floor/iron/dark,
/area/station/commons/dock/secondary)
"Ei" = (
/obj/effect/turf_decal/siding/wideplating_new/dark{
	dir = 4
	},
/obj/effect/turf_decal/tile/neutral{
	dir = 8
	},
/obj/machinery/airalarm/directional/south,
/obj/machinery/camera/autoname/directional/south,
/obj/effect/turf_decal/tile/neutral,
/turf/open/floor/iron/dark,
/area/station/commons/dock/secondary)
"ET" = (
/obj/effect/turf_decal/siding/wideplating_new/dark{
	dir = 8
	},
/obj/machinery/firealarm/directional/south,
/obj/effect/turf_decal/tile/neutral,
/obj/effect/turf_decal/tile/neutral{
	dir = 8
	},
/turf/open/floor/iron/dark,
/area/station/commons/dock/secondary)
"Fj" = (
/obj/effect/turf_decal/siding/dark{
	dir = 10
	},
/obj/effect/turf_decal/trimline/dark/filled/line{
	dir = 10
	},
/obj/item/kirbyplants/organic/plant19,
/obj/structure/cable,
/obj/machinery/atmospherics/pipe/smart/manifold4w/supply/hidden/layer4,
/obj/machinery/atmospherics/components/unary/vent_scrubber/on/layer2{
	dir = 1
	},
/turf/open/floor/iron/dark/small,
/area/station/commons/dock/secondary)
"GH" = (
/obj/effect/turf_decal/stripes/line{
	dir = 8
	},
/turf/open/floor/iron/dark,
/area/station/commons/dock/secondary)
"Hz" = (
/obj/structure/disposalpipe/segment{
	dir = 4
	},
/obj/effect/landmark/navigate_destination/docksec,
/obj/machinery/holopad,
/turf/open/floor/iron/dark/small,
/area/station/commons/dock/secondary)
"HQ" = (
/obj/machinery/atmospherics/pipe/smart/manifold4w/supply/hidden/layer4,
/obj/machinery/atmospherics/pipe/smart/manifold4w/scrubbers/hidden/layer2,
/obj/effect/landmark/firealarm_sanity,
/turf/open/floor/iron/dark,
/area/station/commons/dock/secondary)
"Ia" = (
/obj/structure/cable,
/obj/machinery/atmospherics/pipe/smart/manifold4w/supply/hidden/layer4,
/obj/machinery/atmospherics/pipe/smart/manifold4w/scrubbers/hidden/layer2,
/obj/structure/disposalpipe/segment,
/obj/machinery/door/airlock/maintenance{
	name = "Theater Maintenance"
	},
/obj/effect/mapping_helpers/airlock/access/any/service/maintenance,
/obj/effect/mapping_helpers/airlock/unres,
/turf/open/floor/catwalk_floor/iron_dark,
/area/station/commons/dock/secondary)
"IE" = (
/obj/effect/turf_decal/tile/neutral,
/obj/effect/turf_decal/tile/neutral{
	dir = 8
	},
/obj/machinery/door/firedoor,
/turf/open/floor/iron/dark,
/area/station/commons/dock/secondary)
"Jn" = (
/obj/structure/cable,
/obj/machinery/atmospherics/pipe/smart/manifold4w/supply/hidden/layer4,
/obj/machinery/atmospherics/pipe/smart/manifold4w/scrubbers/hidden/layer2,
/obj/structure/disposalpipe/segment,
/obj/effect/mapping_helpers/airlock/access/any/service/maintenance,
/obj/machinery/door/airlock/maintenance{
	name = "Theater Maintenance"
	},
/obj/effect/mapping_helpers/airlock/unres{
	dir = 1
	},
/turf/open/floor/catwalk_floor/iron_dark,
/area/station/commons/dock/secondary)
"Jp" = (
/obj/structure/window/reinforced/spawner/directional/north,
/obj/structure/lattice/catwalk,
/obj/structure/marker_beacon/cerulean,
/turf/open/space/openspace,
/area/space/nearstation)
"JA" = (
/obj/effect/turf_decal/stripes/line{
	dir = 8
	},
/obj/machinery/atmospherics/pipe/smart/manifold4w/scrubbers/hidden/layer2,
/obj/machinery/atmospherics/pipe/smart/manifold4w/supply/hidden/layer4,
/turf/open/floor/iron/dark,
/area/station/commons/dock/secondary)
"Ko" = (
/obj/structure/railing{
	color = "#36373a"
	},
/obj/structure/railing{
	color = "#36373a";
	dir = 1
	},
/turf/open/floor/iron/stairs/left{
	dir = 4;
	color = "#3d3e42"
	},
/area/station/commons/dock/secondary)
"Lv" = (
/obj/effect/turf_decal/siding/wideplating_new/dark{
	dir = 4
	},
/obj/structure/cable,
/obj/machinery/atmospherics/pipe/smart/manifold4w/scrubbers/hidden/layer2,
/obj/machinery/atmospherics/pipe/smart/manifold4w/supply/hidden/layer4,
/turf/open/floor/iron/dark,
/area/station/commons/dock/secondary)
"LP" = (
/obj/effect/turf_decal/trimline/dark/filled/corner,
/obj/effect/turf_decal/trimline/dark/filled/corner{
	dir = 8
	},
/obj/effect/turf_decal/siding/dark/corner,
/obj/effect/turf_decal/siding/dark/corner{
	dir = 8
	},
/obj/structure/cable,
/obj/machinery/atmospherics/components/unary/vent_pump/on/layer4{
	dir = 8
	},
/turf/open/floor/iron/dark/small,
/area/station/commons/dock/secondary)
"MB" = (
/obj/effect/turf_decal/trimline/yellow/corner{
	dir = 8
	},
/obj/effect/turf_decal/siding/dark/corner{
	dir = 8
	},
/obj/effect/turf_decal/siding/dark{
	dir = 1
	},
/obj/effect/turf_decal/trimline/dark/filled/line{
	dir = 1
	},
/obj/effect/landmark/event_spawn,
/turf/open/floor/iron/dark/small,
/area/station/commons/dock/secondary)
"ME" = (
/obj/effect/turf_decal/stripes/line{
	dir = 8
	},
/obj/effect/turf_decal/stripes/line{
	dir = 4
	},
/obj/effect/mapping_helpers/airlock/cyclelink_helper_multi{
	cycle_id = "ert-lz-starboard"
	},
/obj/machinery/door/airlock/external/glass{
	name = "Secondary Ship Dock"
	},
/obj/structure/sign/warning/vacuum/external/directional/north,
/obj/machinery/atmospherics/pipe/smart/manifold4w/scrubbers/hidden/layer2,
/obj/machinery/atmospherics/pipe/smart/manifold4w/supply/hidden/layer4,
/turf/open/floor/iron/dark,
/area/station/commons/dock/secondary)
"MW" = (
/obj/structure/sign/painting/library,
/turf/closed/wall,
/area/station/commons/dock/secondary)
"Nj" = (
/obj/structure/cable,
/obj/machinery/atmospherics/pipe/smart/manifold4w/supply/hidden/layer4,
/obj/machinery/atmospherics/pipe/smart/manifold4w/scrubbers/hidden/layer2,
/obj/structure/disposalpipe/segment,
/obj/effect/landmark/start/hangover,
/obj/effect/landmark/start/assistant,
/turf/open/floor/iron/dark/textured_large,
/area/station/commons/dock/secondary)
"NF" = (
/obj/structure/window/reinforced/spawner/directional/south,
/obj/effect/turf_decal/tile/neutral,
/obj/effect/turf_decal/tile/neutral{
	dir = 8
	},
/obj/effect/turf_decal/stripes/line{
	dir = 8
	},
/turf/open/floor/iron/dark,
/area/station/commons/dock/secondary)
"OW" = (
/obj/structure/cable,
/obj/structure/disposalpipe/segment{
	dir = 4
	},
/obj/effect/turf_decal/siding/dark{
	dir = 8
	},
/obj/effect/turf_decal/trimline/dark/filled/line{
	dir = 8
	},
/obj/machinery/atmospherics/pipe/smart/manifold4w/supply/hidden/layer4,
/obj/machinery/atmospherics/pipe/smart/manifold4w/scrubbers/hidden/layer2,
/turf/open/floor/iron/dark/small,
/area/station/commons/dock/secondary)
"OY" = (
/obj/structure/cable,
/obj/machinery/atmospherics/pipe/smart/manifold4w/supply/hidden/layer4,
/obj/machinery/atmospherics/pipe/smart/manifold4w/scrubbers/hidden/layer2,
/obj/structure/disposalpipe/segment,
/obj/effect/landmark/blobstart,
/obj/effect/landmark/event_spawn,
/obj/effect/landmark/generic_maintenance_landmark,
/turf/open/floor/plating,
/area/station/maintenance/port)
"PI" = (
/obj/effect/turf_decal/stripes/line{
	dir = 8
	},
/obj/effect/turf_decal/stripes/line{
	dir = 4
	},
/obj/effect/mapping_helpers/airlock/cyclelink_helper_multi{
	cycle_id = "ert-lz-starboard"
	},
/obj/machinery/door/airlock/external/glass{
	name = "Secondary Ship Dock"
	},
/turf/open/floor/iron/dark,
/area/station/commons/dock/secondary)
"Re" = (
/obj/structure/window/reinforced/spawner/directional/north,
/obj/effect/turf_decal/tile/neutral{
	dir = 4
	},
/obj/effect/turf_decal/tile/neutral{
	dir = 1
	},
/obj/machinery/atmospherics/components/unary/vent_pump/on/layer4,
/turf/open/floor/iron/dark,
/area/station/commons/dock/secondary)
"UH" = (
/obj/effect/turf_decal/siding/dark{
	dir = 5
	},
/obj/effect/turf_decal/trimline/dark/filled/line{
	dir = 5
	},
/obj/item/radio/intercom/directional/north,
/turf/open/floor/iron/dark/small,
/area/station/commons/dock/secondary)
"UO" = (
/obj/structure/closet/firecloset/wall,
/turf/closed/wall,
/area/station/commons/dock/secondary)
"Va" = (
/obj/structure/window/reinforced/spawner/directional/north,
/obj/effect/turf_decal/tile/neutral{
	dir = 4
	},
/obj/effect/turf_decal/tile/neutral{
	dir = 1
	},
/obj/effect/turf_decal/stripes/corner{
	dir = 8
	},
/obj/item/kirbyplants/organic/plant10,
/turf/open/floor/iron/dark,
/area/station/commons/dock/secondary)
"VM" = (
/obj/effect/turf_decal/trimline/yellow/corner,
/obj/effect/turf_decal/siding/dark/corner,
/obj/effect/turf_decal/siding/dark{
	dir = 1
	},
/obj/effect/turf_decal/trimline/dark/filled/line{
	dir = 1
	},
/turf/open/floor/iron/dark/small,
/area/station/commons/dock/secondary)
"VN" = (
/obj/structure/window/reinforced/spawner/directional/south,
/obj/effect/turf_decal/tile/neutral,
/obj/effect/turf_decal/tile/neutral{
	dir = 8
	},
/turf/open/floor/iron/dark,
/area/station/commons/dock/secondary)
"WM" = (
/obj/machinery/door/firedoor,
/obj/machinery/atmospherics/pipe/smart/manifold4w/supply/hidden/layer4,
/obj/machinery/atmospherics/pipe/smart/manifold4w/scrubbers/hidden/layer2,
/turf/open/floor/iron/dark,
/area/station/commons/dock/secondary)
"WU" = (
/obj/machinery/door/firedoor,
/obj/machinery/door/airlock/public/glass{
	name = "Secondary Ship Dock"
	},
/turf/open/floor/iron/dark/small,
/area/station/service/theater)
"Xd" = (
/obj/structure/closet/emcloset/wall,
/turf/closed/wall,
/area/station/commons/dock/secondary)
"Yj" = (
/obj/effect/turf_decal/siding/dark{
	dir = 6
	},
/obj/effect/turf_decal/trimline/dark/filled/line{
	dir = 6
	},
/obj/structure/extinguisher_cabinet/directional/south,
/turf/open/floor/iron/dark/small,
/area/station/commons/dock/secondary)
"Yt" = (
/obj/effect/turf_decal/trimline/yellow,
/obj/effect/turf_decal/trimline/yellow/corner{
	dir = 8
	},
/obj/effect/turf_decal/trimline/yellow/corner{
	dir = 1
	},
/obj/machinery/light/floor,
/obj/effect/turf_decal/siding/dark{
	dir = 8
	},
/obj/structure/disposalpipe/segment{
	dir = 10
	},
/obj/effect/landmark/start/hangover,
/obj/effect/landmark/start/assistant,
/turf/open/floor/iron/dark/small,
/area/station/commons/dock/secondary)
"YV" = (
/obj/effect/turf_decal/siding/dark{
	dir = 6
	},
/obj/effect/turf_decal/trimline/dark/filled/line{
	dir = 6
	},
/obj/machinery/disposal/bin,
/obj/structure/disposalpipe/trunk{
	dir = 1
	},
/turf/open/floor/iron/dark/small,
/area/station/commons/dock/secondary)
"Zv" = (
/obj/effect/turf_decal/siding/dark{
	dir = 10
	},
/obj/effect/turf_decal/trimline/dark/filled/line{
	dir = 10
	},
/obj/machinery/newscaster/directional/south,
/turf/open/floor/iron/dark/small,
/area/station/commons/dock/secondary)

(1,1,1) = {"
bu
bu
bu
bu
vS
bu
bu
"}
(2,1,1) = {"
bu
sM
ym
PI
PI
dS
bu
"}
(3,1,1) = {"
bu
lw
cB
GH
bg
Jp
bu
"}
(4,1,1) = {"
bu
rS
Re
iy
kU
nr
bu
"}
(5,1,1) = {"
bu
rS
fv
ME
PI
nr
bu
"}
(6,1,1) = {"
bu
rS
Va
JA
NF
nr
bu
"}
(7,1,1) = {"
bu
rS
ns
HQ
VN
nr
bu
"}
(8,1,1) = {"
xw
ul
iO
WM
IE
ul
bu
"}
(9,1,1) = {"
xw
Xd
bZ
fZ
ss
UO
xw
"}
(10,1,1) = {"
xw
fv
AM
Lv
Ei
fv
xw
"}
(11,1,1) = {"
OY
Jn
Nj
yI
Nj
Ia
xw
"}
(12,1,1) = {"
xw
fv
gl
uB
ET
fv
xw
"}
(13,1,1) = {"
xw
MW
iK
uv
Ko
MW
xw
"}
(14,1,1) = {"
xw
fv
xy
OW
Zv
fv
xw
"}
(15,1,1) = {"
xw
tm
VM
kv
nI
Fj
xw
"}
(16,1,1) = {"
xw
tm
eQ
Hz
vt
LP
xw
"}
(17,1,1) = {"
xw
tm
MB
Yt
mD
YV
xw
"}
(18,1,1) = {"
xw
fv
UH
aF
Yj
fv
xw
"}
(19,1,1) = {"
xw
xw
WU
WU
WU
xw
xw
"}
(20,1,1) = {"
xw
xw
xw
xw
xw
xw
xw
"}
