//MAP CONVERTED BY dmm2tgm.py THIS HEADER COMMENT PREVENTS RECONVERSION, DO NOT REMOVE
"a" = (
/turf/template_noop,
/area/template_noop)
"d" = (
/obj/effect/turf_decal/bot,
/obj/structure/guncase/ecase{
	open = 0;
	anchored = 1
	},
/obj/effect/spawner/armory_spawn/smg,
/turf/open/floor/iron/dark/textured_large,
/area/station/ai_monitored/security/armory)
"x" = (
/obj/structure/guncase/shotgun{
	open = 0;
	anchored = 1
	},
/obj/effect/turf_decal/bot,
/obj/effect/spawner/armory_spawn/shotguns,
/turf/open/floor/iron/dark/textured_large,
/area/station/ai_monitored/security/armory)
"Z" = (
/obj/structure/rack,
/obj/item/gun/energy/laser{
	pixel_x = 1;
	pixel_y = -5
	},
/obj/item/gun/energy/laser,
/obj/item/gun/energy/laser{
	pixel_y = 5
	},
/obj/item/gun/energy/laser/carbine,
/obj/structure/cable,
/obj/machinery/atmospherics/pipe/smart/manifold4w/scrubbers/hidden/layer2,
/obj/effect/turf_decal/bot,
/turf/open/floor/iron/dark/textured_large,
/area/station/ai_monitored/security/armory)

(1,1,1) = {"
a
a
a
a
a
a
a
a
a
a
a
"}
(2,1,1) = {"
a
a
a
a
a
a
a
a
a
a
a
"}
(3,1,1) = {"
a
a
a
a
a
a
a
a
a
a
a
"}
(4,1,1) = {"
a
a
a
a
a
a
a
d
a
a
a
"}
(5,1,1) = {"
a
a
a
a
a
a
Z
a
a
a
a
"}
(6,1,1) = {"
a
a
a
a
a
a
a
x
a
a
a
"}
(7,1,1) = {"
a
a
a
a
a
a
a
a
a
a
a
"}
(8,1,1) = {"
a
a
a
a
a
a
a
a
a
a
a
"}
(9,1,1) = {"
a
a
a
a
a
a
a
a
a
a
a
"}
(10,1,1) = {"
a
a
a
a
a
a
a
a
a
a
a
"}
(11,1,1) = {"
a
a
a
a
a
a
a
a
a
a
a
"}
