//MAP CONVERTED BY dmm2tgm.py THIS HEADER COMMENT PREVENTS RECONVERSION, DO NOT REMOVE
"a" = (
/turf/closed/wall,
/area/station/commons/fitness/recreation/lasertag)
"b" = (
/obj/structure/cable,
/obj/machinery/power/apc/auto_name/directional/east,
/turf/open/floor/wood/tile,
/area/station/commons/fitness/recreation/sauna)
"d" = (
/obj/structure/cable,
/obj/structure/disposalpipe/segment,
/obj/effect/landmark/firealarm_sanity,
/turf/open/floor/wood/tile,
/area/station/commons/fitness/recreation/sauna)
"e" = (
/obj/machinery/atmospherics/pipe/smart/manifold4w/supply/hidden/layer4,
/obj/machinery/atmospherics/pipe/smart/manifold4w/scrubbers/hidden/layer2,
/obj/structure/disposalpipe/segment{
	dir = 4
	},
/obj/structure/cable,
/turf/open/floor/wood/tile,
/area/station/commons/fitness/recreation/sauna)
"g" = (
/obj/structure/chair/sofa/bamboo{
	dir = 4
	},
/turf/open/floor/wood,
/area/station/commons/fitness/recreation/sauna)
"h" = (
/obj/structure/cable,
/obj/machinery/atmospherics/pipe/smart/manifold4w/scrubbers/hidden/layer2,
/obj/effect/landmark/navigate_destination/sauna,
/obj/structure/disposalpipe/segment{
	dir = 9
	},
/turf/open/floor/wood/tile,
/area/station/commons/fitness/recreation/sauna)
"j" = (
/obj/structure/dresser,
/obj/item/radio/intercom/directional/west,
/turf/open/floor/wood/tile,
/area/station/commons/fitness/recreation/sauna)
"k" = (
/turf/template_noop,
/area/template_noop)
"l" = (
/obj/effect/turf_decal/siding{
	dir = 9
	},
/obj/effect/turf_decal/trimline/blue,
/obj/structure/chair/stool/bar/directional{
	dir = 1
	},
/turf/open/floor/iron/white/textured,
/area/station/commons/fitness/recreation/pool)
"n" = (
/obj/structure/rack/wooden,
/obj/item/stack/sheet/mineral/wood/fifty,
/obj/machinery/button/door/directional/south{
	id = "sauna_priv";
	name = "Tactical Privacy Shutters";
	skin = "-warning";
	can_alter_skin = 0;
	icon_state = "button-warning"
	},
/turf/open/floor/wood/tile,
/area/station/commons/fitness/recreation/sauna)
"o" = (
/obj/machinery/light/warm/dim/directional/south,
/turf/open/floor/wood,
/area/station/commons/fitness/recreation/sauna)
"p" = (
/obj/structure/sauna_oven,
/turf/open/floor/wood,
/area/station/commons/fitness/recreation/sauna)
"q" = (
/obj/machinery/door/firedoor,
/obj/structure/cable,
/obj/machinery/door/airlock/public{
	name = "Sauna"
	},
/obj/structure/disposalpipe/segment{
	dir = 4
	},
/obj/machinery/atmospherics/pipe/smart/manifold4w/supply/hidden/layer4,
/obj/machinery/atmospherics/pipe/smart/manifold4w/scrubbers/hidden/layer2,
/turf/open/floor/wood/tile,
/area/station/commons/fitness/recreation/sauna)
"r" = (
/obj/machinery/door/airlock/public{
	name = "Pool Room"
	},
/turf/open/floor/iron/white/small,
/area/station/commons/fitness/recreation/pool)
"s" = (
/obj/item/towel,
/obj/item/clothing/under/misc/skyrat/gear_harness,
/obj/structure/closet/secure_closet/personal/wall{
	pixel_y = 32
	},
/obj/item/clothing/shoes/sandal{
	pixel_y = -3
	},
/obj/machinery/light/warm/directional/east,
/obj/machinery/airalarm/directional/east,
/turf/open/floor/wood/tile,
/area/station/commons/fitness/recreation/sauna)
"t" = (
/obj/structure/sink/directional/east,
/obj/item/reagent_containers/cup/bucket/wooden{
	pixel_y = -7;
	pixel_x = 1;
	name = "solid state sauna rehydration device"
	},
/turf/open/floor/wood,
/area/station/commons/fitness/recreation/sauna)
"u" = (
/obj/structure/cable,
/obj/machinery/atmospherics/components/unary/vent_scrubber/on/layer2{
	dir = 8
	},
/turf/open/floor/wood/tile,
/area/station/commons/fitness/recreation/sauna)
"v" = (
/obj/machinery/button/door/directional/east{
	id = "sauna_priv";
	name = "Tactical Privacy Shutters";
	skin = "-warning";
	icon_state = "button-warning"
	},
/turf/open/floor/wood,
/area/station/commons/fitness/recreation/sauna)
"w" = (
/obj/structure/window/reinforced/tinted/fulltile,
/turf/open/floor/wood,
/area/station/commons/fitness/recreation/sauna)
"x" = (
/obj/machinery/disposal/bin,
/obj/effect/turf_decal/siding/thinplating_new/light{
	dir = 6
	},
/obj/effect/turf_decal/siding/thinplating_new/light/corner{
	dir = 1
	},
/obj/effect/turf_decal/trimline/dark_red/corner{
	dir = 1
	},
/obj/structure/railing{
	dir = 4
	},
/obj/structure/cable,
/obj/structure/disposalpipe/trunk{
	dir = 8
	},
/turf/open/floor/iron/white/herringbone,
/area/station/commons/fitness)
"y" = (
/obj/effect/turf_decal/siding{
	dir = 8
	},
/obj/structure/table/glass,
/obj/item/reagent_containers/cup/glass/colocup{
	pixel_y = 4
	},
/obj/item/clothing/glasses/heat{
	pixel_x = 14;
	pixel_y = 2
	},
/turf/open/floor/iron/white/textured,
/area/station/commons/fitness/recreation/pool)
"z" = (
/turf/open/floor/wood/tile,
/area/station/commons/fitness/recreation/sauna)
"A" = (
/obj/structure/table/wood,
/obj/structure/towel_bin,
/turf/open/floor/wood/tile,
/area/station/commons/fitness/recreation/sauna)
"B" = (
/turf/closed/wall,
/area/station/commons/fitness/recreation/sauna)
"C" = (
/obj/structure/drain,
/obj/machinery/shower/directional/north,
/obj/structure/curtain,
/turf/open/floor/wood/tile,
/area/station/commons/fitness/recreation/sauna)
"D" = (
/obj/effect/turf_decal/siding/thinplating_new/light{
	dir = 10
	},
/obj/effect/turf_decal/siding/thinplating_new/light/corner{
	dir = 4
	},
/obj/effect/turf_decal/trimline/dark_red/corner{
	dir = 4
	},
/obj/structure/disposalpipe/segment{
	dir = 5
	},
/turf/open/floor/iron/white/herringbone,
/area/station/commons/fitness)
"E" = (
/obj/structure/chair/sofa/bamboo/right{
	dir = 8
	},
/turf/open/floor/wood,
/area/station/commons/fitness/recreation/sauna)
"F" = (
/turf/open/floor/wood,
/area/station/commons/fitness/recreation/sauna)
"G" = (
/obj/structure/chair/sofa/bamboo/right{
	dir = 4
	},
/obj/effect/landmark/atmospheric_sanity/ignore_area,
/turf/open/floor/wood,
/area/station/commons/fitness/recreation/sauna)
"H" = (
/turf/closed/wall,
/area/station/maintenance/aft/lesser)
"I" = (
/obj/effect/turf_decal/siding/wideplating_new/light/corner{
	dir = 1
	},
/obj/effect/turf_decal/tile/blue/anticorner/contrasted,
/obj/structure/railing/corner{
	dir = 1
	},
/obj/machinery/atmospherics/pipe/smart/manifold4w/scrubbers/hidden/layer2,
/obj/effect/landmark/navigate_destination/autoname,
/turf/open/floor/iron/white/small,
/area/station/commons/fitness/recreation/pool)
"J" = (
/obj/item/towel,
/obj/item/clothing/under/misc/skyrat/gear_harness,
/obj/structure/closet/secure_closet/personal/wall{
	pixel_y = 32
	},
/obj/item/clothing/shoes/sandal{
	pixel_y = -3
	},
/turf/open/floor/wood/tile,
/area/station/commons/fitness/recreation/sauna)
"K" = (
/obj/effect/turf_decal/siding{
	dir = 1
	},
/obj/effect/turf_decal/trimline/blue,
/obj/structure/chair/stool/bar/directional{
	dir = 1
	},
/obj/effect/landmark/start/hangover,
/obj/machinery/light_switch/directional/east,
/turf/open/floor/iron/white/textured,
/area/station/commons/fitness/recreation/pool)
"L" = (
/obj/structure/chair/sofa/bamboo/left{
	dir = 4
	},
/turf/open/floor/wood,
/area/station/commons/fitness/recreation/sauna)
"O" = (
/obj/machinery/door/firedoor,
/obj/structure/cable,
/obj/machinery/door/airlock/public{
	name = "Sauna"
	},
/obj/structure/disposalpipe/segment,
/turf/open/floor/wood/tile,
/area/station/commons/fitness/recreation/sauna)
"P" = (
/obj/structure/chair/sofa/bamboo/left{
	dir = 8
	},
/turf/open/floor/wood,
/area/station/commons/fitness/recreation/sauna)
"Q" = (
/obj/machinery/light/warm/directional/east,
/turf/template_noop,
/area/template_noop)
"U" = (
/obj/structure/table/glass,
/obj/item/reagent_containers/cup/glass/bottle/beer{
	pixel_y = 7;
	pixel_x = 5
	},
/obj/item/reagent_containers/cup/glass/bottle/beer/light{
	pixel_y = 13;
	pixel_x = -5
	},
/obj/machinery/light/directional/east,
/obj/item/radio/intercom/directional/east,
/turf/open/floor/iron/white/textured,
/area/station/commons/fitness/recreation/pool)
"V" = (
/obj/machinery/atmospherics/pipe/smart/manifold4w/scrubbers/hidden/layer2,
/obj/machinery/atmospherics/components/unary/vent_pump/on/layer4{
	dir = 8
	},
/obj/structure/disposalpipe/segment{
	dir = 4
	},
/obj/structure/cable,
/turf/open/floor/wood/tile,
/area/station/commons/fitness/recreation/sauna)
"W" = (
/obj/structure/mirror/directional/east,
/obj/structure/sink/directional/west,
/obj/structure/cable,
/turf/open/floor/wood/tile,
/area/station/commons/fitness/recreation/sauna)
"X" = (
/obj/structure/chair/sofa/bamboo{
	dir = 8
	},
/turf/open/floor/wood,
/area/station/commons/fitness/recreation/sauna)
"Y" = (
/obj/effect/turf_decal/siding/thinplating_new/light{
	dir = 1
	},
/obj/effect/turf_decal/trimline/dark_red/line{
	dir = 1
	},
/obj/effect/turf_decal/trimline/dark_red/mid_joiner{
	dir = 1
	},
/obj/effect/turf_decal/siding/thinplating_new/light/corner,
/obj/effect/turf_decal/siding/thinplating_new/light/corner{
	dir = 8
	},
/obj/structure/cable,
/obj/structure/disposalpipe/junction/flip{
	dir = 8
	},
/turf/open/floor/iron/white/herringbone,
/area/station/commons/fitness)
"Z" = (
/obj/structure/fans/tiny,
/obj/machinery/door/window/brigdoor/left/directional/north,
/obj/machinery/door/poddoor/shutters/preopen{
	id = "sauna_priv";
	name = "Tactical Privacy Shutter";
	desc = "Heavy duty, airtight mechanical shutters for the most demanding enterprise resource planning."
	},
/turf/open/floor/wood/stairs/down,
/area/station/commons/fitness/recreation/sauna)

(1,1,1) = {"
k
l
y
k
k
k
k
k
k
k
k
"}
(2,1,1) = {"
k
K
U
k
k
k
k
k
k
Q
k
"}
(3,1,1) = {"
I
B
B
q
H
H
H
H
H
H
H
"}
(4,1,1) = {"
r
B
J
e
j
w
t
L
g
G
H
"}
(5,1,1) = {"
D
B
J
V
A
w
F
F
p
o
H
"}
(6,1,1) = {"
Y
O
d
h
z
Z
v
E
X
P
H
"}
(7,1,1) = {"
x
B
J
u
n
B
a
a
a
a
H
"}
(8,1,1) = {"
k
B
s
W
b
C
a
k
k
k
k
"}
(9,1,1) = {"
k
a
a
a
a
a
a
k
k
k
k
"}
