//MAP CONVERTED BY dmm2tgm.py THIS HEADER COMMENT PREVENTS RECONVERSION, DO NOT REMOVE
"ax" = (
/obj/structure/chair/office{
	dir = 1
	},
/obj/effect/landmark/start/blueshield,
/obj/machinery/atmospherics/pipe/smart/manifold4w/scrubbers/hidden/layer2,
/obj/machinery/atmospherics/pipe/smart/manifold4w/supply/hidden/layer4,
/turf/open/floor/carpet/blue,
/area/station/command/heads_quarters/blueshield)
"aH" = (
/obj/structure/cable,
/obj/machinery/power/apc/auto_name/directional/south,
/obj/machinery/light/warm/directional/south,
/obj/machinery/atmospherics/pipe/smart/manifold4w/scrubbers/hidden/layer2,
/obj/machinery/atmospherics/pipe/smart/manifold4w/supply/hidden/layer4,
/turf/open/floor/carpet/blue,
/area/station/command/heads_quarters/blueshield)
"bl" = (
/obj/effect/turf_decal/siding/wood{
	dir = 8
	},
/obj/effect/turf_decal/tile/dark_green/diagonal_centre,
/obj/effect/landmark/start/nanotrasen_consultant,
/turf/open/floor/iron/dark/diagonal,
/area/station/command/heads_quarters/nt_rep)
"cm" = (
/obj/structure/cable,
/turf/open/floor/wood,
/area/station/command/heads_quarters/nt_rep)
"cB" = (
/obj/machinery/door/firedoor,
/obj/structure/cable,
/obj/effect/turf_decal/siding/dark/corner,
/obj/machinery/atmospherics/pipe/smart/manifold4w/supply/hidden/layer4,
/obj/machinery/atmospherics/pipe/smart/manifold4w/scrubbers/hidden/layer2,
/obj/effect/mapping_helpers/airlock/unres/delayed,
/obj/effect/mapping_helpers/airlock/access/any/cent_com/rep_or_captain,
/obj/effect/landmark/navigate_destination/autoname,
/obj/machinery/door/airlock/corporate{
	id_tag = "consultantdoor";
	name = "Consultant's Office"
	},
/obj/machinery/door/poddoor/shutters/preopen{
	id = "nt_rep_priv"
	},
/turf/open/floor/wood,
/area/station/command/heads_quarters/nt_rep)
"dZ" = (
/obj/structure/dresser,
/obj/item/sign/flag/nanotrasen{
	pixel_y = 11
	},
/obj/structure/secure_safe/directional/north,
/turf/open/floor/carpet/green,
/area/station/command/heads_quarters/nt_rep)
"ee" = (
/obj/structure/cable,
/obj/machinery/power/apc/auto_name/directional/south,
/turf/open/floor/wood,
/area/station/command/heads_quarters/nt_rep)
"ey" = (
/turf/open/floor/carpet/green,
/area/station/command/heads_quarters/nt_rep)
"eO" = (
/obj/effect/turf_decal/siding/dark{
	dir = 2;
	icon_state = "siding_plain_end"
	},
/obj/machinery/door/window/brigdoor/right/directional/east{
	name = "Blueshield's Armory";
	req_access = list("captain")
	},
/obj/machinery/light/small/blacklight/directional/west,
/obj/machinery/vending/wallmed/directional/west,
/obj/machinery/suit_storage_unit/blueshield,
/turf/open/floor/engine,
/area/station/command/heads_quarters/blueshield)
"hl" = (
/obj/structure/dresser,
/obj/item/sign/flag/nanotrasen{
	pixel_y = 11
	},
/obj/machinery/computer/security/telescreen/entertainment/directional/north,
/turf/open/floor/carpet/blue,
/area/station/command/heads_quarters/blueshield)
"iu" = (
/obj/machinery/door/firedoor,
/obj/structure/cable,
/obj/machinery/atmospherics/pipe/smart/manifold4w/supply/hidden/layer4,
/obj/machinery/atmospherics/pipe/smart/manifold4w/scrubbers/hidden/layer2,
/obj/effect/mapping_helpers/airlock/access/any/cent_com/rep_or_captain,
/obj/effect/landmark/navigate_destination/autoname,
/obj/machinery/door/airlock/corporate{
	id_tag = "BSdoor";
	name = "Blueshield's Office"
	},
/turf/open/floor/iron/dark/smooth_edge{
	dir = 1
	},
/area/station/command/heads_quarters/blueshield)
"ji" = (
/obj/machinery/atmospherics/pipe/smart/manifold4w/scrubbers/hidden/layer2,
/obj/effect/turf_decal/tile/dark_blue/opposingcorners,
/obj/machinery/photocopier/prebuilt,
/obj/machinery/status_display/ai/directional/north,
/turf/open/floor/iron/dark,
/area/station/command/heads_quarters/blueshield)
"jS" = (
/obj/structure/cable,
/obj/machinery/atmospherics/pipe/smart/manifold4w/supply/hidden/layer4,
/obj/machinery/atmospherics/pipe/smart/manifold4w/scrubbers/hidden/layer2,
/obj/effect/turf_decal/tile/neutral{
	dir = 8
	},
/obj/structure/disposalpipe/segment,
/turf/open/floor/iron,
/area/station/hallway/primary/central)
"kx" = (
/turf/closed/wall/r_wall,
/area/station/command/heads_quarters/blueshield)
"ld" = (
/obj/structure/bed/double,
/obj/item/bedsheet/nanotrasen/double,
/obj/machinery/light/small/blacklight/directional/east,
/obj/machinery/light_switch/directional/north{
	pixel_x = 7
	},
/turf/open/floor/carpet/blue,
/area/station/command/heads_quarters/blueshield)
"lJ" = (
/obj/structure/table/wood,
/obj/item/paper_bin{
	pixel_y = 4;
	pixel_x = -5
	},
/obj/machinery/recharger{
	pixel_x = 7;
	pixel_y = 6
	},
/obj/item/pen/fourcolor{
	pixel_x = -5;
	pixel_y = 5
	},
/obj/structure/cable,
/obj/machinery/atmospherics/pipe/smart/manifold4w/scrubbers/hidden/layer2,
/obj/machinery/atmospherics/pipe/smart/manifold4w/supply/hidden/layer4,
/turf/open/floor/carpet/blue,
/area/station/command/heads_quarters/blueshield)
"mB" = (
/obj/machinery/door/airlock/maintenance,
/obj/machinery/door/poddoor/shutters/preopen{
	id = "nt_rep_priv"
	},
/obj/effect/mapping_helpers/airlock/access/any/cent_com/rep_or_captain,
/turf/open/floor/plating,
/area/station/command/heads_quarters/nt_rep)
"nf" = (
/obj/structure/table/wood,
/obj/effect/turf_decal/siding/wood{
	dir = 4
	},
/obj/item/flashlight/lamp{
	pixel_y = 9;
	pixel_x = -3
	},
/obj/item/lighter/royal,
/obj/effect/mapping_helpers/turn_off_lights_with_lightswitch,
/turf/open/floor/carpet/green,
/area/station/command/heads_quarters/nt_rep)
"nR" = (
/obj/effect/turf_decal/siding/wood/corner{
	dir = 8
	},
/obj/machinery/atmospherics/pipe/smart/manifold4w/scrubbers/hidden/layer2,
/obj/machinery/atmospherics/pipe/smart/manifold4w/supply/hidden/layer4,
/obj/structure/cable,
/turf/open/floor/wood,
/area/station/command/heads_quarters/nt_rep)
"ob" = (
/obj/machinery/door/airlock/corporate{
	name = "Blueshield's Quarters"
	},
/obj/effect/mapping_helpers/airlock/access/all/command/captain,
/obj/effect/turf_decal/tile/dark_blue/opposingcorners,
/obj/machinery/atmospherics/pipe/smart/manifold4w/scrubbers/hidden/layer2,
/obj/machinery/atmospherics/pipe/smart/manifold4w/supply/hidden/layer4,
/obj/machinery/door/firedoor,
/turf/open/floor/iron/dark,
/area/station/command/heads_quarters/blueshield)
"oc" = (
/obj/structure/sign/directions/evac/directional/south{
	dir = 8;
	pixel_y = 10
	},
/obj/structure/sign/directions/dorms/directional/south{
	pixel_y = -10;
	dir = 8
	},
/obj/structure/sign/directions/engineering/directional/south{
	pixel_y = 0
	},
/turf/closed/wall/r_wall,
/area/station/command/heads_quarters/blueshield)
"ot" = (
/obj/effect/turf_decal/siding/wood{
	dir = 4
	},
/obj/structure/table/wood,
/obj/item/paper_bin{
	pixel_y = 4;
	pixel_x = -5
	},
/obj/item/stamp/granted{
	pixel_y = 12;
	pixel_x = 8
	},
/obj/item/stamp/denied{
	pixel_x = 8;
	pixel_y = 6
	},
/obj/item/stamp/centcom{
	pixel_x = 8
	},
/obj/machinery/firealarm/directional/south,
/obj/item/pen/fourcolor{
	pixel_x = -5;
	pixel_y = 5
	},
/obj/item/pen/fountain{
	pixel_x = -5;
	pixel_y = 5
	},
/turf/open/floor/carpet/green,
/area/station/command/heads_quarters/nt_rep)
"oZ" = (
/turf/template_noop,
/area/template_noop)
"po" = (
/obj/effect/turf_decal/tile/dark_blue/opposingcorners,
/obj/effect/landmark/start/blueshield,
/turf/open/floor/iron/dark,
/area/station/command/heads_quarters/blueshield)
"px" = (
/obj/machinery/atmospherics/pipe/smart/manifold4w/scrubbers/hidden/layer2,
/obj/machinery/atmospherics/pipe/smart/manifold4w/supply/hidden/layer4,
/turf/open/floor/carpet/blue,
/area/station/command/heads_quarters/blueshield)
"pA" = (
/obj/machinery/computer/crew{
	dir = 1
	},
/obj/machinery/newscaster/directional/south,
/turf/open/floor/iron/dark,
/area/station/command/heads_quarters/blueshield)
"qk" = (
/obj/structure/chair/office/tactical{
	dir = 4
	},
/obj/effect/landmark/start/nanotrasen_consultant,
/turf/open/floor/carpet/green,
/area/station/command/heads_quarters/nt_rep)
"qz" = (
/obj/structure/bed/double,
/obj/item/bedsheet/centcom/double,
/obj/machinery/light/small/blacklight/directional/east,
/turf/open/floor/carpet/green,
/area/station/command/heads_quarters/nt_rep)
"sb" = (
/obj/structure/closet/secure_closet/nanotrasen_consultant,
/obj/item/clothing/accessory/medal/gold/ordom,
/obj/item/clothing/accessory/medal/silver/bureaucracy,
/obj/item/hand_labeler,
/obj/item/taperecorder{
	name = "Captain's Log"
	},
/obj/structure/sign/flag/galfed/directional/west,
/obj/machinery/light/small/blacklight/directional/west,
/obj/item/storage/box/drinkingglasses,
/obj/item/clothing/accessory/pocketprotector,
/turf/open/floor/carpet/green,
/area/station/command/heads_quarters/nt_rep)
"vk" = (
/obj/structure/chair/office{
	dir = 8
	},
/turf/open/floor/wood,
/area/station/command/heads_quarters/nt_rep)
"vV" = (
/obj/machinery/atmospherics/components/unary/vent_pump/on/layer4{
	dir = 8
	},
/obj/effect/landmark/start/nanotrasen_consultant,
/turf/open/floor/carpet/green,
/area/station/command/heads_quarters/nt_rep)
"vZ" = (
/obj/structure/closet/secure_closet/tac{
	req_access = list("captain")
	},
/obj/item/gun_maintenance_supplies,
/obj/item/clothing/suit/armor/riot,
/obj/item/clothing/head/helmet/toggleable/riot{
	pixel_y = 6
	},
/obj/item/screwdriver,
/obj/item/storage/toolbox/ammobox/wt550m9,
/obj/item/shield/riot,
/obj/effect/turf_decal/siding/dark{
	dir = 1;
	icon_state = "siding_plain_end"
	},
/obj/machinery/door/window/brigdoor/right/directional/east{
	req_access = list("captain");
	name = "Blueshield's Armory"
	},
/obj/machinery/light/small/blacklight/directional/west,
/obj/structure/reagent_dispensers/wall/peppertank/directional/west,
/turf/open/floor/engine,
/area/station/command/heads_quarters/blueshield)
"wj" = (
/obj/machinery/newscaster/directional/west,
/obj/structure/table/wood/fancy/green,
/obj/machinery/computer/security/wooden_tv{
	pixel_y = 10
	},
/obj/item/book/manual/wiki/security_space_law{
	pixel_y = 3;
	pixel_x = 7
	},
/turf/open/floor/carpet/green,
/area/station/command/heads_quarters/nt_rep)
"wC" = (
/obj/structure/cable,
/obj/machinery/holopad,
/obj/structure/table/wood,
/obj/item/modular_computer/laptop/preset/security{
	pixel_y = 5
	},
/obj/item/flashlight/lamp{
	pixel_y = 9;
	pixel_x = -11
	},
/obj/effect/mapping_helpers/turn_off_lights_with_lightswitch,
/obj/machinery/atmospherics/components/unary/vent_pump/on/layer4,
/turf/open/floor/carpet/blue,
/area/station/command/heads_quarters/blueshield)
"xl" = (
/obj/machinery/modular_computer/preset/command{
	dir = 1
	},
/obj/machinery/button/door/directional/south{
	pixel_x = -8;
	id = "nt_rep_priv";
	name = "Privacy Shutters"
	},
/obj/machinery/light_switch/directional/south{
	pixel_y = -30
	},
/obj/machinery/button/curtain{
	id = "nt_rep_priv";
	name = "curtain control";
	pixel_y = -33;
	req_access = list("theatre");
	dir = 4;
	pixel_x = -8
	},
/obj/machinery/camera/directional/south{
	c_tag = "Consultant's Office"
	},
/turf/open/floor/carpet/green,
/area/station/command/heads_quarters/nt_rep)
"xE" = (
/obj/machinery/atmospherics/components/unary/vent_pump/on/layer4,
/obj/effect/turf_decal/tile/dark_green/opposingcorners,
/turf/open/floor/iron/dark,
/area/station/command/heads_quarters/nt_rep)
"xI" = (
/obj/machinery/atmospherics/pipe/smart/manifold4w/supply/hidden/layer4,
/obj/machinery/atmospherics/pipe/smart/manifold4w/scrubbers/hidden/layer2,
/turf/open/floor/wood,
/area/station/command/heads_quarters/nt_rep)
"xX" = (
/obj/structure/closet/secure_closet/blueshield,
/obj/item/taperecorder{
	name = "Captain's Log"
	},
/obj/item/clothing/gloves/tackler/combat/insulated/blueshield,
/obj/machinery/atmospherics/components/unary/vent_pump/on/layer4{
	dir = 1
	},
/obj/machinery/firealarm/directional/east,
/obj/item/storage/medkit/combat_surgeon/stocked,
/obj/item/storage/medkit/regular,
/obj/item/storage/medkit/tactical/blueshield,
/turf/open/floor/wood,
/area/station/command/heads_quarters/blueshield)
"CM" = (
/obj/machinery/holopad,
/obj/effect/turf_decal/bot,
/turf/open/floor/wood,
/area/station/command/heads_quarters/nt_rep)
"Dq" = (
/obj/machinery/photocopier/prebuilt,
/obj/machinery/light/warm/directional/south,
/turf/open/floor/wood,
/area/station/command/heads_quarters/nt_rep)
"Ei" = (
/obj/structure/cable,
/obj/machinery/atmospherics/pipe/smart/manifold4w/scrubbers/hidden/layer2,
/obj/machinery/atmospherics/pipe/smart/manifold4w/supply/hidden/layer4,
/obj/effect/turf_decal/tile/dark_blue/opposingcorners,
/turf/open/floor/iron/dark,
/area/station/command/heads_quarters/blueshield)
"EK" = (
/obj/structure/safe/abovetilefloor,
/obj/item/storage/medkit/tactical/blueshield,
/obj/item/reagent_containers/cup/glass/flask{
	pixel_y = -2;
	pixel_x = 2
	},
/obj/item/toy/figure/captain,
/obj/item/storage/fancy/cigarettes/cigars,
/obj/item/storage/box/matches,
/obj/item/reagent_containers/cup/glass/bottle/lizardwine,
/obj/item/paperwork/captain{
	pixel_x = -3;
	pixel_y = 4;
	name = "Asset Protection case records";
	desc = "A messily compiled stack of DAP records, containing incident reports, asset recovery briefings and classified paramilitary activities, with substantial portions censored and redacted. You probably shouldn't be reading this, unless you yearn for a one-way trip to Space Guantanamo."
	},
/obj/item/toy/plush/skyrat/fox/mia{
	desc = "A cute, marketable version of one of the DAP's mascots, Vigilant the fox. She has a blue collar with a shield-shaped tag that reads DAP. Holding her makes you feel protected.";
	name = "Vigilant plushie"
	},
/obj/item/storage/fancy/donut_box,
/turf/open/floor/carpet/blue,
/area/station/command/heads_quarters/blueshield)
"EX" = (
/obj/machinery/modular_computer/preset/command{
	dir = 1
	},
/obj/machinery/requests_console/auto_name/directional/south,
/obj/effect/mapping_helpers/requests_console/information,
/obj/effect/mapping_helpers/requests_console/supplies,
/obj/effect/mapping_helpers/requests_console/assistance,
/obj/effect/mapping_helpers/requests_console/announcement,
/turf/open/floor/iron/dark,
/area/station/command/heads_quarters/blueshield)
"Fk" = (
/obj/effect/turf_decal/tile/neutral{
	dir = 8
	},
/obj/structure/cable,
/obj/machinery/atmospherics/pipe/smart/manifold4w/supply/hidden/layer4,
/obj/machinery/atmospherics/pipe/smart/manifold4w/scrubbers/hidden/layer2,
/obj/structure/disposalpipe/segment,
/turf/open/floor/iron,
/area/station/hallway/primary/central)
"FQ" = (
/obj/structure/table/wood/fancy/blue,
/obj/item/toy/plush/lizard_plushie/greyscale{
	name = "Hunts-the-Traitor";
	desc = "The Blueshield's best friend, a little too eager to go after criminals and evil-doers alike. He's grounded forever.";
	greyscale_colors = "#FF0000#000000";
	pixel_x = 4;
	pixel_y = 9
	},
/obj/item/reagent_containers/cup/glass/trophy{
	desc = "You did good in the worst way possible.";
	name = "Redshield 1st prize";
	pixel_y = 14;
	pixel_x = -8
	},
/obj/structure/sign/plaques/kiddie/perfect_man{
	pixel_y = -32
	},
/obj/machinery/light/warm/directional/south,
/obj/machinery/atmospherics/components/unary/vent_scrubber/on/layer2{
	dir = 1
	},
/turf/open/floor/wood,
/area/station/command/heads_quarters/blueshield)
"Ga" = (
/obj/structure/flora/bush/grassy,
/obj/structure/flora/bush/flowers_pp,
/obj/structure/curtain/cloth/fancy/mechanical{
	icon_state = "bounty-open";
	icon_type = "bounty";
	id = "nt_rep_priv";
	name = "curtain"
	},
/obj/structure/window/reinforced/fulltile,
/obj/structure/cable,
/turf/open/floor/grass,
/area/station/command/heads_quarters/nt_rep)
"GG" = (
/obj/machinery/atmospherics/pipe/smart/manifold4w/supply/hidden/layer4,
/obj/machinery/atmospherics/pipe/smart/manifold4w/scrubbers/hidden/layer2,
/obj/machinery/airalarm/directional/north,
/turf/open/floor/wood,
/area/station/command/heads_quarters/nt_rep)
"GY" = (
/obj/effect/landmark/start/blueshield,
/obj/machinery/atmospherics/pipe/smart/manifold4w/supply/hidden/layer4,
/turf/open/floor/wood,
/area/station/command/heads_quarters/blueshield)
"It" = (
/obj/effect/turf_decal/tile/dark_blue/opposingcorners,
/obj/machinery/airalarm/directional/south,
/obj/machinery/camera/directional/south{
	c_tag = "Blueshield's Office"
	},
/turf/open/floor/iron/dark,
/area/station/command/heads_quarters/blueshield)
"IG" = (
/obj/machinery/computer/station_goal{
	dir = 1
	},
/obj/machinery/requests_console/auto_name/directional/south,
/obj/effect/mapping_helpers/requests_console/information,
/obj/effect/mapping_helpers/requests_console/supplies,
/obj/effect/mapping_helpers/requests_console/assistance,
/obj/effect/mapping_helpers/requests_console/announcement,
/obj/machinery/newscaster/directional/west,
/turf/open/floor/carpet/green,
/area/station/command/heads_quarters/nt_rep)
"Jr" = (
/obj/machinery/atmospherics/pipe/smart/manifold4w/supply/hidden/layer4,
/obj/machinery/atmospherics/pipe/smart/manifold4w/scrubbers/hidden/layer2,
/turf/open/floor/carpet/green,
/area/station/command/heads_quarters/nt_rep)
"Kc" = (
/obj/structure/cable,
/obj/machinery/atmospherics/pipe/smart/manifold4w/supply/hidden/layer4,
/obj/machinery/atmospherics/pipe/smart/manifold4w/scrubbers/hidden/layer2,
/obj/structure/disposalpipe/segment,
/obj/effect/turf_decal/tile/neutral{
	dir = 8
	},
/obj/structure/disposalpipe/segment{
	dir = 5
	},
/turf/open/floor/iron,
/area/station/hallway/primary/central)
"Kt" = (
/obj/structure/table/wood/fancy/green,
/obj/machinery/chem_dispenser/drinks{
	dir = 8
	},
/obj/effect/turf_decal/tile/dark_green/diagonal_centre,
/turf/open/floor/iron/dark/diagonal,
/area/station/command/heads_quarters/nt_rep)
"MK" = (
/obj/structure/table/wood,
/obj/machinery/fax{
	fax_name = "Nanotrasen Consultant's Office";
	name = "Nanotrasen Consultant's Fax Machine"
	},
/obj/item/radio/intercom/command/directional/west,
/turf/open/floor/carpet/green,
/area/station/command/heads_quarters/nt_rep)
"Nk" = (
/obj/machinery/atmospherics/pipe/smart/manifold4w/scrubbers/hidden/layer2,
/obj/effect/turf_decal/tile/dark_blue/opposingcorners,
/obj/machinery/light/warm/directional/north,
/obj/machinery/holopad,
/obj/effect/turf_decal/bot,
/turf/open/floor/iron/dark,
/area/station/command/heads_quarters/blueshield)
"ND" = (
/obj/machinery/vending/boozeomat,
/turf/closed/wall/r_wall,
/area/station/command/heads_quarters/nt_rep)
"NZ" = (
/obj/effect/turf_decal/tile/dark_blue/opposingcorners,
/obj/machinery/light_switch/directional/north{
	pixel_x = 8;
	pixel_y = 31
	},
/obj/structure/sign/poster/official/nanotrasen_logo/directional/west,
/obj/machinery/firealarm/directional/north,
/turf/open/floor/iron/dark,
/area/station/command/heads_quarters/blueshield)
"Or" = (
/obj/machinery/atmospherics/pipe/smart/manifold4w/scrubbers/hidden/layer2,
/obj/machinery/atmospherics/pipe/smart/manifold4w/supply/hidden/layer4,
/turf/open/floor/wood,
/area/station/command/heads_quarters/blueshield)
"Oz" = (
/obj/structure/filingcabinet/medical{
	pixel_x = -10
	},
/obj/structure/filingcabinet/employment,
/obj/structure/filingcabinet/security{
	pixel_x = 10
	},
/obj/machinery/light_switch/directional/west,
/turf/open/floor/carpet/green,
/area/station/command/heads_quarters/nt_rep)
"OU" = (
/obj/structure/cable,
/obj/machinery/atmospherics/components/unary/vent_scrubber/on/layer2{
	dir = 1
	},
/obj/structure/table/wood,
/obj/machinery/fax{
	name = "Blueshield's Fax Machine";
	fax_name = "Blueshield's Office"
	},
/obj/item/radio/intercom/directional/east,
/turf/open/floor/carpet/blue,
/area/station/command/heads_quarters/blueshield)
"OV" = (
/obj/machinery/status_display/evac/directional/west,
/obj/structure/cable,
/obj/machinery/atmospherics/pipe/smart/manifold4w/supply/hidden/layer4,
/obj/machinery/atmospherics/pipe/smart/manifold4w/scrubbers/hidden/layer2,
/obj/structure/disposalpipe/segment,
/turf/open/floor/iron,
/area/station/hallway/primary/central)
"Pa" = (
/obj/machinery/light/warm/directional/north,
/obj/machinery/newscaster/directional/north,
/obj/effect/turf_decal/tile/dark_green/opposingcorners,
/turf/open/floor/iron/dark,
/area/station/command/heads_quarters/nt_rep)
"PR" = (
/obj/effect/turf_decal/siding/wood{
	dir = 8
	},
/obj/effect/turf_decal/tile/dark_green/diagonal_centre,
/turf/open/floor/iron/dark/diagonal,
/area/station/command/heads_quarters/nt_rep)
"QM" = (
/obj/structure/safe/abovetilefloor,
/obj/item/toy/figure/dsquad,
/obj/item/storage/toolbox/guncase/skyrat/pistol/sec_glock,
/obj/item/folder/documents,
/obj/item/paperwork{
	desc = "A densely compiled stack of Internal Affairs records, documenting various investigations, audits and disciplinary proceedings, extensively redacted under CENTCOM authority.";
	name = "internal affairs records"
	},
/obj/item/reagent_containers/cup/glass/bottle/lizardwine,
/obj/machinery/light_switch/directional/north,
/turf/open/floor/carpet/green,
/area/station/command/heads_quarters/nt_rep)
"RJ" = (
/obj/item/toy/plush/horse,
/obj/structure/broken_flooring/singular/directional/north{
	color = "#73737a"
	},
/turf/open/floor/plating,
/area/station/command/heads_quarters/blueshield)
"RR" = (
/turf/closed/wall/r_wall,
/area/station/command/heads_quarters/nt_rep)
"Sd" = (
/obj/structure/filingcabinet{
	pixel_x = -10
	},
/obj/structure/grandfatherclock{
	pixel_x = 7
	},
/obj/item/reagent_containers/cup/glass/bottle/whiskey,
/obj/item/cigarette/cigar/cohiba,
/turf/open/floor/wood,
/area/station/command/heads_quarters/nt_rep)
"Sv" = (
/obj/machinery/door/firedoor,
/obj/effect/mapping_helpers/airlock/access/all/cent_com/rep_door,
/obj/effect/mapping_helpers/airlock/unres/delayed{
	dir = 1
	},
/obj/machinery/atmospherics/pipe/smart/manifold4w/supply/hidden/layer4,
/obj/machinery/atmospherics/pipe/smart/manifold4w/scrubbers/hidden/layer2,
/obj/machinery/door/airlock/corporate{
	name = "Representative's Quarters";
	id_tag = "repdo"
	},
/turf/open/floor/carpet/green,
/area/station/command/heads_quarters/nt_rep)
"SQ" = (
/obj/structure/table/wood/fancy/green,
/obj/machinery/chem_dispenser/drinks/beer{
	dir = 8
	},
/obj/effect/turf_decal/tile/dark_green/diagonal_centre,
/turf/open/floor/iron/dark/diagonal,
/area/station/command/heads_quarters/nt_rep)
"SX" = (
/obj/effect/landmark/start/blueshield,
/turf/open/floor/carpet/blue,
/area/station/command/heads_quarters/blueshield)
"Tj" = (
/obj/machinery/airalarm/directional/north,
/obj/effect/turf_decal/tile/dark_green/opposingcorners,
/turf/open/floor/iron/dark,
/area/station/command/heads_quarters/nt_rep)
"Xc" = (
/obj/machinery/atmospherics/pipe/smart/manifold4w/supply/hidden/layer4,
/obj/machinery/atmospherics/pipe/smart/manifold4w/scrubbers/hidden/layer2,
/obj/effect/turf_decal/siding/wood{
	dir = 4
	},
/turf/open/floor/carpet/green,
/area/station/command/heads_quarters/nt_rep)
"Xm" = (
/obj/effect/turf_decal/tile/dark_blue/opposingcorners,
/turf/closed/wall/r_wall,
/area/station/command/heads_quarters/blueshield)
"XE" = (
/obj/machinery/atmospherics/pipe/smart/manifold4w/supply/hidden/layer4,
/obj/machinery/atmospherics/pipe/smart/manifold4w/scrubbers/hidden/layer2,
/obj/effect/turf_decal/tile/dark_green/opposingcorners,
/turf/open/floor/iron/dark,
/area/station/command/heads_quarters/nt_rep)
"Yc" = (
/obj/machinery/atmospherics/components/unary/vent_scrubber/on/layer2,
/obj/machinery/firealarm/directional/north,
/turf/open/floor/carpet/green,
/area/station/command/heads_quarters/nt_rep)

(1,1,1) = {"
oZ
RR
RR
RR
RR
mB
RR
RR
RR
oZ
oZ
oZ
oZ
oZ
"}
(2,1,1) = {"
oZ
RR
wj
sb
RR
Tj
Oz
MK
RR
RR
oZ
oZ
oZ
oZ
"}
(3,1,1) = {"
oZ
RR
Yc
Jr
Sv
XE
Jr
ey
IG
RR
oZ
oZ
oZ
oZ
"}
(4,1,1) = {"
oZ
RR
QM
vV
RR
Pa
Jr
qk
xl
RR
oZ
oZ
oZ
oZ
"}
(5,1,1) = {"
oZ
RR
dZ
qz
ND
xE
Xc
nf
ot
RR
oZ
oZ
oZ
oZ
"}
(6,1,1) = {"
oZ
RR
RR
RR
RR
RR
GG
vk
Dq
RR
RR
oZ
oZ
oZ
"}
(7,1,1) = {"
oZ
OV
jS
Fk
Kc
Ga
xI
CM
Sd
RR
RR
oZ
oZ
oZ
"}
(8,1,1) = {"
oZ
oZ
oZ
oZ
oZ
cB
nR
cm
ee
RR
RR
kx
oZ
oZ
"}
(9,1,1) = {"
oZ
oZ
oZ
oZ
oZ
Ga
Ga
bl
PR
RR
RJ
kx
oZ
oZ
"}
(10,1,1) = {"
oZ
oZ
oZ
oZ
oZ
oZ
Ga
Kt
SQ
RR
kx
kx
kx
oZ
"}
(11,1,1) = {"
oZ
oZ
oZ
oZ
oZ
oZ
kx
kx
kx
kx
vZ
eO
kx
oZ
"}
(12,1,1) = {"
oZ
oZ
oZ
oZ
oZ
oZ
oZ
kx
kx
NZ
po
It
kx
oZ
"}
(13,1,1) = {"
oZ
oZ
oZ
oZ
oZ
oZ
oZ
iu
Ei
Ei
lJ
aH
kx
kx
"}
(14,1,1) = {"
oZ
oZ
oZ
oZ
oZ
oZ
oZ
kx
kx
Nk
wC
ax
EX
kx
"}
(15,1,1) = {"
oZ
oZ
oZ
oZ
oZ
oZ
oZ
oZ
kx
ji
OU
px
pA
kx
"}
(16,1,1) = {"
oZ
oZ
oZ
oZ
oZ
oZ
oZ
oZ
kx
kx
Xm
ob
kx
kx
"}
(17,1,1) = {"
oZ
oZ
oZ
oZ
oZ
oZ
oZ
oZ
kx
hl
EK
Or
FQ
kx
"}
(18,1,1) = {"
oZ
oZ
oZ
oZ
oZ
oZ
oZ
oZ
kx
ld
SX
GY
xX
kx
"}
(19,1,1) = {"
oZ
oZ
oZ
oZ
oZ
oZ
oZ
oZ
oc
kx
kx
kx
kx
kx
"}
