//MAP CONVERTED BY dmm2tgm.py THIS HEADER COMMENT PREVENTS RECONVERSION, DO NOT REMOVE
"bc" = (
/obj/machinery/door/airlock/external/glass{
	name = "Engineering External Access"
	},
/obj/effect/mapping_helpers/airlock/cyclelink_helper{
	dir = 8
	},
/obj/effect/mapping_helpers/airlock/access/all/engineering/general,
/turf/open/floor/plating,
/area/station/commons/dock/aux)
"bx" = (
/obj/structure/lattice/catwalk,
/obj/structure/railing{
	dir = 1
	},
/obj/structure/marker_beacon/yellow,
/obj/structure/railing,
/turf/open/space/basic,
/area/space/nearstation)
"by" = (
/obj/structure/cable,
/obj/effect/mapping_helpers/broken_floor,
/obj/machinery/atmospherics/pipe/smart/manifold4w/scrubbers/hidden/layer2,
/obj/machinery/atmospherics/pipe/smart/manifold4w/supply/hidden/layer4,
/obj/structure/disposalpipe/segment{
	dir = 4
	},
/turf/open/floor/plating,
/area/station/maintenance/aft/lesser)
"co" = (
/obj/structure/cable,
/obj/effect/decal/cleanable/dirt,
/obj/effect/spawner/random/maintenance,
/obj/machinery/atmospherics/pipe/smart/manifold4w/scrubbers/hidden/layer2,
/obj/machinery/atmospherics/pipe/smart/manifold4w/supply/hidden/layer4,
/obj/structure/disposalpipe/segment{
	dir = 4
	},
/turf/open/floor/plating,
/area/station/maintenance/aft/lesser)
"ct" = (
/obj/structure/window/reinforced/spawner/directional/east,
/obj/structure/lattice,
/turf/open/space/basic,
/area/space/nearstation)
"gp" = (
/obj/machinery/vending/dorms,
/obj/effect/turf_decal/bot_white,
/turf/open/floor/iron/dark/textured,
/area/station/maintenance/aft/lesser)
"gv" = (
/obj/structure/closet/firecloset/wall,
/turf/closed/wall,
/area/station/maintenance/aft/lesser)
"ho" = (
/obj/effect/turf_decal/siding/thinplating_new/dark{
	dir = 4
	},
/obj/effect/decal/cleanable/dirt/dust,
/obj/machinery/atmospherics/components/unary/vent_pump/on/layer4{
	dir = 4
	},
/turf/open/floor/iron/dark/side{
	dir = 8
	},
/area/station/maintenance/aft/lesser)
"hT" = (
/obj/machinery/door/airlock/external/glass{
	name = "Engineering External Access"
	},
/obj/effect/mapping_helpers/airlock/cyclelink_helper{
	dir = 4
	},
/obj/effect/mapping_helpers/airlock/access/all/engineering/general,
/turf/open/floor/plating,
/area/station/commons/dock/aux)
"ic" = (
/obj/effect/turf_decal/siding/thinplating_new/dark,
/obj/effect/landmark/event_spawn,
/obj/effect/landmark/generic_maintenance_landmark,
/obj/effect/landmark/blobstart,
/turf/open/floor/iron/dark/textured,
/area/station/commons/dock/aux)
"je" = (
/obj/structure/cable,
/obj/machinery/atmospherics/pipe/smart/manifold4w/supply/hidden/layer4,
/obj/machinery/atmospherics/pipe/smart/manifold4w/scrubbers/hidden/layer2,
/obj/machinery/door/airlock/public/glass{
	name = "Auxiliary Ship Dock"
	},
/obj/machinery/door/firedoor,
/turf/open/floor/iron/dark/textured,
/area/station/commons/fitness/recreation)
"kk" = (
/obj/machinery/digital_clock/directional/north,
/obj/structure/cable,
/obj/machinery/atmospherics/pipe/smart/manifold4w/scrubbers/hidden/layer2,
/obj/machinery/atmospherics/pipe/smart/manifold4w/supply/hidden/layer4,
/obj/structure/disposalpipe/junction/flip{
	dir = 8
	},
/obj/effect/turf_decal/siding/thinplating_new/dark{
	dir = 1
	},
/turf/open/floor/iron/dark/textured,
/area/station/commons/dock/aux)
"kx" = (
/obj/effect/turf_decal/siding/thinplating_new/dark{
	dir = 6
	},
/obj/effect/landmark/start/assistant,
/turf/open/floor/iron/dark/textured,
/area/station/commons/dock/aux)
"kD" = (
/turf/open/floor/engine/hull/reinforced,
/area/space/nearstation)
"kM" = (
/obj/structure/window/reinforced/spawner/directional/west,
/turf/open/floor/glass/reinforced,
/area/station/commons/dock/aux)
"kT" = (
/obj/effect/turf_decal/stripes/white/end{
	dir = 4
	},
/obj/effect/turf_decal/siding/thinplating/dark/end{
	dir = 4
	},
/turf/open/floor/engine/hull/reinforced,
/area/space/nearstation)
"lf" = (
/obj/structure/flora/bush/fullgrass,
/obj/structure/flora/bush/grassy/style_random,
/obj/structure/flora/bush/flowers_br/style_2,
/obj/structure/marker_beacon/lime,
/obj/machinery/computer/security/telescreen/entertainment/directional/north,
/obj/structure/railing{
	dir = 10
	},
/obj/machinery/camera/autoname/directional/north,
/turf/open/floor/grass,
/area/station/commons/dock/aux)
"lp" = (
/obj/machinery/atmospherics/pipe/smart/manifold4w/scrubbers/hidden/layer2,
/obj/machinery/atmospherics/pipe/smart/manifold4w/supply/hidden/layer4,
/obj/structure/cable,
/obj/structure/disposalpipe/segment{
	dir = 9
	},
/obj/effect/turf_decal/stripes/line,
/obj/effect/turf_decal/siding/thinplating_new/dark{
	dir = 8
	},
/turf/open/floor/iron/dark/textured,
/area/station/commons/dock/aux)
"lw" = (
/obj/structure/disposalpipe/segment,
/obj/effect/turf_decal/siding/thinplating_new/dark,
/turf/open/floor/iron/dark/textured,
/area/station/commons/dock/aux)
"na" = (
/obj/structure/chair/sofa/bench/left{
	dir = 1
	},
/obj/effect/landmark/start/hangover,
/obj/effect/landmark/start/assistant,
/turf/open/floor/glass/reinforced,
/area/station/commons/dock/aux)
"nz" = (
/obj/structure/disposalpipe/segment,
/obj/effect/turf_decal/siding/thinplating_new/dark{
	dir = 8
	},
/obj/machinery/atmospherics/components/unary/vent_scrubber/on/layer2{
	dir = 4
	},
/obj/machinery/light/dim/directional/west,
/obj/machinery/firealarm/directional/west,
/turf/open/floor/iron/dark/textured,
/area/station/commons/dock/aux)
"nY" = (
/obj/structure/lattice,
/turf/open/space/basic,
/area/space/nearstation)
"ok" = (
/obj/structure/disposalpipe/segment,
/obj/machinery/airalarm/directional/west,
/obj/effect/turf_decal/siding/thinplating_new/dark{
	dir = 8
	},
/obj/effect/landmark/event_spawn,
/obj/effect/landmark/generic_maintenance_landmark,
/turf/open/floor/iron/dark/textured,
/area/station/commons/dock/aux)
"ou" = (
/obj/effect/turf_decal/siding/thinplating_new/dark{
	dir = 4
	},
/obj/effect/turf_decal/trimline/dark_green/corner{
	dir = 4
	},
/obj/structure/sign/warning/vacuum/external/directional/east,
/obj/effect/turf_decal/stripes/corner,
/obj/machinery/atmospherics/pipe/smart/manifold4w/supply/hidden/layer4,
/obj/machinery/atmospherics/pipe/smart/manifold4w/scrubbers/hidden/layer2,
/obj/structure/cable,
/turf/open/floor/iron/dark/textured,
/area/station/commons/dock/aux)
"oL" = (
/obj/structure/disposalpipe/trunk{
	dir = 1
	},
/obj/machinery/disposal/bin,
/obj/effect/turf_decal/delivery,
/turf/open/floor/iron/dark/textured,
/area/station/commons/dock/aux)
"pn" = (
/obj/effect/turf_decal/stripes/white/corner,
/obj/effect/turf_decal/siding/thinplating/dark/corner,
/turf/open/floor/engine/hull/reinforced,
/area/space/nearstation)
"pD" = (
/obj/structure/cable,
/obj/machinery/atmospherics/pipe/smart/manifold4w/scrubbers/hidden/layer2,
/obj/machinery/atmospherics/pipe/smart/manifold4w/supply/hidden/layer4,
/obj/structure/disposalpipe/segment{
	dir = 4
	},
/obj/machinery/holopad,
/obj/effect/turf_decal/bot,
/obj/effect/turf_decal/siding/thinplating_new/dark/corner{
	dir = 4
	},
/turf/open/floor/iron/dark/textured,
/area/station/commons/dock/aux)
"pN" = (
/obj/effect/turf_decal/bot_white,
/obj/effect/spawner/random/engineering/atmospherics_portable,
/obj/effect/decal/cleanable/dirt/dust,
/turf/open/floor/iron/dark/textured_large,
/area/station/maintenance/aft/lesser)
"qC" = (
/obj/effect/spawner/structure/window/reinforced,
/turf/open/floor/plating,
/area/station/commons/dock/aux)
"qH" = (
/turf/open/floor/glass/reinforced,
/area/space/nearstation)
"qK" = (
/obj/structure/window/reinforced/spawner/directional/south,
/obj/structure/window/reinforced/spawner/directional/east,
/obj/structure/window/reinforced/spawner/directional/west,
/obj/structure/flora/bush/sparsegrass/style_3,
/obj/structure/flora/grass/jungle/a/style_3,
/obj/structure/flora/bush/flowers_br,
/obj/structure/flora/bush/ferny/style_random,
/obj/structure/marker_beacon/lime,
/turf/open/floor/grass,
/area/station/commons/dock/aux)
"qW" = (
/obj/structure/cable,
/obj/machinery/atmospherics/pipe/smart/manifold4w/scrubbers/hidden/layer2,
/obj/machinery/atmospherics/pipe/smart/manifold4w/supply/hidden/layer4,
/obj/structure/disposalpipe/segment{
	dir = 4
	},
/obj/effect/turf_decal/siding/thinplating_new/dark{
	dir = 1
	},
/obj/item/radio/intercom/directional/north,
/obj/machinery/camera/autoname/directional/north,
/turf/open/floor/iron/dark/textured,
/area/station/commons/dock/aux)
"rk" = (
/obj/structure/disposalpipe/segment,
/obj/machinery/door/airlock/public/glass{
	name = "Auxiliary Ship Dock"
	},
/obj/machinery/door/firedoor,
/turf/open/floor/iron/dark/textured,
/area/station/commons/fitness/recreation)
"st" = (
/obj/structure/curtain,
/obj/machinery/shower/directional/south,
/obj/effect/decal/cleanable/dirt,
/obj/structure/drain,
/turf/open/floor/noslip/tram{
	name = "shower tile";
	color = "#6e9eb4"
	},
/area/station/commons/dock/aux)
"su" = (
/obj/structure/toilet{
	dir = 8;
	pixel_x = 5
	},
/obj/machinery/light/small/dim/directional/north,
/obj/effect/decal/cleanable/dirt,
/obj/machinery/atmospherics/components/unary/vent_pump/on/layer4,
/obj/machinery/button/door/directional/north{
	normaldoorcontrol = 1;
	specialfunctions = 4;
	name = "Toilet Lock";
	id = "ToiletAux"
	},
/obj/effect/landmark/start/hangover,
/turf/open/floor/iron/showroomfloor,
/area/station/commons/dock/aux)
"sy" = (
/obj/effect/turf_decal/stripes/white/line,
/obj/effect/turf_decal/siding/thinplating/dark,
/turf/open/floor/engine/hull/reinforced,
/area/space/nearstation)
"tK" = (
/obj/structure/cable,
/obj/machinery/door/airlock/maintenance{
	name = "Engineering Maintenance"
	},
/obj/machinery/atmospherics/pipe/smart/manifold4w/scrubbers/hidden/layer2,
/obj/machinery/atmospherics/pipe/smart/manifold4w/supply/hidden/layer4,
/obj/structure/disposalpipe/segment,
/obj/effect/mapping_helpers/airlock/access/all/engineering/maintenance,
/turf/open/floor/iron/dark/textured_large,
/area/station/maintenance/aft/lesser)
"ud" = (
/obj/effect/turf_decal/bot_white,
/obj/effect/decal/cleanable/dirt/dust,
/obj/effect/landmark/start/assistant,
/turf/open/floor/iron/dark/textured_large,
/area/station/maintenance/aft/lesser)
"uf" = (
/obj/effect/turf_decal/stripes/white/corner{
	dir = 8
	},
/obj/effect/turf_decal/siding/thinplating/dark/corner{
	dir = 8
	},
/turf/open/floor/engine/hull/reinforced,
/area/space/nearstation)
"uD" = (
/obj/structure/cable,
/obj/machinery/atmospherics/pipe/smart/manifold4w/scrubbers/hidden/layer2,
/obj/machinery/atmospherics/pipe/smart/manifold4w/supply/hidden/layer4,
/obj/structure/disposalpipe/segment{
	dir = 4
	},
/obj/effect/turf_decal/siding/thinplating_new/dark{
	dir = 1
	},
/turf/open/floor/iron/dark/textured,
/area/station/commons/dock/aux)
"uF" = (
/obj/structure/cable,
/obj/machinery/atmospherics/pipe/smart/manifold4w/scrubbers/hidden/layer2,
/obj/machinery/atmospherics/pipe/smart/manifold4w/supply/hidden/layer4,
/obj/structure/disposalpipe/segment{
	dir = 4
	},
/turf/open/floor/iron/dark/textured,
/area/station/maintenance/aft/lesser)
"uZ" = (
/obj/structure/cable,
/obj/structure/broken_flooring/pile/directional/east{
	color = "#73737a"
	},
/obj/machinery/atmospherics/pipe/smart/manifold4w/scrubbers/hidden/layer2,
/obj/machinery/atmospherics/pipe/smart/manifold4w/supply/hidden/layer4,
/obj/structure/disposalpipe/segment{
	dir = 4
	},
/turf/open/floor/plating,
/area/station/maintenance/aft/lesser)
"vn" = (
/obj/structure/disposalpipe/segment{
	dir = 9
	},
/obj/machinery/atmospherics/pipe/smart/manifold4w/scrubbers/hidden/layer2,
/obj/machinery/atmospherics/pipe/smart/manifold4w/supply/hidden/layer4,
/obj/structure/cable,
/obj/effect/turf_decal/siding/thinplating_new/dark{
	dir = 5
	},
/obj/effect/landmark/start/assistant,
/turf/open/floor/iron/dark/textured,
/area/station/commons/dock/aux)
"wH" = (
/obj/structure/disposalpipe/segment,
/obj/effect/turf_decal/siding/thinplating_new/dark{
	dir = 9
	},
/obj/machinery/power/apc/auto_name/directional/west,
/obj/structure/cable,
/turf/open/floor/iron/dark/textured,
/area/station/commons/dock/aux)
"wX" = (
/turf/closed/wall,
/area/station/commons/dock/aux)
"xc" = (
/obj/machinery/door/airlock/public/glass{
	name = "Auxiliary Ship Dock"
	},
/obj/effect/turf_decal/stripes/corner,
/obj/machinery/atmospherics/pipe/smart/manifold4w/scrubbers/hidden/layer2,
/obj/machinery/atmospherics/pipe/smart/manifold4w/supply/hidden/layer4,
/obj/structure/cable,
/obj/structure/disposalpipe/segment{
	dir = 4
	},
/turf/open/floor/iron/dark/textured,
/area/station/commons/dock/aux)
"xk" = (
/obj/machinery/atmospherics/pipe/smart/manifold4w/scrubbers/hidden/layer2,
/obj/machinery/atmospherics/pipe/smart/manifold4w/supply/hidden/layer4,
/obj/structure/cable,
/obj/effect/turf_decal/siding/thinplating_new/dark{
	dir = 4
	},
/obj/effect/turf_decal/trimline/dark_green/corner{
	dir = 4
	},
/obj/effect/turf_decal/trimline/dark_green/corner,
/turf/open/floor/iron/dark/textured,
/area/station/commons/dock/aux)
"xq" = (
/turf/open/space/basic,
/area/space)
"yd" = (
/obj/effect/turf_decal/siding/thinplating_new/dark{
	dir = 8
	},
/obj/structure/disposalpipe/segment,
/obj/machinery/newscaster/directional/west,
/turf/open/floor/iron/dark/textured,
/area/station/commons/dock/aux)
"yM" = (
/obj/structure/chair/sofa/bench/right{
	dir = 1
	},
/obj/effect/landmark/start/hangover,
/obj/effect/landmark/start/assistant,
/turf/open/floor/glass/reinforced,
/area/station/commons/dock/aux)
"yV" = (
/turf/closed/wall,
/area/station/commons/fitness/recreation)
"zp" = (
/obj/structure/cable,
/obj/machinery/atmospherics/pipe/smart/manifold4w/scrubbers/hidden/layer2,
/obj/machinery/atmospherics/pipe/smart/manifold4w/supply/hidden/layer4,
/obj/effect/turf_decal/siding/thinplating_new/dark{
	dir = 4
	},
/turf/open/floor/iron/dark/textured,
/area/station/commons/dock/aux)
"zM" = (
/obj/structure/disposalpipe/segment,
/obj/effect/turf_decal/siding/thinplating_new/dark{
	dir = 8
	},
/obj/machinery/atmospherics/components/unary/vent_pump/on/layer4{
	dir = 4
	},
/turf/open/floor/iron/dark/textured,
/area/station/commons/dock/aux)
"Ah" = (
/turf/closed/wall/r_wall,
/area/station/maintenance/aft/lesser)
"As" = (
/obj/effect/turf_decal/siding/thinplating_new/dark,
/obj/effect/landmark/navigate_destination/dockaux,
/turf/open/floor/iron/dark/textured,
/area/station/commons/dock/aux)
"AM" = (
/obj/structure/disposalpipe/segment,
/obj/effect/turf_decal/siding/thinplating_new/dark{
	dir = 8
	},
/obj/structure/sign/poster/contraband/random/directional/west,
/turf/open/floor/iron/dark/textured,
/area/station/commons/dock/aux)
"Ch" = (
/obj/machinery/door/airlock/silver{
	name = "Bathroom/Shower";
	id_tag = "ToiletAux"
	},
/obj/effect/decal/cleanable/dirt,
/obj/machinery/atmospherics/pipe/smart/manifold4w/supply/hidden/layer4,
/obj/machinery/atmospherics/pipe/smart/manifold4w/scrubbers/hidden/layer2,
/turf/open/floor/iron/showroomfloor,
/area/station/commons/dock/aux)
"Ci" = (
/obj/structure/fans/tiny,
/obj/effect/turf_decal/trimline/dark_blue,
/obj/machinery/door/airlock/external/glass{
	name = "Auxiliary Ship Dock"
	},
/obj/effect/mapping_helpers/airlock/cyclelink_helper_multi{
	cycle_id = "ferry_upper"
	},
/turf/open/floor/iron/dark/textured_large,
/area/station/commons/dock/aux)
"Cr" = (
/obj/structure/lattice/catwalk,
/obj/structure/marker_beacon/cerulean,
/turf/open/space/basic,
/area/space/nearstation)
"Dx" = (
/turf/closed/wall,
/area/station/maintenance/aft/lesser)
"Dy" = (
/obj/structure/sink/directional/west,
/obj/structure/mirror/directional/east,
/obj/effect/decal/cleanable/dirt,
/obj/machinery/atmospherics/pipe/smart/manifold4w/supply/hidden/layer4,
/obj/machinery/atmospherics/components/unary/vent_scrubber/on/layer2,
/obj/effect/landmark/start/assistant,
/obj/effect/mapping_helpers/broken_floor,
/turf/open/floor/iron/showroomfloor,
/area/station/commons/dock/aux)
"EO" = (
/obj/structure/window/reinforced/spawner/directional/west,
/obj/structure/lattice/catwalk,
/obj/structure/marker_beacon/cerulean,
/turf/open/space/basic,
/area/space/nearstation)
"Gq" = (
/obj/effect/turf_decal/siding/thinplating_new/dark,
/turf/open/floor/iron/dark/textured,
/area/station/commons/dock/aux)
"Gt" = (
/obj/structure/cable,
/obj/machinery/atmospherics/pipe/smart/manifold4w/scrubbers/hidden/layer2,
/obj/machinery/atmospherics/pipe/smart/manifold4w/supply/hidden/layer4,
/obj/effect/turf_decal/siding/thinplating_new/dark/corner,
/turf/open/floor/iron/dark/textured,
/area/station/commons/dock/aux)
"Hj" = (
/obj/structure/cable,
/obj/effect/decal/cleanable/dirt,
/obj/structure/broken_flooring/singular/directional/east{
	color = "#73737a"
	},
/obj/machinery/light/small/directional/north,
/obj/machinery/atmospherics/pipe/smart/manifold4w/scrubbers/hidden/layer2,
/obj/machinery/atmospherics/pipe/smart/manifold4w/supply/hidden/layer4,
/obj/structure/disposalpipe/segment{
	dir = 6
	},
/turf/open/floor/plating,
/area/station/maintenance/aft/lesser)
"Hm" = (
/obj/structure/flora/bush/sparsegrass/style_2,
/obj/structure/flora/bush/grassy/style_2,
/obj/structure/flora/bush/flowers_yw,
/obj/structure/flora/bush/sunny/style_random,
/obj/structure/flora/grass/jungle,
/obj/structure/flora/bush/flowers_pp,
/obj/structure/flora/bush/large{
	pixel_y = -4
	},
/obj/structure/marker_beacon/lime,
/turf/open/floor/grass,
/area/station/commons/dock/aux)
"Hy" = (
/obj/effect/turf_decal/siding/thinplating_new/dark{
	dir = 8
	},
/obj/effect/landmark/event_spawn,
/obj/effect/landmark/generic_maintenance_landmark,
/obj/structure/disposalpipe/segment,
/turf/open/floor/iron/dark/textured,
/area/station/commons/dock/aux)
"HW" = (
/obj/structure/cable,
/obj/structure/railing{
	dir = 8
	},
/obj/structure/railing{
	dir = 4
	},
/obj/machinery/atmospherics/pipe/smart/manifold4w/scrubbers/hidden/layer2,
/obj/machinery/atmospherics/pipe/smart/manifold4w/supply/hidden/layer4,
/obj/structure/disposalpipe/segment,
/turf/open/floor/iron/stairs/right{
	dir = 1;
	color = "#3d3e42"
	},
/area/station/maintenance/aft/lesser)
"Ix" = (
/obj/structure/window/reinforced/spawner/directional/east,
/turf/open/floor/glass/reinforced,
/area/station/commons/dock/aux)
"II" = (
/obj/effect/turf_decal/stripes/white/end{
	dir = 8
	},
/obj/effect/turf_decal/siding/thinplating/dark/end{
	dir = 8
	},
/turf/open/floor/engine/hull/reinforced,
/area/space/nearstation)
"Kc" = (
/obj/docking_port/stationary{
	dir = 2;
	dwidth = 11;
	height = 24;
	name = "Auxiliary Station Dock";
	shuttle_id = "whiteship_home";
	width = 35
	},
/turf/open/space/basic,
/area/space)
"La" = (
/obj/machinery/atmospherics/pipe/smart/manifold4w/scrubbers/hidden/layer2,
/obj/machinery/atmospherics/pipe/smart/manifold4w/supply/hidden/layer4,
/obj/structure/cable,
/obj/effect/turf_decal/siding/thinplating_new/dark{
	dir = 4
	},
/obj/effect/turf_decal/trimline/dark_green/corner,
/turf/open/floor/iron/dark/textured,
/area/station/commons/dock/aux)
"Lo" = (
/obj/machinery/light/floor,
/obj/effect/turf_decal/box,
/turf/open/floor/plating,
/area/station/commons/dock/aux)
"Lr" = (
/obj/effect/turf_decal/siding/thinplating_new/dark/corner{
	dir = 4
	},
/obj/effect/decal/cleanable/dirt,
/turf/open/floor/iron/dark/side{
	dir = 10
	},
/area/station/maintenance/aft/lesser)
"LU" = (
/obj/structure/disposalpipe/junction/flip{
	dir = 2
	},
/obj/effect/turf_decal/siding/thinplating_new/dark{
	dir = 8
	},
/obj/machinery/status_display/evac/directional/west,
/obj/effect/spawner/random/engineering/tracking_beacon,
/turf/open/floor/iron/dark/textured,
/area/station/commons/dock/aux)
"Mx" = (
/obj/machinery/atmospherics/pipe/smart/manifold4w/scrubbers/hidden/layer2,
/obj/machinery/atmospherics/pipe/smart/manifold4w/supply/hidden/layer4,
/obj/structure/cable,
/obj/effect/turf_decal/siding/thinplating_new/dark{
	dir = 5
	},
/obj/structure/sign/poster/contraband/random/directional/east,
/turf/open/floor/iron/dark/textured,
/area/station/commons/dock/aux)
"MA" = (
/obj/effect/turf_decal/bot_blue,
/obj/effect/spawner/random/structure/crate_loot,
/obj/item/toy/plush/skyrat/blue_cat,
/turf/open/floor/iron/dark/textured_large,
/area/station/maintenance/aft/lesser)
"Pv" = (
/obj/structure/window/reinforced/spawner/directional/east,
/obj/structure/window/reinforced/spawner/directional/west,
/obj/structure/flora/bush/sparsegrass/style_3,
/obj/structure/flora/bush/grassy/style_2,
/obj/structure/flora/grass/jungle/a/style_3,
/obj/structure/flora/bush/flowers_br,
/obj/structure/marker_beacon/lime,
/turf/open/floor/grass,
/area/station/commons/dock/aux)
"PI" = (
/obj/structure/window/reinforced/spawner/directional/east,
/obj/structure/window/reinforced/spawner/directional/west,
/obj/structure/flora/bush/sparsegrass/style_3,
/obj/structure/flora/bush/grassy/style_2,
/obj/structure/flora/bush/flowers_br/style_3,
/obj/structure/flora/bush/ferny/style_random,
/obj/structure/window/reinforced/spawner/directional/north,
/obj/structure/marker_beacon/lime,
/obj/structure/marker_beacon/lime,
/turf/open/floor/grass,
/area/station/commons/dock/aux)
"Qc" = (
/obj/machinery/door/airlock/public/glass{
	name = "Auxiliary Ship Dock"
	},
/turf/open/floor/iron/dark/textured,
/area/station/commons/dock/aux)
"QB" = (
/obj/effect/spawner/random/vending/snackvend,
/obj/effect/turf_decal/bot_white,
/turf/open/floor/iron/dark/textured,
/area/station/commons/dock/aux)
"RA" = (
/obj/effect/turf_decal/bot_white,
/obj/effect/decal/cleanable/dirt,
/obj/machinery/power/port_gen/pacman/pre_loaded,
/obj/structure/railing,
/turf/open/floor/iron/dark/textured_large,
/area/station/maintenance/aft/lesser)
"Sn" = (
/obj/structure/sign/nanotrasen,
/turf/closed/wall,
/area/station/commons/dock/aux)
"Sy" = (
/obj/structure/sign/poster/random/directional/north,
/obj/effect/turf_decal/siding/thinplating_new/dark/corner,
/obj/effect/decal/cleanable/dirt,
/obj/effect/turf_decal/trimline/dark/corner{
	dir = 4
	},
/obj/structure/flatpack_cart,
/turf/open/floor/iron/dark/side{
	dir = 9
	},
/area/station/maintenance/aft/lesser)
"Tl" = (
/obj/machinery/door/airlock/external/glass{
	name = "Auxiliary Ship Dock"
	},
/obj/effect/mapping_helpers/airlock/cyclelink_helper_multi{
	cycle_id = "ferry_upper"
	},
/turf/open/floor/iron/dark/textured_large,
/area/station/commons/dock/aux)
"UL" = (
/obj/structure/lattice/catwalk,
/obj/structure/window/reinforced/spawner/directional/east,
/obj/structure/marker_beacon/cerulean,
/turf/open/space/basic,
/area/space/nearstation)
"Wm" = (
/obj/structure/closet/emcloset/wall,
/turf/closed/wall,
/area/station/maintenance/aft/lesser)
"Wp" = (
/obj/structure/window/reinforced/spawner/directional/west,
/obj/structure/lattice,
/turf/open/space/basic,
/area/space/nearstation)
"XJ" = (
/obj/effect/turf_decal/stripes/line,
/obj/effect/turf_decal/stripes/line{
	dir = 6
	},
/obj/machinery/atmospherics/pipe/smart/manifold4w/scrubbers/hidden/layer2,
/obj/machinery/atmospherics/pipe/smart/manifold4w/supply/hidden/layer4,
/obj/structure/cable,
/turf/open/floor/iron/dark/textured,
/area/station/commons/dock/aux)
"XZ" = (
/obj/effect/spawner/random/vending/colavend,
/obj/effect/turf_decal/bot_white,
/obj/effect/decal/cleanable/dirt,
/turf/open/floor/iron/dark/textured,
/area/station/commons/dock/aux)
"Yd" = (
/obj/effect/spawner/structure/window/reinforced,
/turf/open/floor/plating,
/area/station/maintenance/aft/lesser)
"Yn" = (
/turf/template_noop,
/area/template_noop)
"Zo" = (
/obj/structure/hedge,
/turf/open/floor/iron/dark/textured_large,
/area/station/maintenance/aft/lesser)
"Zu" = (
/turf/open/floor/iron/dark/textured,
/area/station/maintenance/aft/lesser)

(1,1,1) = {"
Yn
Yn
Yn
Yn
Yn
Yn
Yn
Yn
Yn
Yn
Dx
xq
xq
xq
xq
"}
(2,1,1) = {"
Yn
Yn
Yn
Yn
Yn
Yn
Yn
Yn
Yn
Yn
Dx
xq
xq
xq
xq
"}
(3,1,1) = {"
Yn
Yn
Yn
Yn
Yn
Yn
Yn
Yn
Yn
Yn
Dx
xq
xq
xq
xq
"}
(4,1,1) = {"
Yn
Yn
Yn
Yn
Yn
Yn
Yn
Yn
Yn
Yn
Dx
xq
xq
xq
xq
"}
(5,1,1) = {"
Yn
Yn
Yn
Yn
Yn
Yn
Yn
Yn
Yn
Yn
Yn
xq
xq
xq
xq
"}
(6,1,1) = {"
Yn
Yn
Yn
Yn
Yn
Yn
Yn
Yn
Yn
Yn
Yn
xq
xq
xq
xq
"}
(7,1,1) = {"
Yn
Yn
Yn
Yn
Yn
Yn
Yn
Yn
Yn
Yn
Yn
nY
Cr
xq
xq
"}
(8,1,1) = {"
Yn
Yn
Yn
Yn
Yn
Yn
Yn
Yn
Yn
Yn
Yn
xq
xq
xq
xq
"}
(9,1,1) = {"
Yn
Yn
Yn
Yn
Yn
Yn
Yn
Yn
Yn
Yn
Yn
nY
nY
Cr
xq
"}
(10,1,1) = {"
Yn
Yn
Yn
Yn
Yn
Yn
Yn
Yn
Yn
Yn
Yn
xq
xq
xq
xq
"}
(11,1,1) = {"
Yn
Yn
Yn
Yn
Yn
Yn
Yn
Yn
Zo
Yn
Yn
nY
Cr
xq
xq
"}
(12,1,1) = {"
Yn
Yn
Yn
Yn
Yn
Yn
Yn
gp
Zu
uF
Yn
xq
xq
xq
xq
"}
(13,1,1) = {"
Yn
Yn
Yn
wX
wX
wX
Sn
wX
Qc
xc
wX
ct
ct
UL
xq
"}
(14,1,1) = {"
rk
wH
AM
ok
LU
nz
zM
yd
Hy
lp
Tl
kM
kM
Ci
Kc
"}
(15,1,1) = {"
je
Mx
zp
zp
pD
Gt
La
xk
ou
XJ
Tl
Ix
Ix
Ci
xq
"}
(16,1,1) = {"
yV
wX
wX
lf
uD
ic
na
Hm
wX
hT
wX
Wp
Wp
EO
xq
"}
(17,1,1) = {"
wX
st
wX
wX
qW
As
yM
Hm
wX
Lo
wX
xq
xq
xq
xq
"}
(18,1,1) = {"
wX
su
Dy
Ch
uD
Gq
XZ
wX
wX
bc
wX
xq
Yn
Yn
Yn
"}
(19,1,1) = {"
wX
wX
wX
wX
kk
lw
oL
qC
nY
bx
nY
xq
Yn
Yn
Yn
"}
(20,1,1) = {"
Wm
Hj
HW
tK
vn
kx
QB
qC
Yn
Yn
Yn
Yn
Yn
Yn
Yn
"}
(21,1,1) = {"
gv
uZ
MA
Dx
PI
Pv
qK
qC
Yn
Yn
Yn
Yn
Yn
Yn
Yn
"}
(22,1,1) = {"
Dx
by
Dx
Dx
RA
ud
pN
Yd
Yn
bx
Yn
Yn
Yn
Yn
Yn
"}
(23,1,1) = {"
Dx
co
Dx
Sy
ho
Lr
Dx
Ah
Yn
Yn
Yn
Yn
Yn
Yn
Yn
"}

(1,1,2) = {"
Yn
Yn
Yn
Yn
Yn
Yn
Yn
Yn
Yn
Yn
Yn
Yn
Yn
Yn
Yn
"}
(2,1,2) = {"
Yn
Yn
Yn
Yn
Yn
Yn
Yn
Yn
Yn
Yn
Yn
Yn
Yn
Yn
Yn
"}
(3,1,2) = {"
Yn
Yn
Yn
Yn
Yn
Yn
Yn
Yn
Yn
Yn
Yn
Yn
Yn
Yn
Yn
"}
(4,1,2) = {"
Yn
Yn
Yn
Yn
Yn
Yn
Yn
Yn
Yn
Yn
Yn
Yn
Yn
Yn
Yn
"}
(5,1,2) = {"
Yn
Yn
Yn
Yn
Yn
Yn
Yn
Yn
Yn
Yn
Yn
Yn
Yn
Yn
Yn
"}
(6,1,2) = {"
Yn
Yn
Yn
Yn
Yn
Yn
Yn
Yn
Yn
Yn
Yn
Yn
Yn
Yn
Yn
"}
(7,1,2) = {"
Yn
Yn
Yn
Yn
Yn
Yn
Yn
Yn
Yn
Yn
Yn
Yn
Yn
Yn
Yn
"}
(8,1,2) = {"
Yn
Yn
Yn
Yn
Yn
Yn
Yn
Yn
Yn
Yn
Yn
Yn
Yn
Yn
Yn
"}
(9,1,2) = {"
Yn
Yn
Yn
Yn
Yn
Yn
Yn
Yn
Yn
Yn
Yn
Yn
Yn
Yn
Yn
"}
(10,1,2) = {"
Yn
Yn
Yn
Yn
Yn
Yn
Yn
Yn
Yn
Yn
Yn
Yn
Yn
Yn
Yn
"}
(11,1,2) = {"
Yn
Yn
Yn
Yn
Yn
Yn
Yn
Yn
Yn
Yn
Yn
Yn
Yn
Yn
Yn
"}
(12,1,2) = {"
Yn
Yn
Yn
Yn
Yn
Yn
Yn
Yn
Yn
Yn
Yn
Yn
Yn
Yn
Yn
"}
(13,1,2) = {"
Yn
Yn
Yn
Yn
Yn
Yn
Yn
Yn
Yn
Yn
Yn
Yn
Yn
Yn
Yn
"}
(14,1,2) = {"
Yn
Yn
Yn
Yn
Yn
Yn
Yn
Yn
Yn
kD
uf
qH
qH
II
Yn
"}
(15,1,2) = {"
Yn
Yn
Yn
Yn
Yn
Yn
Yn
Yn
Yn
kD
pn
qH
qH
kT
Yn
"}
(16,1,2) = {"
Yn
Yn
Yn
Yn
Yn
Yn
Yn
Yn
Yn
kD
sy
Yn
Yn
Yn
Yn
"}
(17,1,2) = {"
Yn
Yn
Yn
Yn
Yn
Yn
Yn
Yn
Yn
kD
sy
Yn
Yn
Yn
Yn
"}
(18,1,2) = {"
Yn
Yn
Yn
Yn
Yn
Yn
Yn
Yn
Yn
Yn
Yn
Yn
Yn
Yn
Yn
"}
(19,1,2) = {"
Yn
Yn
Yn
Yn
Yn
Yn
Yn
Yn
Yn
Yn
Yn
Yn
Yn
Yn
Yn
"}
(20,1,2) = {"
Yn
Yn
Yn
Yn
Yn
Yn
Yn
Yn
Yn
Yn
Yn
Yn
Yn
Yn
Yn
"}
(21,1,2) = {"
Yn
Yn
Yn
Yn
Yn
Yn
Yn
Yn
Yn
Yn
Yn
Yn
Yn
Yn
Yn
"}
(22,1,2) = {"
Yn
Yn
Yn
Yn
Yn
Yn
Yn
Yn
Yn
Yn
Yn
Yn
Yn
Yn
Yn
"}
(23,1,2) = {"
Yn
Yn
Yn
Yn
Yn
Yn
Yn
Yn
Yn
Yn
Yn
Yn
Yn
Yn
Yn
"}
