//MAP CONVERTED BY dmm2tgm.py THIS HEADER COMMENT PREVENTS RECONVERSION, DO NOT REMOVE
"a" = (
/turf/template_noop,
/area/template_noop)
"e" = (
/obj/effect/turf_decal/trimline/white/filled/warning{
	dir = 1
	},
/obj/effect/turf_decal/trimline/dark/warning{
	dir = 1
	},
/obj/machinery/atmospherics/pipe/smart/manifold4w/supply/hidden/layer4,
/obj/machinery/atmospherics/pipe/smart/manifold4w/scrubbers/hidden/layer2,
/obj/structure/cable,
/turf/open/floor/iron,
/area/station/hallway/primary/starboard)
"h" = (
/obj/effect/turf_decal/tile/neutral/half/contrasted{
	dir = 4
	},
/obj/effect/turf_decal/siding/dark{
	dir = 4
	},
/obj/effect/turf_decal/trimline/dark/line{
	dir = 4
	},
/obj/machinery/cryopod{
	dir = 4
	},
/obj/machinery/light/cold/directional/west,
/turf/open/floor/iron/dark,
/area/station/common/cryopods/aux)
"k" = (
/obj/effect/turf_decal/tile/neutral/half/contrasted{
	dir = 4
	},
/obj/effect/turf_decal/siding/dark{
	dir = 4
	},
/obj/effect/turf_decal/trimline/dark/line{
	dir = 4
	},
/obj/item/radio/intercom/directional/north,
/obj/machinery/cryopod{
	dir = 4
	},
/obj/machinery/camera/autoname/directional/west,
/turf/open/floor/iron/dark,
/area/station/common/cryopods/aux)
"l" = (
/obj/effect/landmark/event_spawn,
/obj/effect/landmark/navigate_destination/cryo_east,
/turf/open/floor/iron/dark/textured_large,
/area/station/common/cryopods/aux)
"m" = (
/obj/machinery/digital_clock,
/turf/closed/wall,
/area/station/common/cryopods/aux)
"o" = (
/obj/effect/turf_decal/tile/neutral/half/contrasted{
	dir = 4
	},
/obj/effect/turf_decal/siding/dark{
	dir = 4
	},
/obj/effect/turf_decal/trimline/dark/line{
	dir = 4
	},
/obj/machinery/cryopod{
	dir = 4
	},
/obj/machinery/firealarm/directional/west,
/turf/open/floor/iron/dark,
/area/station/common/cryopods/aux)
"q" = (
/obj/effect/turf_decal/trimline/white/filled/corner{
	dir = 1
	},
/obj/effect/turf_decal/tile/neutral{
	dir = 4
	},
/obj/effect/turf_decal/trimline/dark/corner{
	dir = 1
	},
/obj/machinery/atmospherics/pipe/smart/manifold4w/supply/hidden/layer4,
/obj/machinery/atmospherics/pipe/smart/manifold4w/scrubbers/hidden/layer2,
/turf/open/floor/iron,
/area/station/hallway/primary/starboard)
"r" = (
/obj/structure/flora/bush/flowers_pp/style_2{
	name = "skyyblossoms"
	},
/obj/structure/flora/bush/flowers_pp{
	name = "skyyblossoms"
	},
/obj/structure/window/fulltile,
/obj/machinery/atmospherics/pipe/smart/manifold4w/scrubbers/hidden/layer2,
/obj/machinery/atmospherics/pipe/smart/manifold4w/supply/hidden/layer4,
/turf/open/floor/grass/fairy,
/area/station/common/cryopods/aux)
"t" = (
/obj/machinery/firealarm/directional/south,
/turf/template_noop,
/area/template_noop)
"u" = (
/obj/machinery/modular_computer/preset/time_clock/directional/east,
/obj/effect/turf_decal/tile/neutral/half/contrasted{
	dir = 8
	},
/obj/effect/turf_decal/siding/dark{
	dir = 8
	},
/obj/effect/turf_decal/trimline/dark/line{
	dir = 8
	},
/obj/machinery/atmospherics/pipe/smart/manifold4w/scrubbers/hidden/layer2,
/turf/open/floor/iron/dark,
/area/station/common/cryopods/aux)
"x" = (
/obj/effect/turf_decal/tile/neutral/half/contrasted{
	dir = 8
	},
/obj/effect/turf_decal/siding/dark{
	dir = 8
	},
/obj/effect/turf_decal/trimline/dark/line{
	dir = 8
	},
/obj/machinery/airalarm/directional/north,
/obj/machinery/computer/cryopod/directional/east,
/obj/machinery/atmospherics/pipe/smart/manifold4w/scrubbers/hidden/layer2,
/turf/open/floor/iron/dark,
/area/station/common/cryopods/aux)
"A" = (
/turf/closed/wall,
/area/station/common/cryopods/aux)
"C" = (
/obj/machinery/door/firedoor,
/obj/structure/cable,
/obj/machinery/atmospherics/pipe/smart/manifold4w/supply/hidden/layer4,
/obj/machinery/atmospherics/pipe/smart/manifold4w/scrubbers/hidden/layer2,
/obj/machinery/door/airlock/public/glass{
	name = "Auxiliary Cryopods"
	},
/turf/open/floor/iron/dark/textured_large,
/area/station/common/cryopods/aux)
"E" = (
/obj/structure/sign/poster/timeclock_psa/directional/north,
/obj/machinery/atmospherics/components/unary/vent_scrubber/on/layer2{
	dir = 4
	},
/turf/open/floor/iron/dark/textured_large,
/area/station/common/cryopods/aux)
"G" = (
/obj/structure/flora/bush/flowers_pp{
	name = "skyyblossoms"
	},
/obj/structure/flora/bush/flowers_pp/style_2{
	name = "skyyblossoms"
	},
/obj/structure/window/fulltile,
/turf/open/floor/grass/fairy,
/area/station/common/cryopods/aux)
"M" = (
/obj/structure/cable,
/obj/machinery/atmospherics/components/unary/vent_pump/on/layer4{
	dir = 4
	},
/turf/open/floor/iron/dark/textured_large,
/area/station/common/cryopods/aux)
"R" = (
/obj/machinery/power/apc/auto_name/directional/east,
/obj/structure/cable,
/obj/effect/turf_decal/tile/neutral/half/contrasted{
	dir = 8
	},
/obj/effect/turf_decal/trimline/dark/line{
	dir = 8
	},
/obj/effect/turf_decal/siding/dark{
	dir = 8
	},
/obj/machinery/atmospherics/pipe/smart/manifold4w/scrubbers/hidden/layer2,
/obj/machinery/atmospherics/pipe/smart/manifold4w/supply/hidden/layer4,
/turf/open/floor/iron/dark,
/area/station/common/cryopods/aux)
"X" = (
/obj/effect/turf_decal/trimline/white/filled/corner{
	dir = 4
	},
/obj/effect/turf_decal/trimline/dark/corner{
	dir = 4
	},
/obj/machinery/atmospherics/pipe/smart/manifold4w/supply/hidden/layer4,
/obj/machinery/atmospherics/pipe/smart/manifold4w/scrubbers/hidden/layer2,
/obj/effect/landmark/start/hangover,
/turf/open/floor/iron,
/area/station/hallway/primary/starboard)

(1,1,1) = {"
a
a
a
a
a
a
a
"}
(2,1,1) = {"
a
A
k
h
o
G
X
"}
(3,1,1) = {"
a
A
E
l
M
C
e
"}
(4,1,1) = {"
t
A
x
u
R
r
q
"}
(5,1,1) = {"
a
m
A
A
A
A
a
"}
