//MAP CONVERTED BY dmm2tgm.py THIS HEADER COMMENT PREVENTS RECONVERSION, DO NOT REMOVE
"a" = (
/obj/structure/flora/bush/fullgrass,
/obj/structure/flora/bush/grassy/style_random,
/obj/structure/flora/bush/lavendergrass/style_random,
/turf/open/floor/grass,
/area/station/service/library/upper)
"j" = (
/obj/structure/flora/bush/fullgrass,
/obj/structure/flora/bush/grassy/style_random,
/obj/structure/flora/bush/flowers_yw,
/obj/structure/flora/bush/flowers_br/style_2,
/turf/open/floor/grass,
/area/station/service/library/upper)
"x" = (
/obj/structure/flora/bush/fullgrass,
/obj/structure/flora/bush/grassy/style_random,
/obj/structure/flora/bush/flowers_br/style_2,
/turf/open/floor/grass,
/area/station/service/library/upper)
"A" = (
/obj/structure/flora/bush/fullgrass,
/obj/structure/flora/bush/grassy/style_random,
/obj/structure/flora/bush/flowers_br/style_2,
/obj/machinery/camera/autoname/directional/east,
/turf/open/floor/grass,
/area/station/service/library/upper)
"F" = (
/turf/template_noop,
/area/template_noop)
"I" = (
/obj/machinery/camera/autoname/directional/east,
/turf/template_noop,
/area/template_noop)
"J" = (
/obj/structure/flora/bush/grassy/style_random,
/obj/structure/flora/bush/fullgrass,
/obj/structure/marker_beacon/lime,
/turf/open/floor/grass,
/area/station/service/library/upper)
"L" = (
/obj/structure/flora/bush/grassy/style_random,
/obj/structure/flora/bush/flowers_br/style_2,
/turf/open/floor/grass,
/area/station/service/library/upper)
"N" = (
/obj/structure/flora/bush/fullgrass,
/obj/structure/flora/bush/large{
	pixel_y = -2
	},
/obj/structure/marker_beacon/lime,
/turf/open/floor/grass,
/area/station/service/library/upper)
"T" = (
/obj/structure/flora/bush/fullgrass,
/obj/structure/flora/bush/grassy/style_random,
/obj/structure/flora/bush/lavendergrass/style_random,
/obj/structure/flora/bush/flowers_yw,
/turf/open/floor/grass,
/area/station/service/library/upper)
"V" = (
/obj/structure/flora/bush/fullgrass,
/obj/structure/flora/bush/grassy/style_random,
/obj/structure/flora/bush/lavendergrass/style_random,
/obj/structure/flora/bush/flowers_br/style_2,
/turf/open/floor/grass,
/area/station/service/library/upper)

(1,1,1) = {"
F
F
F
V
a
L
F
F
"}
(2,1,1) = {"
I
x
a
j
F
T
a
A
"}
(3,1,1) = {"
F
F
N
F
F
F
J
F
"}
