//MAP CONVERTED BY dmm2tgm.py THIS HEADER COMMENT PREVENTS RECONVERSION, DO NOT REMOVE
"ba" = (
/obj/effect/turf_decal/bot_white,
/obj/effect/decal/cleanable/dirt,
/obj/machinery/power/port_gen/pacman/pre_loaded,
/obj/structure/railing,
/turf/open/floor/iron/dark/textured_large,
/area/station/maintenance/aft/lesser)
"cK" = (
/obj/machinery/airalarm/directional/south,
/turf/open/floor/iron/dark/textured,
/area/station/commons/auxdock)
"dQ" = (
/turf/open/floor/iron/dark/textured,
/area/station/commons/auxdock)
"gt" = (
/obj/effect/spawner/random/vending/colavend,
/obj/effect/turf_decal/bot_white,
/obj/effect/decal/cleanable/dirt,
/turf/open/floor/iron/dark/textured,
/area/station/commons/auxdock)
"gD" = (
/obj/structure/lattice/catwalk,
/obj/structure/marker_beacon/cerulean,
/turf/open/space/basic,
/area/space)
"gS" = (
/obj/structure/window/reinforced/spawner/directional/east,
/obj/structure/window/reinforced/spawner/directional/west,
/obj/structure/flora/bush/sparsegrass/style_3,
/obj/structure/flora/bush/grassy/style_2,
/obj/structure/flora/bush/flowers_br/style_3,
/obj/structure/flora/bush/ferny/style_random,
/obj/structure/window/reinforced/spawner/directional/north,
/obj/structure/marker_beacon/lime,
/turf/open/floor/grass,
/area/station/commons/auxdock)
"gY" = (
/obj/structure/window/reinforced/spawner/directional/west,
/obj/structure/lattice,
/turf/open/space/basic,
/area/space/nearstation)
"hC" = (
/obj/structure/cable,
/obj/effect/decal/cleanable/dirt,
/obj/structure/sign/poster/random/directional/north,
/obj/structure/broken_flooring/singular/directional/east{
	color = "#73737a"
	},
/obj/machinery/light/small/directional/north,
/obj/machinery/atmospherics/pipe/smart/manifold4w/scrubbers/hidden/layer2,
/obj/machinery/atmospherics/pipe/smart/manifold4w/supply/hidden/layer4,
/obj/structure/disposalpipe/segment{
	dir = 6
	},
/turf/open/floor/plating,
/area/station/maintenance/aft/lesser)
"if" = (
/obj/machinery/digital_clock/directional/north,
/turf/open/floor/iron/dark/textured,
/area/station/commons/auxdock)
"kc" = (
/obj/structure/cable,
/obj/machinery/atmospherics/pipe/smart/manifold4w/scrubbers/hidden/layer2,
/obj/machinery/atmospherics/pipe/smart/manifold4w/supply/hidden/layer4,
/obj/structure/disposalpipe/segment{
	dir = 4
	},
/turf/open/floor/plating,
/area/station/maintenance/aft/lesser)
"ke" = (
/obj/structure/cable,
/obj/effect/decal/cleanable/dirt,
/obj/effect/spawner/random/maintenance,
/obj/machinery/atmospherics/pipe/smart/manifold4w/scrubbers/hidden/layer2,
/obj/machinery/atmospherics/pipe/smart/manifold4w/supply/hidden/layer4,
/obj/structure/disposalpipe/segment{
	dir = 4
	},
/turf/open/floor/plating,
/area/station/maintenance/aft/lesser)
"kJ" = (
/turf/template_noop,
/area/template_noop)
"kU" = (
/obj/structure/closet/emcloset,
/obj/effect/turf_decal/trimline/blue/warning{
	dir = 1
	},
/turf/open/floor/iron/dark/side{
	dir = 1
	},
/area/station/maintenance/aft/lesser)
"li" = (
/obj/structure/lattice/catwalk,
/obj/structure/railing{
	dir = 1
	},
/obj/structure/marker_beacon/yellow,
/obj/structure/railing,
/turf/open/space/basic,
/area/space/nearstation)
"lr" = (
/turf/closed/wall,
/area/station/maintenance/aft/lesser)
"mD" = (
/obj/structure/cable,
/obj/structure/railing{
	dir = 8
	},
/obj/structure/railing{
	dir = 4
	},
/obj/machinery/atmospherics/pipe/smart/manifold4w/scrubbers/hidden/layer2,
/obj/machinery/atmospherics/pipe/smart/manifold4w/supply/hidden/layer4,
/obj/structure/disposalpipe/segment,
/turf/open/floor/iron/stairs/right{
	dir = 1;
	color = "#3d3e42"
	},
/area/station/maintenance/aft/lesser)
"mE" = (
/obj/structure/disposalpipe/junction/flip{
	dir = 2
	},
/obj/machinery/camera/autoname/directional/west,
/turf/open/floor/iron/dark/textured,
/area/station/commons/auxdock)
"nF" = (
/turf/open/floor/glass/reinforced,
/area/station/commons/auxdock)
"pl" = (
/obj/structure/cable,
/obj/structure/broken_flooring/pile/directional/east{
	color = "#73737a"
	},
/obj/machinery/atmospherics/pipe/smart/manifold4w/scrubbers/hidden/layer2,
/obj/machinery/atmospherics/pipe/smart/manifold4w/supply/hidden/layer4,
/obj/structure/disposalpipe/segment{
	dir = 4
	},
/turf/open/floor/plating,
/area/station/maintenance/aft/lesser)
"ps" = (
/obj/machinery/door/airlock/public/glass{
	name = "Auxiliary Ship Dock"
	},
/turf/open/floor/iron/dark/textured,
/area/station/commons/fitness/recreation)
"pE" = (
/obj/docking_port/stationary{
	dir = 2;
	dwidth = 11;
	height = 24;
	name = "SS13: Auxiliary Dock, Station-Port";
	shuttle_id = "whiteship_home";
	width = 35
	},
/turf/open/space/basic,
/area/space)
"pF" = (
/obj/structure/disposalpipe/segment,
/obj/machinery/door/airlock/public/glass{
	name = "Auxiliary Ship Dock"
	},
/turf/open/floor/iron/dark/textured,
/area/station/commons/fitness/recreation)
"sC" = (
/obj/structure/cable,
/obj/effect/mapping_helpers/broken_floor,
/obj/machinery/digital_clock/directional/north,
/obj/machinery/atmospherics/pipe/smart/manifold4w/scrubbers/hidden/layer2,
/obj/machinery/atmospherics/pipe/smart/manifold4w/supply/hidden/layer4,
/obj/structure/disposalpipe/segment{
	dir = 4
	},
/turf/open/floor/plating,
/area/station/maintenance/aft/lesser)
"sD" = (
/obj/machinery/power/apc/auto_name/directional/south,
/obj/structure/cable,
/turf/open/floor/iron/dark/textured,
/area/station/commons/auxdock)
"sW" = (
/turf/open/floor/plating,
/area/station/commons/auxdock)
"tj" = (
/turf/closed/wall,
/area/station/commons/auxdock)
"tn" = (
/obj/effect/turf_decal/bot_white,
/obj/effect/decal/cleanable/dirt/dust,
/turf/open/floor/iron/dark/textured_large,
/area/station/maintenance/aft/lesser)
"tt" = (
/obj/structure/cable,
/obj/machinery/atmospherics/pipe/smart/manifold4w/scrubbers/hidden/layer2,
/obj/machinery/atmospherics/pipe/smart/manifold4w/supply/hidden/layer4,
/obj/structure/disposalpipe/segment{
	dir = 9
	},
/turf/open/floor/iron/dark/textured,
/area/station/commons/auxdock)
"uo" = (
/obj/effect/turf_decal/siding/thinplating_new/dark/corner{
	dir = 4
	},
/obj/effect/decal/cleanable/dirt,
/turf/open/floor/iron/dark/side{
	dir = 10
	},
/area/station/maintenance/aft/lesser)
"wN" = (
/obj/machinery/door/airlock/public/glass{
	name = "Auxiliary Ship Dock";
	normalspeed = 0
	},
/turf/open/floor/iron/dark/textured,
/area/station/commons/auxdock)
"xr" = (
/obj/structure/cable,
/obj/structure/broken_flooring/singular/directional/east{
	color = "#73737a"
	},
/obj/machinery/atmospherics/pipe/smart/manifold4w/scrubbers/hidden/layer2,
/obj/machinery/atmospherics/pipe/smart/manifold4w/supply/hidden/layer4,
/obj/structure/disposalpipe/segment{
	dir = 4
	},
/obj/machinery/door/airlock/maintenance{
	name = "Auxiliary Ship Dock"
	},
/obj/effect/mapping_helpers/airlock/access/all/engineering/maintenance,
/turf/open/floor/plating,
/area/station/commons/auxdock)
"xs" = (
/turf/open/space/basic,
/area/space)
"xw" = (
/obj/structure/disposalpipe/segment,
/obj/machinery/light/directional/west,
/turf/open/floor/iron/dark/textured,
/area/station/commons/auxdock)
"xz" = (
/obj/effect/landmark/navigate_destination/dockaux,
/turf/open/floor/iron/dark/textured,
/area/station/commons/auxdock)
"yb" = (
/obj/structure/window/reinforced/spawner/directional/south,
/obj/structure/window/reinforced/spawner/directional/east,
/obj/structure/window/reinforced/spawner/directional/west,
/obj/structure/flora/bush/sparsegrass/style_3,
/obj/structure/flora/grass/jungle/a/style_3,
/obj/structure/flora/bush/flowers_br,
/obj/structure/flora/bush/ferny/style_random,
/turf/open/floor/grass,
/area/station/commons/auxdock)
"yh" = (
/obj/structure/cable,
/obj/machinery/atmospherics/pipe/smart/manifold4w/scrubbers/hidden/layer2,
/obj/machinery/atmospherics/pipe/smart/manifold4w/supply/hidden/layer4,
/obj/structure/disposalpipe/segment{
	dir = 4
	},
/obj/machinery/light/directional/north,
/turf/open/floor/iron/dark/textured,
/area/station/commons/auxdock)
"yN" = (
/obj/structure/sign/poster/random/directional/north,
/obj/effect/turf_decal/siding/thinplating_new/dark/corner,
/obj/effect/decal/cleanable/dirt,
/obj/effect/turf_decal/trimline/dark/corner{
	dir = 4
	},
/obj/structure/flatpack_cart,
/turf/open/floor/iron/dark/side{
	dir = 9
	},
/area/station/maintenance/aft/lesser)
"Aj" = (
/obj/structure/lattice,
/turf/open/space/basic,
/area/space)
"Br" = (
/obj/effect/turf_decal/bot_white,
/turf/open/floor/iron/dark/textured,
/area/station/commons/auxdock)
"Cn" = (
/obj/machinery/computer/security/telescreen/entertainment/directional/east,
/turf/open/floor/iron/dark/textured,
/area/station/commons/auxdock)
"Cy" = (
/obj/structure/cable,
/obj/machinery/atmospherics/pipe/smart/manifold4w/supply/hidden/layer4,
/obj/machinery/atmospherics/pipe/smart/manifold4w/scrubbers/hidden/layer2,
/obj/machinery/door/airlock/public/glass{
	name = "Auxiliary Ship Dock"
	},
/turf/open/floor/iron/dark/textured,
/area/station/commons/fitness/recreation)
"CC" = (
/obj/structure/disposalpipe/segment,
/turf/open/floor/iron/dark/textured,
/area/station/commons/auxdock)
"DX" = (
/obj/structure/closet/firecloset,
/obj/effect/turf_decal/trimline/red/warning{
	dir = 1
	},
/turf/open/floor/iron/dark/side{
	dir = 1
	},
/area/station/maintenance/aft/lesser)
"DY" = (
/obj/structure/cable,
/obj/effect/mapping_helpers/broken_floor,
/obj/effect/spawner/random/maintenance,
/obj/machinery/atmospherics/pipe/smart/manifold4w/scrubbers/hidden/layer2,
/obj/machinery/atmospherics/pipe/smart/manifold4w/supply/hidden/layer4,
/obj/structure/disposalpipe/segment{
	dir = 4
	},
/turf/open/floor/plating,
/area/station/maintenance/aft/lesser)
"Et" = (
/obj/machinery/atmospherics/pipe/smart/manifold4w/scrubbers/hidden/layer2,
/obj/machinery/atmospherics/pipe/smart/manifold4w/supply/hidden/layer4,
/obj/structure/cable,
/turf/open/floor/iron/dark/textured,
/area/station/commons/auxdock)
"Iy" = (
/obj/machinery/door/airlock/external/glass{
	name = "Engineering External Access"
	},
/obj/effect/mapping_helpers/airlock/cyclelink_helper{
	dir = 4
	},
/obj/effect/mapping_helpers/airlock/access/all/engineering/general,
/turf/open/floor/plating,
/area/station/commons/auxdock)
"Jy" = (
/obj/structure/cable,
/obj/machinery/atmospherics/pipe/smart/manifold4w/scrubbers/hidden/layer2,
/obj/machinery/atmospherics/pipe/smart/manifold4w/supply/hidden/layer4,
/obj/structure/disposalpipe/segment{
	dir = 4
	},
/turf/open/floor/iron/dark/textured,
/area/station/commons/auxdock)
"JA" = (
/obj/effect/turf_decal/bot_white,
/obj/effect/spawner/random/engineering/atmospherics_portable,
/obj/effect/decal/cleanable/dirt/dust,
/turf/open/floor/iron/dark/textured_large,
/area/station/maintenance/aft/lesser)
"Qg" = (
/obj/machinery/atmospherics/components/unary/vent_scrubber/on/layer2{
	dir = 8
	},
/turf/open/floor/iron/dark/textured,
/area/station/commons/auxdock)
"Rn" = (
/obj/structure/window/reinforced/spawner/directional/east,
/obj/structure/lattice,
/turf/open/space/basic,
/area/space/nearstation)
"RI" = (
/obj/effect/turf_decal/siding/thinplating_new/dark{
	dir = 4
	},
/obj/effect/decal/cleanable/dirt/dust,
/obj/machinery/atmospherics/components/unary/vent_pump/on/layer4{
	dir = 4
	},
/turf/open/floor/iron/dark/side{
	dir = 8
	},
/area/station/maintenance/aft/lesser)
"SU" = (
/obj/machinery/door/airlock/external/glass{
	name = "Auxiliary Ship Dock"
	},
/obj/effect/mapping_helpers/airlock/cyclelink_helper_multi{
	cycle_id = "ferry_upper"
	},
/turf/open/floor/iron/dark/textured_large,
/area/station/commons/auxdock)
"SY" = (
/obj/structure/disposalpipe/segment,
/obj/machinery/atmospherics/components/unary/vent_pump/on/layer4{
	dir = 4
	},
/turf/open/floor/iron/dark/textured,
/area/station/commons/auxdock)
"Tq" = (
/obj/structure/hedge,
/turf/open/floor/plating,
/area/station/maintenance/aft/lesser)
"TA" = (
/obj/structure/cable,
/obj/machinery/door/airlock/public/glass{
	name = "Auxiliary Ship Dock"
	},
/obj/machinery/atmospherics/pipe/smart/manifold4w/scrubbers/hidden/layer2,
/obj/machinery/atmospherics/pipe/smart/manifold4w/supply/hidden/layer4,
/obj/structure/disposalpipe/segment,
/obj/effect/mapping_helpers/airlock/access/all/engineering/maintenance,
/turf/open/floor/iron/dark/textured_large,
/area/station/maintenance/aft/lesser)
"TG" = (
/obj/effect/spawner/random/vending/snackvend,
/obj/effect/turf_decal/bot_white,
/turf/open/floor/iron/dark/textured,
/area/station/commons/auxdock)
"Uq" = (
/obj/machinery/door/airlock/external/glass{
	name = "Engineering External Access"
	},
/obj/effect/mapping_helpers/airlock/cyclelink_helper{
	dir = 8
	},
/obj/effect/mapping_helpers/airlock/access/all/engineering/general,
/turf/open/floor/plating,
/area/station/commons/auxdock)
"Uw" = (
/obj/item/radio/intercom/directional/east,
/turf/open/floor/iron/dark/textured,
/area/station/commons/auxdock)
"UI" = (
/obj/structure/lattice,
/turf/open/space/basic,
/area/space/nearstation)
"VS" = (
/turf/closed/wall/r_wall,
/area/station/maintenance/aft/lesser)
"WA" = (
/obj/structure/cable,
/obj/machinery/atmospherics/pipe/smart/manifold4w/scrubbers/hidden/layer2,
/obj/machinery/atmospherics/pipe/smart/manifold4w/supply/hidden/layer4,
/turf/open/floor/iron/dark/textured,
/area/station/commons/auxdock)
"XV" = (
/obj/effect/spawner/structure/window/reinforced,
/turf/open/floor/plating,
/area/station/maintenance/aft/lesser)
"YE" = (
/obj/structure/disposalpipe/segment{
	dir = 9
	},
/obj/machinery/atmospherics/pipe/smart/manifold4w/scrubbers/hidden/layer2,
/obj/machinery/atmospherics/pipe/smart/manifold4w/supply/hidden/layer4,
/obj/structure/cable,
/turf/open/floor/iron/dark/textured,
/area/station/commons/auxdock)
"YK" = (
/obj/effect/spawner/structure/window/reinforced,
/turf/open/floor/plating,
/area/station/commons/auxdock)
"YX" = (
/obj/structure/window/reinforced/spawner/directional/east,
/obj/structure/window/reinforced/spawner/directional/west,
/obj/structure/flora/bush/sparsegrass/style_3,
/obj/structure/flora/bush/grassy/style_2,
/obj/structure/flora/grass/jungle/a/style_3,
/obj/structure/flora/bush/flowers_br,
/turf/open/floor/grass,
/area/station/commons/auxdock)

(1,1,1) = {"
kJ
kJ
kJ
kJ
kJ
kJ
kJ
kJ
kJ
kJ
lr
xs
xs
xs
xs
"}
(2,1,1) = {"
kJ
kJ
kJ
kJ
kJ
kJ
kJ
kJ
kJ
kJ
lr
xs
xs
xs
xs
"}
(3,1,1) = {"
kJ
kJ
kJ
kJ
kJ
kJ
kJ
kJ
kJ
kJ
lr
xs
xs
xs
xs
"}
(4,1,1) = {"
kJ
kJ
kJ
kJ
kJ
kJ
kJ
kJ
kJ
kJ
lr
xs
xs
xs
xs
"}
(5,1,1) = {"
kJ
kJ
kJ
kJ
kJ
kJ
kJ
kJ
kJ
kJ
kJ
xs
xs
xs
xs
"}
(6,1,1) = {"
kJ
kJ
kJ
kJ
kJ
kJ
kJ
kJ
kJ
kJ
kJ
xs
xs
xs
xs
"}
(7,1,1) = {"
kJ
kJ
kJ
kJ
kJ
kJ
kJ
kJ
kJ
kJ
kJ
Aj
gD
xs
xs
"}
(8,1,1) = {"
kJ
kJ
kJ
kJ
kJ
kJ
kJ
kJ
kJ
kJ
kJ
xs
xs
xs
xs
"}
(9,1,1) = {"
kJ
kJ
kJ
kJ
kJ
kJ
kJ
kJ
kJ
kJ
kJ
Aj
Aj
gD
xs
"}
(10,1,1) = {"
kJ
kJ
kJ
kJ
kJ
kJ
kJ
kJ
kJ
kJ
kJ
xs
xs
xs
xs
"}
(11,1,1) = {"
kJ
kJ
kJ
kJ
kJ
kJ
kJ
kJ
kJ
kJ
kJ
Aj
gD
xs
xs
"}
(12,1,1) = {"
kJ
kJ
kJ
kJ
kJ
kJ
kJ
kJ
kJ
kJ
kJ
xs
xs
xs
xs
"}
(13,1,1) = {"
kJ
kJ
kJ
tj
tj
tj
tj
xr
tj
tj
tj
Rn
Rn
tj
xs
"}
(14,1,1) = {"
pF
CC
CC
SY
mE
xw
CC
tt
wN
dQ
SU
nF
nF
SU
pE
"}
(15,1,1) = {"
Cy
Et
WA
WA
Jy
WA
Et
Et
wN
dQ
SU
nF
nF
SU
xs
"}
(16,1,1) = {"
ps
Cn
Uw
Qg
Jy
dQ
xz
sD
tj
Iy
tj
gY
gY
tj
xs
"}
(17,1,1) = {"
lr
lr
lr
lr
yh
dQ
dQ
cK
tj
sW
tj
xs
xs
xs
xs
"}
(18,1,1) = {"
lr
hC
mD
TA
YE
dQ
dQ
tj
tj
Uq
tj
xs
kJ
kJ
kJ
"}
(19,1,1) = {"
lr
DY
Tq
lr
if
dQ
dQ
YK
UI
li
UI
xs
kJ
kJ
kJ
"}
(20,1,1) = {"
lr
kc
kU
lr
gt
Br
TG
YK
kJ
kJ
kJ
kJ
kJ
kJ
kJ
"}
(21,1,1) = {"
lr
pl
DX
lr
gS
YX
yb
YK
kJ
kJ
kJ
kJ
kJ
kJ
kJ
"}
(22,1,1) = {"
lr
sC
lr
lr
ba
tn
JA
XV
kJ
li
kJ
kJ
kJ
kJ
kJ
"}
(23,1,1) = {"
lr
ke
lr
yN
RI
uo
lr
VS
kJ
kJ
kJ
kJ
kJ
kJ
kJ
"}
