//MAP CONVERTED BY dmm2tgm.py THIS HEADER COMMENT PREVENTS RECONVERSION, DO NOT REMOVE
"a" = (
/turf/closed/wall,
/area/station/commons/locker)
"c" = (
/obj/structure/chair/sofa/bench/tram{
	dir = 8
	},
/obj/effect/turf_decal/siding/thinplating_new/dark{
	dir = 4
	},
/turf/open/floor/iron/dark,
/area/station/commons/locker)
"e" = (
/obj/effect/turf_decal/siding/thinplating_new/dark{
	dir = 4
	},
/turf/open/floor/iron/dark/herringbone,
/area/station/commons/locker)
"f" = (
/obj/effect/spawner/structure/window/reinforced/tinted,
/turf/open/floor/plating,
/area/station/commons/locker)
"g" = (
/obj/machinery/cryopod,
/obj/machinery/digital_clock/directional/north,
/obj/effect/turf_decal/bot_blue,
/turf/open/floor/iron/dark/herringbone,
/area/station/commons/locker)
"i" = (
/obj/effect/turf_decal/siding/thinplating_new/dark{
	dir = 8
	},
/obj/effect/turf_decal/tile/neutral{
	dir = 1
	},
/turf/open/floor/iron/dark/side{
	dir = 4
	},
/area/station/commons/locker)
"j" = (
/obj/effect/turf_decal/siding/thinplating_new/dark{
	dir = 1
	},
/obj/effect/turf_decal/tile/neutral{
	dir = 1
	},
/obj/effect/turf_decal/siding/thinplating_new/dark,
/turf/open/floor/iron/dark/side,
/area/station/commons/locker)
"l" = (
/obj/effect/turf_decal/delivery,
/obj/structure/disposalpipe/trunk{
	dir = 8
	},
/obj/machinery/disposal/bin/tagger,
/turf/open/floor/iron/dark/herringbone,
/area/station/commons/locker)
"p" = (
/obj/effect/turf_decal/bot_white,
/obj/machinery/vending/autodrobe,
/turf/open/floor/iron/dark/herringbone,
/area/station/commons/locker)
"q" = (
/obj/effect/turf_decal/tile/neutral{
	dir = 1
	},
/obj/structure/hedge,
/obj/structure/railing{
	dir = 10
	},
/obj/effect/turf_decal/siding/thinplating_new/dark{
	dir = 8
	},
/turf/open/floor/iron/dark/side{
	dir = 4
	},
/area/station/commons/locker)
"r" = (
/obj/machinery/vending/clothing,
/obj/effect/turf_decal/bot_white,
/turf/open/floor/iron/dark/herringbone,
/area/station/commons/locker)
"s" = (
/obj/machinery/cryopod,
/obj/structure/sign/poster/timeclock_psa/directional/east,
/obj/effect/turf_decal/bot_blue,
/obj/machinery/status_display/evac/directional/north,
/turf/open/floor/iron/dark/herringbone,
/area/station/commons/locker)
"v" = (
/obj/effect/turf_decal/siding/thinplating_new/dark{
	dir = 4
	},
/obj/structure/disposalpipe/segment{
	dir = 4
	},
/turf/open/floor/iron/dark/herringbone,
/area/station/commons/locker)
"z" = (
/obj/machinery/cryopod,
/obj/effect/turf_decal/bot_blue,
/obj/machinery/light_switch/default_on/directional/north,
/turf/open/floor/iron/dark/herringbone,
/area/station/commons/locker)
"A" = (
/obj/effect/turf_decal/tile/neutral{
	dir = 1
	},
/obj/effect/turf_decal/siding/thinplating_new/dark,
/obj/effect/turf_decal/siding/thinplating_new/dark{
	dir = 1
	},
/turf/open/floor/iron/dark/side,
/area/station/commons/locker)
"C" = (
/obj/structure/chair/sofa/bench/tram/left{
	dir = 8
	},
/obj/effect/turf_decal/siding/thinplating_new/dark{
	dir = 4
	},
/turf/open/floor/iron/dark,
/area/station/commons/locker)
"D" = (
/obj/effect/turf_decal/siding/thinplating_new/dark{
	dir = 1
	},
/obj/effect/turf_decal/siding/thinplating_new/dark/corner{
	dir = 8
	},
/turf/open/floor/iron/dark/side{
	dir = 5
	},
/area/station/commons/locker)
"F" = (
/obj/effect/turf_decal/siding/thinplating_new/dark{
	dir = 8
	},
/obj/effect/turf_decal/tile/neutral{
	dir = 1
	},
/obj/effect/landmark/navigate_destination/cryo_west,
/turf/open/floor/iron/dark/side{
	dir = 4
	},
/area/station/commons/locker)
"J" = (
/obj/effect/spawner/structure/window,
/turf/open/floor/plating,
/area/station/commons/locker)
"K" = (
/obj/effect/turf_decal/siding/thinplating_new/dark,
/obj/effect/turf_decal/siding/thinplating_new/dark{
	dir = 1
	},
/obj/effect/turf_decal/tile/neutral,
/turf/open/floor/iron/dark/side{
	dir = 1
	},
/area/station/commons/locker)
"L" = (
/obj/machinery/cryopod{
	dir = 1
	},
/obj/structure/sign/poster/timeclock_psa/directional/east,
/obj/effect/turf_decal/bot_blue,
/obj/machinery/firealarm/directional/south,
/turf/open/floor/iron/dark/herringbone,
/area/station/commons/locker)
"Q" = (
/obj/machinery/vending/dorms,
/obj/effect/turf_decal/bot_white,
/obj/item/radio/intercom/directional/south,
/turf/open/floor/iron/dark/herringbone,
/area/station/commons/locker)
"S" = (
/obj/effect/turf_decal/siding/thinplating_new/dark{
	dir = 1
	},
/obj/effect/turf_decal/siding/thinplating_new/dark/corner,
/obj/effect/turf_decal/tile/neutral/opposingcorners,
/turf/open/floor/iron/dark/corner{
	dir = 4
	},
/area/station/commons/locker)
"T" = (
/obj/machinery/cryopod{
	dir = 1
	},
/obj/effect/turf_decal/bot_blue,
/obj/structure/extinguisher_cabinet/directional/south,
/turf/open/floor/iron/dark/herringbone,
/area/station/commons/locker)
"U" = (
/obj/machinery/computer/cryopod/directional/east,
/obj/effect/turf_decal/siding/thinplating_new/dark{
	dir = 6
	},
/obj/machinery/light/cold/directional/east,
/turf/open/floor/iron/dark,
/area/station/commons/locker)
"V" = (
/obj/structure/chair/sofa/bench/tram/right{
	dir = 8
	},
/obj/effect/turf_decal/siding/thinplating_new/dark{
	dir = 4
	},
/turf/open/floor/iron/dark,
/area/station/commons/locker)
"W" = (
/obj/effect/turf_decal/siding/thinplating_new/dark,
/obj/effect/turf_decal/siding/thinplating_new/dark/corner{
	dir = 1
	},
/obj/effect/turf_decal/tile/neutral{
	dir = 1
	},
/turf/open/floor/iron/dark/side{
	dir = 6
	},
/area/station/commons/locker)
"X" = (
/obj/machinery/time_clock/directional/east,
/obj/effect/turf_decal/siding/thinplating_new/dark{
	dir = 5
	},
/obj/machinery/light/cold/directional/east,
/turf/open/floor/iron/dark,
/area/station/commons/locker)
"Y" = (
/obj/machinery/cryopod{
	dir = 1
	},
/obj/effect/turf_decal/bot_blue,
/obj/machinery/newscaster/directional/south,
/turf/open/floor/iron/dark/herringbone,
/area/station/commons/locker)

(1,1,1) = {"
J
q
S
e
v
e
A
Q
a
"}
(2,1,1) = {"
a
z
K
r
l
p
j
Y
a
"}
(3,1,1) = {"
a
g
D
i
F
i
W
T
a
"}
(4,1,1) = {"
a
s
X
V
c
C
U
L
a
"}
(5,1,1) = {"
a
a
a
f
f
f
a
a
a
"}
