//MAP CONVERTED BY dmm2tgm.py THIS HEADER COMMENT PREVENTS RECONVERSION, DO NOT REMOVE
"a" = (
/turf/closed/wall/r_wall,
/area/station/command/heads_quarters/nt_rep)
"b" = (
/obj/structure/table/wood,
/obj/item/storage/briefcase/central_command,
/turf/open/floor/carpet/green,
/area/station/command/heads_quarters/nt_rep)
"c" = (
/obj/structure/sign/directions/engineering,
/obj/structure/sign/directions/evac{
	pixel_y = -8
	},
/obj/structure/sign/directions/science{
	pixel_y = 8
	},
/turf/closed/wall/r_wall,
/area/station/command/heads_quarters/nt_rep)
"f" = (
/obj/structure/closet/secure_closet/nanotrasen_consultant,
/obj/item/clothing/accessory/medal/silver/bureaucracy,
/obj/item/clothing/accessory/medal/gold/nanotrasen_consultant,
/obj/item/clothing/accessory/medal/gold/ordom,
/obj/effect/turf_decal/siding/wood{
	dir = 8
	},
/obj/structure/extinguisher_cabinet/directional/east,
/obj/machinery/light/directional/north,
/turf/open/floor/wood,
/area/station/command/heads_quarters/nt_rep)
"h" = (
/obj/machinery/light/directional/west,
/turf/template_noop,
/area/template_noop)
"i" = (
/turf/template_noop,
/area/template_noop)
"j" = (
/obj/structure/table/wood,
/obj/machinery/fax{
	fax_name = "Nanotrasen Consultant's Office";
	name = "Nanotrasen Consultant's Fax Machine"
	},
/turf/open/floor/wood,
/area/station/command/heads_quarters/nt_rep)
"k" = (
/obj/effect/turf_decal/siding/wood{
	dir = 1
	},
/obj/effect/landmark/start/nanotrasen_consultant,
/obj/effect/turf_decal/siding/wood,
/obj/structure/chair/comfy{
	dir = 1
	},
/turf/open/floor/wood,
/area/station/command/heads_quarters/nt_rep)
"m" = (
/obj/machinery/vending/boozeomat/all_access,
/turf/closed/wall/r_wall,
/area/station/command/heads_quarters/nt_rep)
"n" = (
/obj/machinery/atmospherics/pipe/smart/manifold4w/scrubbers/hidden/layer2,
/obj/machinery/atmospherics/components/unary/vent_pump/on/layer4,
/obj/effect/turf_decal/siding/wood{
	dir = 1
	},
/turf/open/floor/wood,
/area/station/command/heads_quarters/nt_rep)
"o" = (
/obj/machinery/button/door/directional/south{
	id = "nt_rep_priv";
	name = "Privacy Shutters Control"
	},
/obj/item/kirbyplants/random,
/obj/structure/cable,
/turf/open/floor/wood,
/area/station/command/heads_quarters/nt_rep)
"q" = (
/obj/structure/chair/comfy/black{
	dir = 8
	},
/turf/open/floor/carpet/green,
/area/station/command/heads_quarters/nt_rep)
"s" = (
/obj/machinery/atmospherics/pipe/smart/manifold4w/supply/hidden/layer4,
/obj/machinery/door/airlock/maintenance_hatch{
	name = "Maintenance Hatch"
	},
/obj/structure/cable,
/obj/effect/mapping_helpers/airlock/access/all/cent_com/rep_door,
/obj/effect/turf_decal/siding/wood{
	dir = 1
	},
/turf/open/floor/iron/dark/textured_large,
/area/station/maintenance/port/fore)
"t" = (
/obj/effect/turf_decal/siding/wood,
/obj/structure/sign/poster/official/random/directional/north,
/obj/item/radio/intercom/directional/west,
/turf/open/floor/wood,
/area/station/command/heads_quarters/nt_rep)
"u" = (
/obj/structure/cable,
/obj/machinery/power/apc/auto_name/directional/west,
/obj/machinery/airalarm/directional/north,
/obj/effect/turf_decal/siding/wood{
	dir = 4
	},
/obj/machinery/photocopier,
/obj/machinery/light/directional/north,
/turf/open/floor/wood,
/area/station/command/heads_quarters/nt_rep)
"v" = (
/obj/effect/landmark/start/nanotrasen_consultant,
/obj/structure/sign/flag/nanotrasen/directional/west,
/obj/structure/chair/office/tactical{
	dir = 4
	},
/turf/open/floor/carpet/green,
/area/station/command/heads_quarters/nt_rep)
"w" = (
/obj/effect/spawner/structure/window/reinforced,
/obj/machinery/door/poddoor/shutters/preopen{
	id = "nt_rep_priv";
	name = "Privacy Shutters"
	},
/obj/structure/cable,
/turf/open/floor/plating,
/area/station/command/heads_quarters/nt_rep)
"x" = (
/obj/structure/sign/poster/official/random/directional/south,
/obj/structure/disposalpipe/segment{
	dir = 9
	},
/obj/structure/table/wood/fancy/green,
/obj/item/statuebust{
	pixel_y = 8
	},
/obj/machinery/light/directional/south,
/obj/structure/cable,
/turf/open/floor/wood,
/area/station/command/heads_quarters/nt_rep)
"y" = (
/obj/machinery/atmospherics/pipe/smart/manifold4w/supply/hidden/layer4,
/obj/machinery/atmospherics/pipe/smart/manifold4w/scrubbers/hidden/layer2,
/obj/structure/cable,
/turf/open/floor/wood,
/area/station/command/heads_quarters/nt_rep)
"z" = (
/obj/effect/turf_decal/tile/neutral/fourcorners,
/obj/structure/sign/flag/nanotrasen/directional/north,
/obj/structure/bed/dogbed{
	name = "Lisa's bed"
	},
/mob/living/basic/pet/dog/corgi/lisa,
/turf/open/floor/iron/dark,
/area/station/command/heads_quarters/nt_rep)
"B" = (
/obj/machinery/holopad,
/obj/effect/turf_decal/bot,
/turf/open/floor/iron/dark/textured_large,
/area/station/command/heads_quarters/nt_rep)
"C" = (
/obj/machinery/atmospherics/pipe/smart/manifold4w/scrubbers/hidden/layer2,
/obj/effect/turf_decal/siding/wood{
	dir = 8
	},
/obj/structure/cable,
/obj/effect/turf_decal/siding/wood/corner{
	dir = 4
	},
/turf/open/floor/wood,
/area/station/command/heads_quarters/nt_rep)
"D" = (
/obj/effect/turf_decal/siding/wood{
	dir = 8
	},
/turf/open/floor/wood,
/area/station/command/heads_quarters/nt_rep)
"E" = (
/obj/structure/filingcabinet/medical{
	pixel_x = -10;
	icon_state = "employmentcabinet"
	},
/obj/structure/filingcabinet/employment,
/obj/structure/filingcabinet/security{
	pixel_x = 10;
	icon_state = "employmentcabinet"
	},
/obj/effect/turf_decal/siding/wood/corner{
	dir = 4
	},
/turf/open/floor/wood,
/area/station/command/heads_quarters/nt_rep)
"F" = (
/obj/machinery/atmospherics/pipe/smart/manifold4w/scrubbers/hidden/layer2,
/obj/effect/turf_decal/siding/wood/corner{
	dir = 8
	},
/obj/structure/cable,
/obj/effect/turf_decal/siding/wood{
	dir = 4
	},
/turf/open/floor/wood,
/area/station/command/heads_quarters/nt_rep)
"G" = (
/obj/effect/turf_decal/tile/neutral/fourcorners,
/obj/structure/sign/flag/galfed/directional/north,
/turf/open/floor/iron/dark,
/area/station/command/heads_quarters/nt_rep)
"H" = (
/obj/structure/disposalpipe/junction/yjunction{
	dir = 1
	},
/turf/open/floor/iron,
/area/station/hallway/primary/central/fore)
"I" = (
/obj/effect/turf_decal/siding/wood{
	dir = 1
	},
/obj/effect/turf_decal/siding/wood/corner{
	dir = 8
	},
/turf/open/floor/wood,
/area/station/command/heads_quarters/nt_rep)
"J" = (
/obj/structure/table/wood,
/obj/item/stamp/centcom{
	pixel_x = -8;
	pixel_y = 8
	},
/obj/item/stamp/denied{
	pixel_x = -8;
	pixel_y = 4
	},
/obj/item/stamp{
	pixel_x = -8
	},
/obj/item/paper_bin{
	pixel_y = 4;
	pixel_x = 4
	},
/obj/item/pen/fountain{
	pixel_x = 4;
	pixel_y = 4
	},
/obj/machinery/light/directional/south,
/turf/open/floor/carpet/green,
/area/station/command/heads_quarters/nt_rep)
"K" = (
/obj/machinery/light_switch/directional/north,
/obj/structure/disposalpipe/segment{
	dir = 4
	},
/turf/open/floor/wood,
/area/station/command/heads_quarters/nt_rep)
"L" = (
/obj/machinery/door/airlock/corporate{
	name = "Nanotrasen Consultant's Office"
	},
/obj/structure/disposalpipe/segment{
	dir = 4
	},
/obj/effect/mapping_helpers/airlock/access/all/cent_com/rep_door,
/obj/machinery/door/firedoor,
/obj/effect/turf_decal/siding/wood{
	dir = 8
	},
/obj/effect/mapping_helpers/airlock/unres{
	dir = 8
	},
/obj/effect/landmark/navigate_destination/autoname,
/turf/open/floor/iron/dark/textured_large,
/area/station/command/heads_quarters/nt_rep)
"M" = (
/obj/machinery/status_display/ai/directional/south,
/obj/machinery/modular_computer/preset/command{
	dir = 1
	},
/obj/machinery/requests_console/directional/west{
	name = "Nanotrasen Consultant's Requests Console";
	department = "Nanotrasen Consultant"
	},
/turf/open/floor/carpet/green,
/area/station/command/heads_quarters/nt_rep)
"P" = (
/obj/machinery/airalarm/directional/south,
/obj/effect/turf_decal/siding/wood{
	dir = 8
	},
/obj/machinery/camera/directional/south{
	c_tag = "NT Consultant's Office";
	name = "command camera"
	},
/obj/structure/cable,
/turf/open/floor/wood,
/area/station/command/heads_quarters/nt_rep)
"Q" = (
/obj/structure/closet/secure_closet/personal/cabinet,
/obj/item/clothing/under/rank/centcom/officer,
/obj/item/clothing/under/rank/centcom/officer_skirt,
/obj/item/clothing/under/rank/centcom/intern,
/obj/item/clothing/under/rank/centcom/commander,
/obj/item/clothing/under/rank/centcom/centcom_skirt,
/obj/item/clothing/head/hats/centcom_cap,
/obj/item/clothing/suit/hooded/wintercoat/centcom/nt_consultant,
/obj/item/clothing/head/hats/centhat,
/obj/item/radio/headset/heads/nanotrasen_consultant/alt,
/obj/item/clothing/glasses/sunglasses,
/obj/item/clothing/suit/armor/centcom_formal/nt_consultant,
/obj/item/clothing/suit/armor/centcom_formal,
/obj/machinery/newscaster/directional/east,
/obj/effect/turf_decal/siding/wood/corner{
	dir = 1
	},
/turf/open/floor/wood,
/area/station/command/heads_quarters/nt_rep)
"S" = (
/obj/machinery/disposal/bin,
/obj/structure/disposalpipe/trunk{
	dir = 4
	},
/obj/machinery/firealarm/directional/south,
/obj/structure/cable,
/turf/open/floor/wood,
/area/station/command/heads_quarters/nt_rep)
"U" = (
/obj/structure/fireplace,
/obj/effect/turf_decal/tile/neutral/fourcorners,
/turf/open/floor/iron/dark,
/area/station/command/heads_quarters/nt_rep)
"V" = (
/obj/machinery/atmospherics/components/unary/vent_scrubber/on/layer2,
/obj/structure/cable,
/obj/effect/turf_decal/siding/wood/corner,
/obj/effect/turf_decal/siding/wood{
	dir = 1
	},
/turf/open/floor/wood,
/area/station/command/heads_quarters/nt_rep)
"W" = (
/obj/structure/disposalpipe/segment{
	dir = 6
	},
/turf/open/floor/wood,
/area/station/command/heads_quarters/nt_rep)
"X" = (
/obj/effect/turf_decal/siding/wood/corner{
	dir = 1
	},
/turf/open/floor/wood,
/area/station/command/heads_quarters/nt_rep)
"Y" = (
/obj/effect/turf_decal/siding/wood,
/turf/open/floor/wood,
/area/station/command/heads_quarters/nt_rep)

(1,1,1) = {"
i
i
a
a
a
a
a
"}
(2,1,1) = {"
i
i
a
t
v
M
a
"}
(3,1,1) = {"
a
a
m
Y
b
J
a
"}
(4,1,1) = {"
a
u
E
Y
q
q
a
"}
(5,1,1) = {"
a
z
V
F
C
P
a
"}
(6,1,1) = {"
a
U
k
B
n
y
s
"}
(7,1,1) = {"
a
G
I
D
X
S
a
"}
(8,1,1) = {"
a
f
Q
j
W
x
a
"}
(9,1,1) = {"
a
a
a
a
K
o
a
"}
(10,1,1) = {"
i
i
i
c
L
w
a
"}
(11,1,1) = {"
i
i
i
i
H
i
h
"}
