//MAP CONVERTED BY dmm2tgm.py THIS HEADER COMMENT PREVENTS RECONVERSION, DO NOT REMOVE
"al" = (
/obj/machinery/transport/guideway_sensor{
	dir = 1
	},
/obj/structure/railing{
	dir = 10
	},
/obj/effect/turf_decal/bot_white,
/turf/open/floor/plating,
/area/station/maintenance/central/greater)
"aY" = (
/obj/structure/transport/linear/tram,
/obj/structure/tram/split,
/obj/machinery/transport/destination_sign/split/north,
/turf/open/floor/plating/elevatorshaft,
/area/station/maintenance/central/greater)
"bt" = (
/obj/structure/cable,
/obj/machinery/atmospherics/pipe/smart/manifold4w/scrubbers/hidden/layer2,
/obj/machinery/atmospherics/pipe/smart/manifold4w/supply/hidden/layer4,
/obj/machinery/light/cold/dim/directional/south,
/turf/open/floor/plating,
/area/station/maintenance/central/greater)
"cm" = (
/obj/structure/transport/linear/tram,
/obj/structure/tram,
/turf/open/floor/plating/elevatorshaft,
/area/station/maintenance/central/greater)
"cv" = (
/obj/structure/holosign/barrier/atmos/tram,
/turf/open/floor/plating/elevatorshaft,
/area/station/maintenance/central/greater)
"cz" = (
/obj/effect/turf_decal/sand/plating,
/obj/machinery/atmospherics/pipe/smart/manifold4w/supply/hidden/layer4,
/turf/open/floor/plating,
/area/station/maintenance/central/greater)
"do" = (
/obj/structure/transport/linear/tram,
/obj/structure/tram,
/obj/machinery/transport/tram_controller,
/turf/open/floor/plating/elevatorshaft,
/area/station/maintenance/central/greater)
"dT" = (
/obj/structure/holosign/barrier/atmos/tram,
/obj/effect/turf_decal/tile/neutral/tram,
/turf/open/floor/tram/plate,
/area/station/maintenance/central/greater)
"ew" = (
/obj/machinery/atmospherics/pipe/smart/manifold4w/supply/hidden/layer4,
/turf/template_noop,
/area/station/maintenance/central/greater)
"fR" = (
/obj/structure/fluff/tram_rail/electric{
	dir = 1
	},
/obj/machinery/atmospherics/pipe/smart/manifold4w/scrubbers/hidden/layer2,
/obj/machinery/atmospherics/pipe/smart/manifold4w/supply/hidden/layer4,
/obj/structure/cable,
/turf/open/floor/catwalk_floor/iron_dark,
/area/station/maintenance/central/greater)
"iD" = (
/obj/structure/fluff/tram_rail/electric,
/obj/structure/transport/linear/tram,
/obj/structure/thermoplastic,
/obj/structure/chair/sofa/bench/tram/left,
/turf/open/floor/plating/elevatorshaft,
/area/station/maintenance/central/greater)
"iF" = (
/obj/structure/transport/linear/tram,
/obj/structure/tram/split,
/turf/open/floor/plating/elevatorshaft,
/area/station/maintenance/central/greater)
"iY" = (
/obj/effect/turf_decal/tile/neutral/tram,
/obj/structure/transport/linear/tram,
/obj/effect/landmark/transport/nav_beacon/tram/platform/tramstation/west,
/obj/structure/thermoplastic/light,
/obj/effect/landmark/transport/nav_beacon/tram/nav/tramstation/main,
/turf/open/floor/tram/plate,
/area/station/maintenance/central/greater)
"ke" = (
/obj/structure/transport/linear/tram,
/obj/structure/thermoplastic/light,
/obj/machinery/door/airlock/tram,
/turf/open/floor/plating/elevatorshaft,
/area/station/maintenance/central/greater)
"kM" = (
/obj/structure/fluff/tram_rail,
/obj/structure/transport/linear/tram,
/obj/structure/thermoplastic,
/obj/structure/chair/sofa/bench/tram/right,
/turf/open/floor/plating/elevatorshaft,
/area/station/maintenance/central/greater)
"my" = (
/obj/structure/cable,
/obj/machinery/atmospherics/pipe/smart/manifold4w/supply/hidden/layer4,
/obj/machinery/atmospherics/pipe/smart/manifold4w/scrubbers/hidden/layer2,
/turf/open/floor/plating,
/area/station/maintenance/central/greater)
"mK" = (
/obj/structure/cable,
/obj/machinery/atmospherics/pipe/smart/manifold4w/scrubbers/hidden/layer2,
/obj/machinery/atmospherics/pipe/smart/manifold4w/supply/hidden/layer4,
/turf/open/floor/catwalk_floor/iron_dark,
/area/station/maintenance/central/greater)
"nh" = (
/obj/machinery/atmospherics/pipe/smart/manifold4w/scrubbers/hidden/layer2,
/obj/machinery/atmospherics/pipe/smart/manifold4w/supply/hidden/layer4,
/obj/structure/cable,
/turf/open/floor/catwalk_floor/iron_dark,
/area/station/maintenance/central/greater)
"nH" = (
/obj/effect/turf_decal/sand/plating,
/obj/machinery/atmospherics/pipe/smart/manifold4w/supply/hidden/layer4,
/obj/effect/spawner/random/entertainment/arcade{
	dir = 4
	},
/turf/open/floor/plating,
/area/station/maintenance/central/greater)
"nZ" = (
/obj/effect/turf_decal/tile/neutral/tram,
/obj/structure/transport/linear/tram,
/obj/structure/tram,
/turf/open/floor/tram/plate,
/area/station/maintenance/central/greater)
"on" = (
/turf/open/floor/plating/elevatorshaft,
/area/station/maintenance/central/greater)
"oq" = (
/obj/machinery/atmospherics/pipe/smart/manifold4w/scrubbers/hidden/layer2,
/obj/machinery/atmospherics/pipe/smart/manifold4w/supply/hidden/layer4,
/obj/structure/cable,
/obj/effect/turf_decal/stripes/white/line,
/obj/effect/turf_decal/stripes/white/line{
	dir = 1
	},
/obj/effect/turf_decal/tile/neutral/tram,
/turf/open/floor/tram/plate/energized,
/area/station/maintenance/central/greater)
"oB" = (
/obj/machinery/light/small/blacklight/directional/east,
/turf/open/floor/plating,
/area/station/maintenance/central/greater)
"pj" = (
/obj/structure/fluff/tram_rail/electric,
/obj/machinery/atmospherics/pipe/smart/manifold4w/scrubbers/hidden/layer2,
/obj/machinery/atmospherics/pipe/smart/manifold4w/supply/hidden/layer4,
/obj/structure/cable,
/turf/open/floor/catwalk_floor/iron_dark,
/area/station/maintenance/central/greater)
"rC" = (
/obj/effect/turf_decal/tile/neutral/tram,
/obj/structure/transport/linear/tram,
/obj/structure/thermoplastic/light,
/turf/open/floor/tram/plate,
/area/station/maintenance/central/greater)
"sh" = (
/obj/structure/transport/linear/tram/corner/southwest,
/obj/structure/tram/spoiler,
/turf/open/floor/plating/elevatorshaft,
/area/station/maintenance/central/greater)
"sn" = (
/obj/structure/transport/linear/tram/corner/northeast,
/obj/structure/tram/spoiler{
	dir = 1
	},
/turf/open/floor/plating/elevatorshaft,
/area/station/maintenance/central/greater)
"tT" = (
/obj/structure/fluff/tram_rail/electric{
	dir = 1
	},
/obj/structure/holosign/barrier/atmos/tram,
/turf/open/floor/plating/elevatorshaft,
/area/station/maintenance/central/greater)
"uS" = (
/obj/machinery/transport/destination_sign/indicator/directional,
/obj/machinery/button/transport/tram/directional{
	id = 1
	},
/turf/closed/wall,
/area/station/hallway/secondary/entry)
"vg" = (
/turf/template_noop,
/area/template_noop)
"wg" = (
/obj/structure/fluff/tram_rail/electric{
	dir = 1
	},
/turf/open/floor/plating/elevatorshaft,
/area/station/maintenance/central/greater)
"wv" = (
/turf/closed/wall,
/area/station/maintenance/central/greater)
"wX" = (
/obj/effect/turf_decal/sand/plating,
/obj/effect/mapping_helpers/broken_floor,
/turf/open/floor/plating,
/area/station/maintenance/central/greater)
"wZ" = (
/obj/structure/fluff/tram_rail/electric,
/obj/structure/transport/linear/tram,
/obj/structure/thermoplastic/light,
/obj/machinery/computer/tram_controls/split/directional/north,
/turf/open/floor/plating/elevatorshaft,
/area/station/maintenance/central/greater)
"yw" = (
/obj/structure/fluff/tram_rail/electric{
	dir = 1
	},
/obj/structure/transport/linear/tram,
/obj/structure/thermoplastic,
/obj/structure/chair/sofa/bench/tram/right{
	dir = 1
	},
/turf/open/floor/plating/elevatorshaft,
/area/station/maintenance/central/greater)
"yx" = (
/obj/structure/fluff/tram_rail/electric,
/turf/open/floor/plating/elevatorshaft,
/area/station/maintenance/central/greater)
"zc" = (
/obj/structure/transport/linear/tram,
/obj/structure/tram/split,
/obj/machinery/transport/destination_sign/split/south,
/turf/open/floor/plating/elevatorshaft,
/area/station/maintenance/central/greater)
"zx" = (
/obj/machinery/light/small/directional/east,
/turf/template_noop,
/area/station/maintenance/central/greater)
"Ah" = (
/obj/structure/transport/linear/tram/corner/southeast,
/obj/structure/tram/spoiler{
	dir = 4
	},
/turf/open/floor/plating/elevatorshaft,
/area/station/maintenance/central/greater)
"Au" = (
/obj/effect/mapping_helpers/airlock/access/all/command/general,
/obj/machinery/door/airlock/command{
	name = "Corporate Private Dock"
	},
/obj/effect/mapping_helpers/airlock/unres{
	dir = 1
	},
/turf/open/floor/plating,
/area/station/maintenance/central/greater)
"Az" = (
/obj/effect/turf_decal/tile/neutral/tram,
/obj/structure/transport/linear/tram,
/obj/structure/thermoplastic,
/obj/structure/chair/sofa/bench/tram/left{
	dir = 4
	},
/turf/open/floor/tram/plate,
/area/station/maintenance/central/greater)
"BN" = (
/obj/effect/turf_decal/tile/neutral/tram,
/turf/open/floor/tram/plate,
/area/station/maintenance/central/greater)
"Cm" = (
/obj/structure/fluff/tram_rail/electric{
	dir = 1
	},
/obj/structure/transport/linear/tram,
/obj/structure/thermoplastic,
/obj/structure/chair/sofa/bench/tram/left{
	dir = 8
	},
/turf/open/floor/plating/elevatorshaft,
/area/station/maintenance/central/greater)
"Dj" = (
/obj/machinery/atmospherics/pipe/smart/manifold4w/scrubbers/hidden/layer2,
/obj/machinery/atmospherics/pipe/smart/manifold4w/supply/hidden/layer4,
/obj/structure/cable,
/turf/open/floor/plating,
/area/station/maintenance/central/greater)
"Dp" = (
/obj/structure/fluff/tram_rail/end{
	dir = 8
	},
/obj/structure/transport/linear/tram,
/obj/structure/tram,
/turf/open/floor/plating/elevatorshaft,
/area/station/maintenance/central/greater)
"DM" = (
/obj/machinery/transport/power_rectifier{
	pixel_y = 0
	},
/turf/closed/wall,
/area/station/maintenance/central/greater)
"ET" = (
/obj/structure/transport/linear/tram,
/obj/structure/thermoplastic/light,
/turf/open/floor/plating/elevatorshaft,
/area/station/maintenance/central/greater)
"FH" = (
/obj/structure/fluff/tram_rail/electric{
	dir = 1
	},
/obj/structure/transport/linear/tram,
/obj/structure/tram,
/turf/open/floor/plating/elevatorshaft,
/area/station/maintenance/central/greater)
"Gh" = (
/obj/structure/fluff/tram_rail/electric,
/obj/structure/transport/linear/tram,
/obj/structure/thermoplastic/light,
/turf/open/floor/plating/elevatorshaft,
/area/station/maintenance/central/greater)
"Gm" = (
/obj/structure/fluff/tram_rail/electric{
	dir = 1
	},
/obj/structure/transport/linear/tram,
/obj/structure/thermoplastic,
/obj/structure/chair/sofa/bench/tram/right{
	dir = 4
	},
/turf/open/floor/plating/elevatorshaft,
/area/station/maintenance/central/greater)
"GH" = (
/obj/effect/turf_decal/sand/plating,
/turf/open/floor/plating,
/area/station/maintenance/central/greater)
"Hu" = (
/obj/structure/fluff/tram_rail/electric,
/obj/structure/holosign/barrier/atmos/tram,
/turf/open/floor/plating/elevatorshaft,
/area/station/maintenance/central/greater)
"HM" = (
/obj/structure/fluff/tram_rail/end{
	dir = 4
	},
/obj/structure/transport/linear/tram,
/obj/structure/tram,
/turf/open/floor/plating/elevatorshaft,
/area/station/maintenance/central/greater)
"HP" = (
/obj/structure/fluff/tram_rail/electric{
	dir = 1
	},
/obj/structure/transport/linear/tram,
/obj/structure/thermoplastic/light,
/turf/open/floor/plating/elevatorshaft,
/area/station/maintenance/central/greater)
"Im" = (
/turf/open/floor/noslip/tram,
/area/station/hallway/secondary/entry)
"IC" = (
/obj/machinery/door/airlock/maintenance_hatch{
	name = "Utilities Access Hatch"
	},
/obj/machinery/atmospherics/pipe/smart/manifold4w/supply/hidden/layer4,
/obj/effect/mapping_helpers/airlock/access/all/engineering/maintenance,
/turf/open/floor/plating,
/area/station/maintenance/central/greater)
"JL" = (
/obj/structure/cable,
/obj/machinery/atmospherics/pipe/smart/manifold4w/scrubbers/hidden/layer2,
/obj/machinery/atmospherics/pipe/smart/manifold4w/supply/hidden/layer4,
/turf/open/floor/plating,
/area/station/maintenance/central/greater)
"Kn" = (
/obj/structure/fluff/tram_rail/electric,
/obj/structure/transport/linear/tram,
/obj/structure/thermoplastic,
/obj/structure/chair/sofa/bench/tram/right,
/turf/open/floor/plating/elevatorshaft,
/area/station/maintenance/central/greater)
"KF" = (
/obj/structure/railing,
/obj/structure/lattice,
/turf/open/openspace,
/area/station/maintenance/central/greater)
"KZ" = (
/obj/machinery/light/directional/west,
/turf/open/floor/noslip/tram,
/area/station/hallway/secondary/entry)
"LT" = (
/obj/structure/transport/linear/tram/corner/northwest,
/obj/structure/tram/spoiler{
	dir = 8
	},
/turf/open/floor/plating/elevatorshaft,
/area/station/maintenance/central/greater)
"Nz" = (
/obj/effect/turf_decal/tile/neutral/tram,
/obj/structure/transport/linear/tram,
/obj/structure/thermoplastic,
/obj/structure/chair/sofa/bench/tram/right{
	dir = 8
	},
/turf/open/floor/tram/plate,
/area/station/maintenance/central/greater)
"NN" = (
/obj/structure/cable,
/obj/machinery/atmospherics/pipe/smart/manifold4w/scrubbers/hidden/layer2,
/obj/machinery/atmospherics/pipe/smart/manifold4w/supply/hidden/layer4,
/obj/machinery/door/airlock/maintenance_hatch{
	name = "Utilities Access Hatch"
	},
/turf/open/floor/plating,
/area/station/maintenance/central/greater)
"PR" = (
/obj/structure/fluff/tram_rail/electric{
	dir = 1
	},
/obj/structure/transport/linear/tram,
/obj/structure/thermoplastic,
/obj/structure/chair/sofa/bench/tram/left{
	dir = 1
	},
/obj/machinery/computer/tram_controls/split/directional/south,
/turf/open/floor/plating/elevatorshaft,
/area/station/maintenance/central/greater)
"Qb" = (
/obj/structure/fluff/tram_rail/electric,
/obj/structure/transport/linear/tram,
/obj/structure/tram,
/turf/open/floor/plating/elevatorshaft,
/area/station/maintenance/central/greater)
"Qo" = (
/obj/effect/turf_decal/tile/neutral/tram,
/obj/effect/landmark/transport/transport_id/tramstation/line_1,
/obj/structure/transport/linear/tram,
/obj/structure/thermoplastic/light,
/turf/open/floor/tram/plate,
/area/station/maintenance/central/greater)
"Qq" = (
/obj/structure/transport/linear/tram,
/obj/structure/tram/alt/titanium,
/turf/open/floor/plating/elevatorshaft,
/area/station/maintenance/central/greater)
"Sa" = (
/obj/structure/transport/linear/tram,
/obj/structure/thermoplastic,
/obj/structure/chair/sofa/bench/tram{
	dir = 1
	},
/turf/open/floor/plating/elevatorshaft,
/area/station/maintenance/central/greater)
"SM" = (
/turf/open/floor/plating,
/area/station/maintenance/central/greater)
"SW" = (
/obj/machinery/light/cold/dim/directional/south,
/turf/open/floor/plating,
/area/station/maintenance/central/greater)
"TQ" = (
/obj/machinery/transport/guideway_sensor,
/obj/structure/railing{
	dir = 1
	},
/obj/effect/turf_decal/bot_white,
/turf/open/floor/plating,
/area/station/maintenance/central/greater)
"Vh" = (
/obj/structure/transport/linear/tram,
/obj/structure/tram,
/obj/structure/plaque/static_plaque/tram,
/turf/open/floor/plating/elevatorshaft,
/area/station/maintenance/central/greater)
"VT" = (
/obj/structure/fluff/tram_rail/electric,
/obj/structure/transport/linear/tram,
/obj/structure/thermoplastic,
/turf/open/floor/plating/elevatorshaft,
/area/station/maintenance/central/greater)
"Xf" = (
/obj/machinery/door/airlock/maintenance_hatch{
	name = "Utilities Access Hatch"
	},
/obj/effect/mapping_helpers/airlock/access/all/engineering/maintenance,
/turf/closed/wall,
/area/station/maintenance/central/greater)
"Zu" = (
/obj/machinery/atmospherics/pipe/smart/manifold4w/scrubbers/hidden/layer2,
/obj/machinery/atmospherics/pipe/smart/manifold4w/supply/hidden/layer4,
/obj/structure/cable,
/obj/machinery/door/airlock/maintenance_hatch{
	name = "Utilities Access Hatch"
	},
/obj/effect/mapping_helpers/airlock/unres,
/obj/effect/mapping_helpers/airlock/access/all/engineering/maintenance,
/turf/open/floor/catwalk_floor/titanium,
/area/station/maintenance/central/greater)

(1,1,1) = {"
vg
vg
vg
vg
vg
vg
vg
vg
vg
vg
vg
"}
(2,1,1) = {"
vg
vg
vg
JL
KF
LT
Dp
nZ
HM
sh
uS
"}
(3,1,1) = {"
vg
vg
vg
vg
KF
do
VT
Az
Gm
cm
KZ
"}
(4,1,1) = {"
vg
vg
vg
vg
KF
Qq
Kn
rC
HP
ke
Im
"}
(5,1,1) = {"
vg
vg
vg
vg
KF
Qq
iD
rC
HP
ET
Im
"}
(6,1,1) = {"
vg
vg
vg
vg
KF
iF
Gh
Qo
PR
zc
Im
"}
(7,1,1) = {"
vg
vg
vg
vg
KF
iF
ET
iY
Sa
iF
Im
"}
(8,1,1) = {"
vg
vg
vg
vg
KF
aY
wZ
rC
yw
iF
Im
"}
(9,1,1) = {"
vg
vg
vg
vg
KF
Qq
kM
rC
HP
ke
Im
"}
(10,1,1) = {"
vg
vg
vg
vg
KF
Qq
iD
rC
HP
ET
Im
"}
(11,1,1) = {"
vg
vg
vg
my
KF
Vh
VT
Nz
Cm
cm
uS
"}
(12,1,1) = {"
vg
vg
vg
my
wv
sn
Qb
nZ
FH
Ah
wv
"}
(13,1,1) = {"
vg
GH
vg
Dj
Zu
nh
pj
oq
fR
nh
mK
"}
(14,1,1) = {"
vg
GH
wv
IC
wv
cv
Hu
dT
tT
cv
NN
"}
(15,1,1) = {"
ew
cz
nH
cz
wv
on
yx
BN
wg
on
JL
"}
(16,1,1) = {"
ew
GH
GH
GH
wv
on
yx
BN
wg
on
bt
"}
(17,1,1) = {"
ew
vg
vg
vg
wv
on
yx
BN
wg
on
JL
"}
(18,1,1) = {"
vg
vg
vg
vg
wv
on
yx
BN
wg
on
JL
"}
(19,1,1) = {"
vg
vg
vg
vg
wv
on
yx
BN
wg
on
SM
"}
(20,1,1) = {"
vg
vg
vg
vg
wv
on
yx
BN
wg
on
SM
"}
(21,1,1) = {"
vg
vg
vg
vg
wv
on
yx
BN
wg
on
SM
"}
(22,1,1) = {"
vg
vg
vg
vg
wv
on
yx
BN
wg
on
SM
"}
(23,1,1) = {"
vg
vg
vg
vg
wv
on
yx
BN
wg
on
SM
"}
(24,1,1) = {"
vg
vg
vg
vg
wv
on
yx
BN
wg
on
SW
"}
(25,1,1) = {"
vg
vg
vg
vg
wv
on
yx
BN
wg
on
SM
"}
(26,1,1) = {"
vg
zx
wX
vg
wv
on
yx
BN
wg
on
SM
"}
(27,1,1) = {"
vg
wv
Xf
wv
DM
on
yx
BN
wg
on
SM
"}
(28,1,1) = {"
Au
SM
SM
oB
TQ
on
yx
BN
wg
on
al
"}
