//MAP CONVERTED BY dmm2tgm.py THIS HEADER COMMENT PREVENTS RECONVERSION, DO NOT REMOVE
"al" = (
/obj/machinery/door/firedoor,
/turf/open/floor/iron/white,
/area/station/hallway/secondary/entry)
"bb" = (
/obj/effect/turf_decal/stripes/line{
	dir = 1
	},
/obj/machinery/light/dim/directional/east,
/turf/open/floor/engine,
/area/station/hallway/secondary/entry)
"bg" = (
/obj/effect/turf_decal/trimline/green/filled/line{
	dir = 10
	},
/obj/structure/closet/emcloset,
/turf/open/floor/iron/white,
/area/station/hallway/secondary/entry)
"bv" = (
/obj/effect/turf_decal/siding{
	dir = 4
	},
/turf/open/floor/iron/white,
/area/station/hallway/secondary/entry)
"ca" = (
/obj/effect/turf_decal/trimline/green/filled/corner,
/turf/open/floor/iron/white,
/area/station/hallway/secondary/entry)
"cq" = (
/obj/structure/chair/comfy/beige{
	dir = 8
	},
/obj/machinery/newscaster/directional/east,
/turf/open/floor/iron/grimy,
/area/station/hallway/secondary/entry)
"dt" = (
/obj/effect/turf_decal/stripes/line{
	dir = 1
	},
/obj/machinery/light/dim/directional/west,
/turf/open/floor/engine,
/area/station/hallway/secondary/entry)
"dv" = (
/obj/machinery/atmospherics/pipe/smart/manifold4w/scrubbers/hidden/layer2,
/obj/machinery/atmospherics/pipe/smart/manifold4w/supply/hidden/layer4,
/obj/machinery/door/airlock/maintenance/external,
/obj/effect/mapping_helpers/airlock/unres{
	dir = 8
	},
/obj/effect/turf_decal/sand/plating,
/obj/effect/mapping_helpers/airlock/access/all/engineering/maintenance,
/obj/structure/cable,
/turf/open/floor/plating,
/area/station/hallway/secondary/entry)
"eD" = (
/obj/machinery/atmospherics/pipe/smart/manifold4w/scrubbers/hidden/layer2,
/obj/machinery/atmospherics/pipe/smart/manifold4w/supply/hidden/layer4,
/obj/structure/cable,
/obj/effect/turf_decal/trimline/green/filled/line{
	dir = 1
	},
/obj/structure/closet/firecloset,
/turf/open/floor/iron/white,
/area/station/hallway/secondary/entry)
"fd" = (
/obj/structure/chair/comfy/beige{
	dir = 8
	},
/turf/open/floor/iron/grimy,
/area/station/hallway/secondary/entry)
"fp" = (
/obj/structure/cable,
/obj/machinery/atmospherics/pipe/smart/manifold4w/supply/hidden/layer4,
/obj/machinery/atmospherics/pipe/smart/manifold4w/scrubbers/hidden/layer2,
/turf/open/floor/catwalk_floor/flat_white,
/area/station/hallway/secondary/entry)
"fv" = (
/obj/machinery/atmospherics/pipe/smart/manifold4w/scrubbers/hidden/layer2,
/obj/structure/cable,
/obj/machinery/atmospherics/pipe/smart/manifold4w/supply/hidden/layer4,
/obj/effect/turf_decal/trimline/green/filled/corner{
	dir = 1
	},
/obj/effect/turf_decal/trimline/green/filled/corner{
	dir = 4
	},
/turf/open/floor/iron/white,
/area/station/hallway/secondary/entry)
"fx" = (
/obj/structure/cable,
/obj/machinery/power/apc/auto_name/directional/north,
/turf/open/floor/iron,
/area/station/service/janitor)
"gp" = (
/obj/structure/table/wood,
/obj/effect/spawner/random/decoration/ornament,
/turf/open/floor/iron/grimy,
/area/station/hallway/secondary/entry)
"hI" = (
/obj/machinery/atmospherics/pipe/smart/manifold4w/supply/hidden/layer4,
/turf/open/floor/iron/white,
/area/station/hallway/secondary/entry)
"hV" = (
/obj/structure/cable,
/obj/machinery/atmospherics/pipe/smart/manifold4w/supply/hidden/layer4,
/obj/machinery/atmospherics/pipe/smart/manifold4w/scrubbers/hidden/layer2,
/obj/machinery/light/directional/north,
/obj/structure/extinguisher_cabinet/directional/north,
/turf/open/floor/catwalk_floor/flat_white,
/area/station/hallway/secondary/entry)
"iJ" = (
/obj/effect/spawner/structure/window,
/turf/open/floor/plating,
/area/station/hallway/secondary/entry)
"iW" = (
/turf/closed/wall,
/area/station/service/janitor)
"jd" = (
/turf/closed/wall,
/area/station/hallway/secondary/entry)
"jG" = (
/obj/effect/spawner/random/vending/snackvend,
/turf/open/floor/iron/dark/textured_large,
/area/station/hallway/secondary/entry)
"kd" = (
/obj/machinery/atmospherics/pipe/smart/manifold4w/scrubbers/hidden/layer2,
/turf/open/floor/iron/white,
/area/station/hallway/secondary/entry)
"lb" = (
/obj/structure/table/wood,
/obj/effect/spawner/random/decoration/ornament,
/obj/machinery/newscaster/directional/east,
/turf/open/floor/iron/grimy,
/area/station/hallway/secondary/entry)
"lO" = (
/obj/effect/turf_decal/siding/corner,
/turf/open/floor/iron/white,
/area/station/hallway/secondary/entry)
"md" = (
/obj/machinery/computer/shuttle/arrivals/recall,
/turf/open/floor/iron/dark/textured_large,
/area/station/hallway/secondary/entry)
"mk" = (
/obj/machinery/atmospherics/pipe/smart/manifold4w/scrubbers/hidden/layer2,
/obj/machinery/atmospherics/pipe/smart/manifold4w/supply/hidden/layer4,
/obj/structure/cable,
/turf/open/floor/iron/white,
/area/station/hallway/secondary/entry)
"mE" = (
/obj/structure/cable,
/obj/machinery/atmospherics/pipe/smart/manifold4w/supply/hidden/layer4,
/obj/machinery/atmospherics/pipe/smart/manifold4w/scrubbers/hidden/layer2,
/obj/structure/extinguisher_cabinet/directional/west,
/turf/open/floor/catwalk_floor/flat_white,
/area/station/hallway/secondary/entry)
"mT" = (
/obj/effect/turf_decal/trimline/green/filled/line{
	dir = 1
	},
/obj/effect/turf_decal/siding{
	dir = 8
	},
/turf/open/floor/iron/white,
/area/station/hallway/secondary/entry)
"or" = (
/obj/effect/turf_decal/sand/plating,
/obj/machinery/atmospherics/components/unary/vent_pump/on/layer4{
	dir = 8
	},
/obj/effect/landmark/generic_maintenance_landmark,
/turf/open/floor/plating,
/area/station/asteroid)
"oz" = (
/obj/effect/decal/cleanable/dirt,
/obj/vehicle/ridden/janicart,
/obj/item/key/janitor,
/obj/machinery/camera/autoname/directional/west,
/turf/open/floor/iron,
/area/station/service/janitor)
"oT" = (
/obj/effect/turf_decal/stripes/full,
/turf/open/floor/engine,
/area/station/hallway/secondary/entry)
"pi" = (
/obj/machinery/power/apc/auto_name/directional/north,
/obj/structure/cable,
/obj/machinery/atmospherics/pipe/smart/manifold4w/scrubbers/hidden/layer2,
/obj/machinery/atmospherics/pipe/smart/manifold4w/supply/hidden/layer4,
/obj/effect/turf_decal/trimline/green/filled/line{
	dir = 1
	},
/turf/open/floor/iron/white,
/area/station/hallway/secondary/entry)
"qc" = (
/obj/effect/mapping_helpers/airlock/access/all/service/janitor,
/obj/machinery/door/airlock{
	name = "Custodial Closet"
	},
/obj/machinery/atmospherics/pipe/smart/manifold4w/scrubbers/hidden/layer2,
/obj/structure/cable,
/obj/machinery/atmospherics/pipe/smart/manifold4w/supply/hidden/layer4,
/obj/machinery/door/firedoor,
/turf/open/floor/plating,
/area/station/service/janitor)
"rl" = (
/obj/machinery/atmospherics/pipe/smart/manifold4w/supply/hidden/layer4,
/obj/machinery/atmospherics/pipe/smart/manifold4w/scrubbers/hidden/layer2,
/turf/open/floor/iron/white,
/area/station/hallway/secondary/entry)
"rn" = (
/obj/effect/turf_decal/trimline/green/filled/line{
	dir = 4
	},
/obj/effect/turf_decal/siding{
	dir = 1
	},
/obj/item/kirbyplants/random,
/turf/open/floor/iron/white,
/area/station/hallway/secondary/entry)
"rs" = (
/obj/effect/turf_decal/trimline/green/filled/line,
/turf/open/floor/iron/white,
/area/station/hallway/secondary/entry)
"rU" = (
/obj/effect/turf_decal/trimline/green/filled/line{
	dir = 4
	},
/obj/machinery/door/firedoor,
/turf/open/floor/iron/white,
/area/station/hallway/secondary/entry)
"rW" = (
/obj/structure/cable,
/obj/machinery/atmospherics/pipe/smart/manifold4w/supply/hidden/layer4,
/obj/machinery/atmospherics/pipe/smart/manifold4w/scrubbers/hidden/layer2,
/obj/machinery/status_display/shuttle/directional/south{
	shuttle_id = "arrivals_shuttle";
	name = "Interlink shuttle display"
	},
/turf/open/floor/catwalk_floor/flat_white,
/area/station/hallway/secondary/entry)
"sh" = (
/obj/structure/chair/comfy/beige{
	dir = 4
	},
/turf/open/floor/iron/grimy,
/area/station/hallway/secondary/entry)
"td" = (
/obj/effect/turf_decal/sand/plating,
/obj/effect/spawner/random/structure/crate,
/turf/open/floor/plating,
/area/station/asteroid)
"to" = (
/obj/effect/turf_decal/stripes/line,
/obj/machinery/light/dim/directional/east,
/turf/open/floor/engine,
/area/station/hallway/secondary/entry)
"uC" = (
/obj/structure/cable,
/obj/machinery/atmospherics/pipe/smart/manifold4w/supply/hidden/layer4,
/obj/machinery/atmospherics/pipe/smart/manifold4w/scrubbers/hidden/layer2,
/obj/machinery/light/directional/west,
/turf/open/floor/catwalk_floor/flat_white,
/area/station/hallway/secondary/entry)
"vy" = (
/obj/effect/landmark/navigate_destination{
	location = "Public Mining Dock"
	},
/obj/machinery/door/airlock/external{
	name = "Common Mining Dock"
	},
/turf/open/floor/iron,
/area/station/hallway/secondary/entry)
"vB" = (
/obj/structure/cable,
/obj/machinery/atmospherics/pipe/smart/manifold4w/scrubbers/hidden/layer2,
/obj/machinery/atmospherics/pipe/smart/manifold4w/supply/hidden/layer4,
/obj/machinery/airalarm/directional/north,
/obj/effect/turf_decal/trimline/green/filled/line{
	dir = 1
	},
/turf/open/floor/iron/white,
/area/station/hallway/secondary/entry)
"vO" = (
/obj/effect/turf_decal/trimline/green/filled/line{
	dir = 4
	},
/obj/effect/turf_decal/siding,
/obj/structure/closet/emcloset,
/turf/open/floor/iron/white,
/area/station/hallway/secondary/entry)
"wv" = (
/obj/effect/turf_decal/siding{
	dir = 4
	},
/obj/machinery/light/directional/east,
/obj/machinery/door/firedoor,
/turf/open/floor/iron/white,
/area/station/hallway/secondary/entry)
"wP" = (
/obj/effect/landmark/event_spawn,
/turf/open/floor/iron/white,
/area/station/hallway/secondary/entry)
"wW" = (
/obj/structure/cable,
/obj/machinery/atmospherics/pipe/smart/manifold4w/scrubbers/hidden/layer2,
/obj/machinery/atmospherics/pipe/smart/manifold4w/supply/hidden/layer4,
/obj/effect/turf_decal/trimline/green/filled/corner,
/obj/effect/turf_decal/trimline/green/filled/line{
	dir = 1
	},
/turf/open/floor/iron/white,
/area/station/hallway/secondary/entry)
"xs" = (
/turf/open/floor/engine,
/area/station/hallway/secondary/entry)
"yc" = (
/obj/machinery/door/airlock/maintenance,
/obj/effect/mapping_helpers/airlock/unres{
	dir = 1
	},
/obj/effect/mapping_helpers/airlock/access/all/engineering/maintenance,
/obj/machinery/atmospherics/pipe/smart/manifold4w/scrubbers/hidden/layer2,
/obj/structure/cable,
/obj/machinery/atmospherics/pipe/smart/manifold4w/supply/hidden/layer4,
/turf/open/floor/plating,
/area/station/hallway/secondary/entry)
"za" = (
/obj/effect/turf_decal/sand/plating,
/obj/machinery/atmospherics/pipe/smart/manifold4w/supply/hidden/layer4,
/obj/machinery/light/small/dim/directional/west,
/obj/structure/extinguisher_cabinet/directional/north,
/turf/open/floor/plating,
/area/station/asteroid)
"zc" = (
/obj/machinery/door/airlock/maintenance/external/glass,
/obj/effect/mapping_helpers/airlock/access/all/engineering/maintenance,
/obj/effect/mapping_helpers/airlock/unres{
	dir = 8
	},
/obj/machinery/door/firedoor,
/turf/open/floor/engine,
/area/station/hallway/secondary/entry)
"zi" = (
/obj/effect/spawner/random/vending/colavend,
/turf/open/floor/iron/dark/textured_large,
/area/station/hallway/secondary/entry)
"zq" = (
/obj/structure/cable,
/obj/machinery/atmospherics/pipe/smart/manifold4w/supply/hidden/layer4,
/obj/machinery/atmospherics/pipe/smart/manifold4w/scrubbers/hidden/layer2,
/obj/machinery/status_display/shuttle/directional/north{
	name = "Interlink shuttle display";
	shuttle_id = "arrivals_shuttle"
	},
/turf/open/floor/catwalk_floor/flat_white,
/area/station/hallway/secondary/entry)
"zy" = (
/obj/machinery/atmospherics/components/unary/vent_pump/on/layer4{
	dir = 8
	},
/turf/open/floor/iron/white,
/area/station/hallway/secondary/entry)
"zG" = (
/obj/structure/cable,
/obj/machinery/atmospherics/pipe/smart/manifold4w/supply/hidden/layer4,
/obj/machinery/atmospherics/pipe/smart/manifold4w/scrubbers/hidden/layer2,
/obj/machinery/door/firedoor,
/turf/open/floor/catwalk_floor/flat_white,
/area/station/hallway/secondary/entry)
"Az" = (
/obj/machinery/holopad,
/turf/open/floor/iron/white,
/area/station/hallway/secondary/entry)
"AB" = (
/turf/open/floor/iron/grimy,
/area/station/hallway/secondary/entry)
"AL" = (
/obj/structure/cable,
/obj/machinery/atmospherics/pipe/smart/manifold4w/scrubbers/hidden/layer2,
/obj/machinery/atmospherics/pipe/smart/manifold4w/supply/hidden/layer4,
/obj/effect/turf_decal/trimline/green/filled/line{
	dir = 1
	},
/turf/open/floor/iron/white,
/area/station/hallway/secondary/entry)
"AR" = (
/obj/effect/turf_decal/stripes/line,
/turf/open/floor/engine,
/area/station/hallway/secondary/entry)
"Bx" = (
/turf/closed/wall,
/area/station/service/bar)
"CJ" = (
/turf/open/floor/iron/dark/textured_large,
/area/station/hallway/secondary/entry)
"CZ" = (
/obj/effect/turf_decal/trimline/green/filled/line{
	dir = 1
	},
/turf/open/floor/iron/white,
/area/station/hallway/secondary/entry)
"DR" = (
/obj/effect/spawner/structure/window/reinforced,
/turf/open/floor/plating,
/area/station/hallway/secondary/entry)
"Ep" = (
/obj/structure/cable,
/obj/machinery/atmospherics/pipe/smart/manifold4w/supply/hidden/layer4,
/obj/machinery/atmospherics/pipe/smart/manifold4w/scrubbers/hidden/layer2,
/obj/machinery/light/directional/south,
/turf/open/floor/catwalk_floor/flat_white,
/area/station/hallway/secondary/entry)
"Ev" = (
/obj/docking_port/stationary{
	dir = 4;
	dwidth = 1;
	height = 13;
	shuttle_id = "arrivals_stationary";
	name = "arrivals";
	width = 5
	},
/turf/open/floor/engine,
/area/station/hallway/secondary/entry)
"Fi" = (
/obj/structure/cable,
/obj/machinery/atmospherics/pipe/smart/manifold4w/supply/hidden/layer4,
/obj/machinery/atmospherics/pipe/smart/manifold4w/scrubbers/hidden/layer2,
/obj/item/radio/intercom/directional/south,
/turf/open/floor/catwalk_floor/flat_white,
/area/station/hallway/secondary/entry)
"FD" = (
/obj/machinery/atmospherics/components/unary/vent_scrubber/on/layer2{
	dir = 8
	},
/turf/open/floor/iron/white,
/area/station/hallway/secondary/entry)
"Gj" = (
/obj/structure/cable,
/obj/machinery/atmospherics/pipe/smart/manifold4w/supply/hidden/layer4,
/obj/machinery/atmospherics/pipe/smart/manifold4w/scrubbers/hidden/layer2,
/obj/machinery/light/directional/west,
/obj/machinery/door/firedoor,
/turf/open/floor/catwalk_floor/flat_white,
/area/station/hallway/secondary/entry)
"Gs" = (
/obj/effect/turf_decal/trimline/green/filled/line{
	dir = 1
	},
/obj/effect/turf_decal/siding/corner{
	dir = 4
	},
/turf/open/floor/iron/white,
/area/station/hallway/secondary/entry)
"Gx" = (
/obj/effect/turf_decal/siding,
/obj/machinery/atmospherics/pipe/smart/manifold4w/supply/hidden/layer4,
/obj/machinery/atmospherics/pipe/smart/manifold4w/scrubbers/hidden/layer2,
/turf/open/floor/iron/white,
/area/station/hallway/secondary/entry)
"Gz" = (
/obj/effect/decal/cleanable/dirt,
/obj/structure/cable,
/obj/machinery/atmospherics/pipe/smart/manifold4w/scrubbers/hidden/layer2,
/obj/machinery/atmospherics/pipe/smart/manifold4w/supply/hidden/layer4,
/obj/effect/landmark/blobstart,
/turf/open/floor/iron,
/area/station/service/janitor)
"Ha" = (
/obj/structure/cable,
/obj/machinery/atmospherics/pipe/smart/manifold4w/scrubbers/hidden/layer2,
/obj/machinery/atmospherics/pipe/smart/manifold4w/supply/hidden/layer4,
/obj/effect/turf_decal/trimline/green/filled/corner{
	dir = 4
	},
/turf/open/floor/iron/white,
/area/station/hallway/secondary/entry)
"Hc" = (
/obj/effect/turf_decal/trimline/green/filled/line{
	dir = 4
	},
/turf/open/floor/iron/white,
/area/station/hallway/secondary/entry)
"Hf" = (
/obj/effect/turf_decal/trimline/green/filled/line{
	dir = 6
	},
/obj/structure/closet/emcloset,
/turf/open/floor/iron/white,
/area/station/hallway/secondary/entry)
"HG" = (
/obj/machinery/atmospherics/pipe/smart/manifold4w/scrubbers/hidden/layer2,
/obj/machinery/atmospherics/pipe/smart/manifold4w/supply/hidden/layer4,
/obj/structure/cable,
/obj/effect/turf_decal/trimline/green/filled/line{
	dir = 1
	},
/obj/structure/closet/emcloset,
/obj/machinery/incident_display/dual/directional/north,
/turf/open/floor/iron/white,
/area/station/hallway/secondary/entry)
"HO" = (
/obj/effect/turf_decal/trimline/green/filled/corner{
	dir = 8
	},
/turf/open/floor/iron/white,
/area/station/hallway/secondary/entry)
"IS" = (
/turf/open/misc/asteroid,
/area/station/asteroid)
"Jk" = (
/obj/effect/turf_decal/sand/plating,
/obj/machinery/atmospherics/pipe/smart/manifold4w/supply/hidden/layer4,
/obj/machinery/door/airlock/maintenance,
/obj/effect/mapping_helpers/airlock/access/all/engineering/maintenance,
/obj/effect/mapping_helpers/airlock/welded,
/turf/open/floor/plating,
/area/station/asteroid)
"JO" = (
/obj/structure/window/reinforced/spawner/directional/west,
/obj/structure/window/reinforced/spawner/directional/north,
/obj/machinery/computer/shuttle/mining/common{
	pixel_x = 2
	},
/turf/open/floor/plating,
/area/station/hallway/secondary/entry)
"Ky" = (
/obj/machinery/status_display/evac,
/turf/closed/wall,
/area/station/hallway/secondary/entry)
"KA" = (
/obj/effect/turf_decal/siding,
/obj/effect/turf_decal/trimline/green/filled/line{
	dir = 4
	},
/obj/machinery/atmospherics/pipe/smart/manifold4w/supply/hidden/layer4,
/obj/item/kirbyplants/random,
/turf/open/floor/iron/white,
/area/station/hallway/secondary/entry)
"Lf" = (
/obj/effect/turf_decal/siding/corner,
/obj/machinery/atmospherics/pipe/smart/manifold4w/supply/hidden/layer4,
/obj/machinery/atmospherics/pipe/smart/manifold4w/scrubbers/hidden/layer2,
/turf/open/floor/iron/white,
/area/station/hallway/secondary/entry)
"Lm" = (
/obj/effect/turf_decal/siding,
/obj/machinery/atmospherics/pipe/smart/manifold4w/supply/hidden/layer4,
/turf/open/floor/iron/white,
/area/station/hallway/secondary/entry)
"Lr" = (
/obj/machinery/atmospherics/components/unary/vent_scrubber/on/layer2,
/turf/open/floor/iron/white,
/area/station/hallway/secondary/entry)
"LB" = (
/obj/effect/turf_decal/trimline/green/filled/line{
	dir = 4
	},
/obj/machinery/atmospherics/components/unary/vent_pump/on/layer4,
/obj/machinery/light/directional/east,
/turf/open/floor/iron/white,
/area/station/hallway/secondary/entry)
"LE" = (
/obj/structure/cable,
/obj/machinery/atmospherics/pipe/smart/manifold4w/supply/hidden/layer4,
/obj/machinery/atmospherics/pipe/smart/manifold4w/scrubbers/hidden/layer2,
/obj/machinery/firealarm/directional/south,
/turf/open/floor/catwalk_floor/flat_white,
/area/station/hallway/secondary/entry)
"LW" = (
/obj/effect/turf_decal/sand/plating,
/obj/machinery/atmospherics/pipe/smart/manifold4w/supply/hidden/layer4,
/turf/open/floor/plating,
/area/station/asteroid)
"ML" = (
/obj/effect/turf_decal/trimline/green/filled/line,
/obj/effect/turf_decal/siding{
	dir = 4
	},
/turf/open/floor/iron/white,
/area/station/hallway/secondary/entry)
"MQ" = (
/obj/effect/turf_decal/sand/plating,
/obj/item/rack_parts,
/turf/open/floor/plating,
/area/station/asteroid)
"Nk" = (
/obj/structure/table/wood,
/obj/effect/spawner/random/entertainment/deck{
	pixel_x = -2;
	pixel_y = 15
	},
/obj/effect/spawner/random/food_or_drink/snack{
	pixel_x = 5;
	pixel_y = 6
	},
/turf/open/floor/iron/grimy,
/area/station/hallway/secondary/entry)
"Nw" = (
/obj/machinery/door/airlock/maintenance/external/glass,
/obj/effect/mapping_helpers/airlock/access/all/engineering/maintenance,
/obj/effect/mapping_helpers/airlock/unres{
	dir = 4
	},
/turf/open/floor/engine,
/area/station/hallway/secondary/entry)
"NE" = (
/obj/effect/mapping_helpers/airlock/cyclelink_helper{
	dir = 1
	},
/obj/machinery/door/airlock/external{
	name = "Port Docking Bay 1"
	},
/turf/open/floor/plating,
/area/station/hallway/secondary/entry)
"Oc" = (
/obj/effect/landmark/start/hangover,
/turf/open/floor/iron/white,
/area/station/hallway/secondary/entry)
"Oj" = (
/obj/machinery/atmospherics/pipe/smart/manifold4w/supply/hidden/layer4,
/obj/machinery/atmospherics/pipe/smart/manifold4w/scrubbers/hidden/layer2,
/turf/open/misc/asteroid,
/area/station/asteroid)
"Ow" = (
/obj/structure/cable,
/obj/machinery/atmospherics/pipe/smart/manifold4w/supply/hidden/layer4,
/obj/machinery/atmospherics/pipe/smart/manifold4w/scrubbers/hidden/layer2,
/obj/effect/landmark/navigate_destination{
	location = "Arrival Shuttle"
	},
/turf/open/floor/catwalk_floor/flat_white,
/area/station/hallway/secondary/entry)
"Pk" = (
/turf/closed/wall,
/area/station/asteroid)
"Pv" = (
/obj/effect/turf_decal/trimline/green/filled/corner{
	dir = 1
	},
/obj/effect/turf_decal/siding{
	dir = 1
	},
/turf/open/floor/iron/white,
/area/station/hallway/secondary/entry)
"Pz" = (
/obj/effect/turf_decal/siding,
/turf/open/floor/iron/white,
/area/station/hallway/secondary/entry)
"PR" = (
/obj/machinery/vending/coffee,
/turf/open/floor/iron/dark/textured_large,
/area/station/hallway/secondary/entry)
"Qa" = (
/obj/effect/turf_decal/stripes/line{
	dir = 1
	},
/turf/open/floor/engine,
/area/station/hallway/secondary/entry)
"Qy" = (
/turf/open/floor/iron/white,
/area/station/hallway/secondary/entry)
"RM" = (
/obj/machinery/atmospherics/pipe/smart/manifold4w/scrubbers/hidden/layer2,
/obj/machinery/atmospherics/pipe/smart/manifold4w/supply/hidden/layer4,
/obj/structure/cable,
/obj/effect/turf_decal/trimline/green/filled/line{
	dir = 1
	},
/obj/machinery/light/directional/north,
/turf/open/floor/iron/white,
/area/station/hallway/secondary/entry)
"Sc" = (
/obj/structure/table/wood,
/turf/open/floor/iron/grimy,
/area/station/hallway/secondary/entry)
"Ss" = (
/obj/structure/cable,
/obj/machinery/atmospherics/pipe/smart/manifold4w/supply/hidden/layer4,
/obj/machinery/atmospherics/pipe/smart/manifold4w/scrubbers/hidden/layer2,
/obj/machinery/light/directional/north,
/obj/machinery/firealarm/directional/north,
/turf/open/floor/catwalk_floor/flat_white,
/area/station/hallway/secondary/entry)
"SL" = (
/obj/structure/table,
/obj/item/grenade/chem_grenade/cleaner{
	pixel_x = -7;
	pixel_y = 12
	},
/obj/item/grenade/chem_grenade/cleaner{
	pixel_x = -7;
	pixel_y = 12
	},
/obj/item/grenade/chem_grenade/cleaner{
	pixel_x = -7;
	pixel_y = 12
	},
/obj/item/reagent_containers/spray/cleaner,
/obj/item/storage/box/lights/mixed{
	pixel_x = 6;
	pixel_y = 8
	},
/obj/item/storage/box/lights/mixed{
	pixel_x = 6;
	pixel_y = 8
	},
/obj/effect/decal/cleanable/dirt,
/obj/machinery/light/directional/west,
/obj/item/storage/box/mousetraps{
	pixel_x = -3;
	pixel_y = 8
	},
/turf/open/floor/iron,
/area/station/service/janitor)
"SV" = (
/obj/effect/turf_decal/siding{
	dir = 1
	},
/turf/open/floor/iron/white,
/area/station/hallway/secondary/entry)
"Ti" = (
/obj/effect/turf_decal/siding/corner{
	dir = 1
	},
/turf/open/floor/iron/white,
/area/station/hallway/secondary/entry)
"Tk" = (
/obj/structure/closet/l3closet/janitor,
/turf/open/floor/iron,
/area/station/service/janitor)
"Ud" = (
/obj/effect/turf_decal/trimline/green/filled/line{
	dir = 5
	},
/obj/machinery/button/transport/tram/directional/east{
	id = 1
	},
/obj/machinery/transport/destination_sign/indicator/directional/east,
/turf/open/floor/iron/white,
/area/station/hallway/secondary/entry)
"UY" = (
/turf/template_noop,
/area/template_noop)
"Vc" = (
/obj/effect/turf_decal/siding{
	dir = 1
	},
/obj/effect/landmark/start/hangover,
/turf/open/floor/iron/white,
/area/station/hallway/secondary/entry)
"Vy" = (
/obj/structure/cable,
/turf/open/floor/iron,
/area/station/service/janitor)
"WF" = (
/obj/effect/landmark/start/hangover,
/turf/open/floor/iron/grimy,
/area/station/hallway/secondary/entry)
"XE" = (
/obj/machinery/atmospherics/pipe/smart/manifold4w/supply/hidden/layer4,
/obj/machinery/atmospherics/pipe/smart/manifold4w/scrubbers/hidden/layer2,
/obj/structure/cable,
/turf/open/floor/wood/tile,
/area/station/service/bar)
"Yh" = (
/obj/docking_port/stationary/mining_home/common,
/turf/open/floor/engine,
/area/station/hallway/secondary/entry)
"Yn" = (
/obj/effect/turf_decal/stripes/line,
/obj/machinery/light/dim/directional/west,
/turf/open/floor/engine,
/area/station/hallway/secondary/entry)
"YI" = (
/obj/structure/cable,
/obj/machinery/atmospherics/pipe/smart/manifold4w/supply/hidden/layer4,
/obj/machinery/atmospherics/pipe/smart/manifold4w/scrubbers/hidden/layer2,
/obj/item/radio/intercom/directional/north,
/turf/open/floor/catwalk_floor/flat_white,
/area/station/hallway/secondary/entry)
"YV" = (
/obj/effect/turf_decal/siding/corner{
	dir = 4
	},
/turf/open/floor/iron/white,
/area/station/hallway/secondary/entry)
"Zq" = (
/obj/machinery/door/airlock{
	name = "Custodial Closet"
	},
/obj/effect/mapping_helpers/airlock/access/all/service/janitor,
/obj/structure/cable,
/obj/machinery/door/firedoor,
/obj/machinery/atmospherics/pipe/smart/manifold4w/scrubbers/hidden/layer2,
/obj/machinery/atmospherics/pipe/smart/manifold4w/supply/hidden/layer4,
/turf/open/floor/plating,
/area/station/service/bar)

(1,1,1) = {"
UY
UY
UY
UY
Pk
td
za
LW
Jk
UY
UY
UY
UY
UY
UY
UY
UY
UY
UY
UY
UY
"}
(2,1,1) = {"
UY
UY
UY
UY
Pk
td
or
MQ
Pk
UY
UY
UY
UY
UY
UY
UY
UY
UY
UY
UY
UY
"}
(3,1,1) = {"
UY
UY
UY
UY
Pk
Pk
Pk
Pk
Pk
jd
jd
UY
UY
UY
UY
UY
UY
UY
UY
UY
UY
"}
(4,1,1) = {"
UY
UY
UY
UY
jd
xs
Ev
xs
xs
xs
jd
UY
UY
UY
UY
UY
UY
UY
UY
UY
UY
"}
(5,1,1) = {"
UY
jd
jd
jd
jd
xs
xs
xs
xs
xs
jd
IS
IS
UY
UY
UY
UY
UY
UY
UY
UY
"}
(6,1,1) = {"
UY
HG
mk
fp
NE
xs
xs
xs
xs
xs
jd
UY
UY
UY
UY
UY
UY
UY
UY
UY
UY
"}
(7,1,1) = {"
UY
eD
Qy
rW
jd
xs
xs
xs
xs
xs
jd
UY
IS
UY
UY
UY
UY
UY
UY
UY
UY
"}
(8,1,1) = {"
UY
RM
Qy
fp
iJ
xs
xs
xs
xs
xs
jd
IS
IS
UY
UY
UY
IS
IS
IS
IS
UY
"}
(9,1,1) = {"
yc
fv
Qy
fp
iJ
xs
xs
xs
xs
xs
jd
Nw
jd
jd
jd
jd
jd
jd
jd
Oj
UY
"}
(10,1,1) = {"
UY
Gs
Qy
fp
iJ
xs
xs
xs
xs
xs
Yn
oT
dt
xs
xs
xs
xs
xs
jd
dv
UY
"}
(11,1,1) = {"
md
Pv
Qy
fp
iJ
xs
xs
xs
xs
xs
AR
oT
Qa
xs
xs
xs
xs
xs
jd
hV
bg
"}
(12,1,1) = {"
zi
SV
Qy
fp
iJ
xs
xs
xs
xs
xs
AR
oT
Qa
xs
xs
xs
xs
xs
DR
fp
rs
"}
(13,1,1) = {"
jG
SV
Qy
rW
jd
xs
xs
xs
xs
xs
AR
oT
Qa
xs
xs
xs
xs
Yh
vy
fp
rs
"}
(14,1,1) = {"
mT
Ti
Oc
Ow
NE
xs
xs
xs
xs
xs
AR
oT
Qa
xs
xs
xs
xs
xs
JO
fp
rs
"}
(15,1,1) = {"
CZ
wP
Qy
Fi
jd
xs
xs
xs
xs
xs
AR
oT
Qa
xs
xs
xs
xs
xs
jd
YI
rs
"}
(16,1,1) = {"
CZ
Qy
Qy
LE
jd
xs
xs
xs
xs
xs
to
oT
bb
xs
xs
xs
xs
xs
jd
Ss
rs
"}
(17,1,1) = {"
CZ
Qy
Qy
Ep
Ky
jd
jd
jd
jd
jd
jd
zc
jd
iJ
iJ
iJ
iJ
iJ
jd
zq
rs
"}
(18,1,1) = {"
CZ
Qy
rl
fp
uC
mE
fp
fp
fp
fp
zG
fp
uC
fp
fp
fp
fp
fp
Gj
fp
rs
"}
(19,1,1) = {"
CZ
Qy
rl
Qy
Qy
Qy
Qy
ca
Hc
Hc
rU
Hc
Hc
Ha
Qy
hI
kd
Qy
al
Qy
rs
"}
(20,1,1) = {"
CZ
Qy
Lf
bv
bv
bv
YV
rs
Qy
Qy
Qy
Qy
Qy
AL
Qy
zy
FD
Qy
al
Qy
rs
"}
(21,1,1) = {"
CZ
Lr
Gx
sh
sh
sh
SV
HO
Qy
Qy
Qy
Qy
Qy
pi
lO
bv
bv
bv
wv
bv
ML
"}
(22,1,1) = {"
CZ
Az
Lm
gp
Nk
Sc
Vc
ca
Qy
Qy
Qy
Qy
Qy
vB
Pz
AB
WF
AB
Ky
CJ
CJ
"}
(23,1,1) = {"
Ud
LB
KA
fd
cq
fd
rn
Hf
Qy
Qy
Qy
Qy
Qy
wW
vO
fd
lb
fd
jd
PR
jG
"}
(24,1,1) = {"
UY
UY
UY
UY
UY
UY
UY
UY
Qy
Qy
Qy
Qy
Qy
qc
iW
UY
UY
UY
UY
UY
UY
"}
(25,1,1) = {"
UY
UY
UY
UY
UY
UY
UY
UY
UY
UY
UY
XE
Zq
Gz
Vy
Tk
oz
SL
UY
UY
UY
"}
(26,1,1) = {"
UY
UY
UY
UY
UY
UY
UY
UY
UY
UY
UY
UY
Bx
iW
fx
UY
UY
UY
UY
UY
UY
"}
