//MAP CONVERTED BY dmm2tgm.py THIS HEADER COMMENT PREVENTS RECONVERSION, DO NOT REMOVE
"aD" = (
/obj/structure/table/reinforced,
/obj/effect/spawner/random/food_or_drink/donkpockets,
/obj/effect/spawner/random/food_or_drink/donkpockets,
/obj/item/reagent_containers/condiment/mayonnaise{
	pixel_x = 9;
	pixel_y = 6
	},
/obj/item/reagent_containers/condiment/donksauce{
	pixel_x = 11;
	pixel_y = 15
	},
/turf/open/floor/iron/large,
/area/station/commons/kiosk)
"dp" = (
/obj/effect/turf_decal/siding/white{
	dir = 8
	},
/obj/effect/turf_decal/siding/white{
	dir = 8
	},
/turf/open/floor/iron/large,
/area/station/commons/kiosk)
"eG" = (
/obj/machinery/atmospherics/components/unary/vent_pump/on/layer4,
/turf/open/floor/iron/dark,
/area/station/commons/kiosk)
"eL" = (
/obj/effect/turf_decal/siding/white{
	dir = 4
	},
/turf/open/floor/iron/dark,
/area/station/commons/kiosk)
"eM" = (
/obj/structure/window/reinforced/spawner/directional/east,
/obj/structure/window/reinforced/spawner/directional/north,
/obj/structure/rack,
/obj/structure/rack,
/obj/structure/rack,
/obj/effect/spawner/random/entertainment/lighter,
/obj/effect/spawner/random/entertainment/lighter,
/obj/effect/spawner/random/entertainment/cigarette_pack,
/obj/effect/spawner/random/entertainment/cigarette_pack,
/obj/effect/spawner/random/entertainment/cigarette_pack,
/obj/effect/spawner/random/entertainment/cigarette_pack,
/turf/open/floor/iron/freezer{
	baseturfs = /turf/open/misc/asteroid/basalt/lava_land_surface
	},
/area/station/commons/kiosk)
"fj" = (
/obj/effect/turf_decal/siding/white{
	dir = 4
	},
/obj/effect/landmark/start/assistant,
/turf/open/floor/iron/dark,
/area/station/commons/kiosk)
"fM" = (
/obj/structure/rack,
/obj/item/food/sticko{
	pixel_y = 2;
	pixel_x = 6
	},
/obj/item/food/sticko/nutty{
	pixel_y = 5;
	pixel_x = -5
	},
/turf/open/floor/iron/large,
/area/station/commons/kiosk)
"gu" = (
/obj/effect/turf_decal/siding/white/corner{
	dir = 8
	},
/obj/effect/turf_decal/siding/white/corner{
	dir = 1
	},
/turf/open/floor/iron/dark,
/area/station/commons/kiosk)
"gD" = (
/obj/structure/disposalpipe/segment{
	dir = 4
	},
/obj/machinery/power/apc/auto_name/directional/north,
/obj/structure/cable,
/turf/open/floor/iron/dark,
/area/station/commons/kiosk)
"iB" = (
/obj/structure/closet/secure_closet/freezer/fridge,
/obj/item/reagent_containers/condiment/soymilk,
/obj/item/reagent_containers/condiment/soymilk,
/obj/item/reagent_containers/condiment/milk,
/obj/item/reagent_containers/condiment/milk,
/obj/item/reagent_containers/cup/glass/bottle/juice/cream,
/obj/item/reagent_containers/cup/glass/bottle/juice/cream,
/obj/item/reagent_containers/cup/glass/ice,
/obj/item/reagent_containers/cup/glass/ice,
/obj/item/reagent_containers/condiment/sugar,
/obj/item/reagent_containers/condiment/sugar,
/obj/effect/turf_decal/bot_white,
/obj/item/storage/pill_bottle/happinesspsych{
	pixel_x = -4;
	pixel_y = -1
	},
/obj/structure/extinguisher_cabinet/directional/north,
/turf/open/floor/iron/dark/textured_large,
/area/station/commons/kiosk)
"jR" = (
/obj/structure/rack,
/obj/item/food/chips{
	pixel_x = 7
	},
/obj/item/food/chips{
	pixel_y = 7;
	pixel_x = -4
	},
/obj/item/food/chips/shrimp{
	pixel_y = 10;
	pixel_x = 7
	},
/obj/item/food/chips/shrimp{
	pixel_y = -4;
	pixel_x = -5
	},
/turf/open/floor/iron/large,
/area/station/commons/kiosk)
"kp" = (
/obj/item/food/popsicle/creamsicle_berry{
	pixel_y = 4;
	pixel_x = -1
	},
/obj/item/food/popsicle/creamsicle_berry{
	pixel_y = 1;
	pixel_x = 5
	},
/obj/item/food/popsicle/creamsicle_orange,
/obj/item/food/popsicle/creamsicle_orange{
	pixel_y = 6;
	pixel_x = 3
	},
/obj/structure/closet/crate/freezer,
/obj/item/food/cornuto{
	pixel_y = -5;
	pixel_x = -3
	},
/obj/item/food/cornuto{
	pixel_y = -5;
	pixel_x = 2
	},
/obj/item/food/cornuto{
	pixel_y = 4;
	pixel_x = -3
	},
/obj/item/food/cornuto{
	pixel_y = 5;
	pixel_x = 6
	},
/obj/structure/marker_beacon/teal,
/obj/structure/sign/poster/fluff/lizards_gas_payment/directional/north,
/turf/open/floor/iron/freezer{
	baseturfs = /turf/open/misc/asteroid/basalt/lava_land_surface
	},
/area/station/commons/kiosk)
"kV" = (
/obj/machinery/door/window/brigdoor/left/directional/east,
/obj/structure/sign/poster/fluff/lizards_gas_power/directional/north,
/turf/open/floor/iron/large,
/area/station/commons/kiosk)
"mi" = (
/obj/effect/turf_decal/siding/white{
	dir = 4
	},
/obj/structure/extinguisher_cabinet/directional/north,
/turf/open/floor/iron/dark,
/area/station/commons/kiosk)
"mo" = (
/obj/effect/turf_decal/siding/white{
	dir = 8
	},
/turf/open/floor/iron/dark,
/area/station/commons/kiosk)
"mC" = (
/obj/effect/turf_decal/siding/white,
/obj/effect/turf_decal/siding/white{
	dir = 1
	},
/obj/effect/landmark/start/assistant,
/turf/open/floor/iron/dark,
/area/station/commons/kiosk)
"nO" = (
/obj/item/storage/fancy/egg_box,
/obj/item/storage/fancy/egg_box{
	pixel_y = 9
	},
/obj/item/storage/fancy/pickles_jar,
/obj/structure/closet/crate/freezer,
/obj/structure/marker_beacon/teal,
/obj/structure/window/reinforced/spawner/directional/south,
/turf/open/floor/iron/freezer{
	baseturfs = /turf/open/misc/asteroid/basalt/lava_land_surface
	},
/area/station/commons/kiosk)
"oj" = (
/obj/effect/turf_decal/siding/white{
	dir = 8
	},
/obj/machinery/vending/cola/pwr_game{
	pixel_x = 2
	},
/obj/item/radio/intercom/directional/north,
/turf/open/floor/iron/dark,
/area/station/commons/kiosk)
"oV" = (
/obj/item/reagent_containers/condiment/bbqsauce{
	pixel_y = 17;
	pixel_x = 9
	},
/obj/item/reagent_containers/condiment/hotsauce{
	pixel_y = 15;
	pixel_x = -8
	},
/obj/item/reagent_containers/condiment/coldsauce{
	pixel_x = -9;
	pixel_y = 5
	},
/obj/item/reagent_containers/condiment/donksauce{
	pixel_x = 1;
	pixel_y = 15
	},
/obj/item/reagent_containers/condiment/mayonnaise{
	pixel_x = 6;
	pixel_y = 6
	},
/obj/item/food/bun,
/obj/item/food/bun,
/obj/item/food/bun,
/obj/structure/table/reinforced,
/obj/machinery/light/cold/directional/west,
/turf/open/floor/iron/dark/textured_large,
/area/station/commons/kiosk)
"pr" = (
/obj/structure/cable,
/obj/machinery/atmospherics/pipe/smart/manifold4w/supply/hidden/layer4,
/obj/machinery/atmospherics/pipe/smart/manifold4w/scrubbers/hidden/layer2,
/obj/effect/turf_decal/siding/white{
	dir = 8
	},
/obj/structure/disposalpipe/segment,
/turf/open/floor/iron/dark,
/area/station/commons/kiosk)
"rB" = (
/turf/open/misc/asteroid,
/area/station/asteroid)
"sx" = (
/obj/structure/table/reinforced,
/obj/item/food/rootbread_peanut_butter_jelly{
	pixel_x = 2;
	pixel_y = 2
	},
/obj/item/food/rootbread_peanut_butter_banana{
	pixel_y = 12;
	pixel_x = -3
	},
/obj/item/radio/intercom/directional/west,
/turf/open/floor/iron/dark/textured_large,
/area/station/commons/kiosk)
"sR" = (
/obj/effect/turf_decal/siding/white,
/obj/effect/turf_decal/siding/white{
	dir = 1
	},
/obj/effect/landmark/start/hangover,
/turf/open/floor/iron/dark,
/area/station/commons/kiosk)
"sY" = (
/obj/machinery/atmospherics/pipe/smart/manifold4w/scrubbers/hidden/layer2,
/obj/machinery/atmospherics/pipe/smart/manifold4w/supply/hidden/layer4,
/obj/structure/cable,
/obj/machinery/door/airlock/public/glass{
	name = "Wawastation Convienence Store"
	},
/obj/structure/disposalpipe/segment,
/turf/open/floor/iron/dark,
/area/station/commons/kiosk)
"td" = (
/obj/structure/cable,
/obj/machinery/atmospherics/pipe/smart/manifold4w/scrubbers/hidden/layer2,
/obj/effect/turf_decal/siding/white{
	dir = 8
	},
/obj/structure/disposalpipe/segment,
/obj/effect/landmark/start/hangover,
/turf/open/floor/iron/dark,
/area/station/commons/kiosk)
"to" = (
/obj/structure/cable,
/obj/machinery/atmospherics/pipe/smart/manifold4w/scrubbers/hidden/layer2,
/obj/effect/turf_decal/siding/white{
	dir = 8
	},
/obj/structure/disposalpipe/segment,
/turf/open/floor/iron/dark,
/area/station/commons/kiosk)
"tH" = (
/obj/effect/turf_decal/siding/white{
	dir = 8
	},
/obj/machinery/light/cold/directional/north,
/obj/machinery/light_switch/default_on/directional/north,
/turf/open/floor/iron/large,
/area/station/commons/kiosk)
"uq" = (
/obj/item/reagent_containers/condiment/yoghurt{
	pixel_x = -3;
	pixel_y = 1
	},
/obj/item/reagent_containers/condiment/yoghurt{
	pixel_x = 6;
	pixel_y = -1
	},
/obj/structure/closet/crate/freezer,
/obj/item/reagent_containers/condiment/milk,
/obj/item/reagent_containers/condiment/soymilk,
/obj/item/reagent_containers/condiment/soymilk,
/obj/structure/sign/poster/contraband/moffuchis_pizza/directional/north,
/obj/structure/window/reinforced/spawner/directional/east,
/turf/open/floor/iron/freezer{
	baseturfs = /turf/open/misc/asteroid/basalt/lava_land_surface
	},
/area/station/commons/kiosk)
"uD" = (
/obj/machinery/griddle/frontier_tabletop,
/obj/item/food/raw_sausage,
/obj/item/food/raw_sausage{
	pixel_y = 4
	},
/obj/item/food/raw_sausage{
	pixel_y = 9
	},
/obj/structure/table/reinforced,
/turf/open/floor/iron/dark/textured_large,
/area/station/commons/kiosk)
"vb" = (
/obj/structure/rack,
/obj/item/food/cornchips/random,
/obj/item/food/cornchips/random{
	pixel_x = 8;
	pixel_y = -5
	},
/obj/item/food/cornchips/random{
	pixel_y = 4;
	pixel_x = -5
	},
/obj/item/food/cornchips/random{
	pixel_y = -7;
	pixel_x = -5
	},
/obj/item/food/cornchips/random{
	pixel_y = -7;
	pixel_x = 3
	},
/obj/item/food/cornchips/random{
	pixel_x = 5;
	pixel_y = 6
	},
/turf/open/floor/iron/large,
/area/station/commons/kiosk)
"vH" = (
/obj/structure/rack,
/turf/open/floor/iron/large,
/area/station/commons/kiosk)
"zd" = (
/obj/effect/turf_decal/siding/white{
	dir = 8
	},
/obj/machinery/airalarm/directional/north,
/obj/structure/disposalpipe/segment{
	dir = 6
	},
/turf/open/floor/iron/dark,
/area/station/commons/kiosk)
"BU" = (
/obj/item/storage/cans/sixbeer,
/obj/item/storage/cans/sixsoda,
/obj/structure/closet/crate/freezer,
/obj/structure/window/reinforced/spawner/directional/west,
/obj/structure/window/reinforced/spawner/directional/south,
/turf/open/floor/iron/freezer{
	baseturfs = /turf/open/misc/asteroid/basalt/lava_land_surface
	},
/area/station/commons/kiosk)
"Ck" = (
/obj/structure/table/reinforced,
/obj/machinery/light/cold/directional/east,
/turf/open/floor/iron/large,
/area/station/commons/kiosk)
"DA" = (
/obj/structure/window/fulltile,
/turf/open/floor/iron/dark,
/area/station/commons/kiosk)
"El" = (
/obj/effect/turf_decal/siding/white{
	dir = 1
	},
/obj/effect/turf_decal/siding/white,
/obj/effect/landmark/start/assistant,
/turf/open/floor/iron/dark,
/area/station/commons/kiosk)
"ER" = (
/obj/machinery/atmospherics/pipe/smart/manifold4w/scrubbers/hidden/layer2,
/obj/structure/cable,
/obj/effect/landmark/start/assistant,
/turf/open/floor/iron/dark,
/area/station/commons/kiosk)
"Fg" = (
/obj/structure/table/reinforced,
/obj/machinery/coffeemaker/impressa,
/obj/item/reagent_containers/cup/glass/mug{
	pixel_x = -7;
	pixel_y = 20
	},
/obj/item/reagent_containers/cup/glass/mug{
	pixel_x = 1;
	pixel_y = 20
	},
/obj/item/reagent_containers/cup/glass/mug{
	pixel_x = 9;
	pixel_y = 20
	},
/turf/open/floor/iron/dark/textured_large,
/area/station/commons/kiosk)
"FM" = (
/obj/effect/turf_decal/siding/white{
	dir = 4
	},
/obj/machinery/light/cold/directional/north,
/obj/structure/disposalpipe/trunk{
	dir = 8
	},
/obj/machinery/disposal/bin,
/obj/machinery/firealarm/directional/north,
/turf/open/floor/iron/dark,
/area/station/commons/kiosk)
"GB" = (
/turf/template_noop,
/area/template_noop)
"Ht" = (
/obj/effect/turf_decal/siding/white{
	dir = 1
	},
/obj/effect/turf_decal/siding/white,
/turf/open/floor/iron/dark,
/area/station/commons/kiosk)
"Hy" = (
/obj/effect/turf_decal/siding/white{
	dir = 8
	},
/obj/machinery/light/cold/directional/east,
/turf/open/floor/iron/dark,
/area/station/commons/kiosk)
"HE" = (
/obj/structure/table/reinforced,
/obj/structure/cable,
/obj/item/food/donut/berry{
	pixel_y = 14;
	pixel_x = -6
	},
/obj/item/food/donut/berry{
	pixel_y = 11;
	pixel_x = -6
	},
/obj/item/food/donut/berry{
	pixel_y = 8;
	pixel_x = -6
	},
/obj/item/food/donut/jelly/choco{
	name = "boston cream donut";
	pixel_x = 8;
	pixel_y = 14
	},
/obj/item/food/donut/jelly/choco{
	name = "boston cream donut";
	pixel_x = 8;
	pixel_y = 11
	},
/obj/item/food/donut/jelly/choco{
	name = "boston cream donut";
	pixel_x = 8;
	pixel_y = 8
	},
/obj/item/food/cakeslice/pound_cake_slice{
	pixel_x = -7
	},
/obj/item/food/cakeslice/pound_cake_slice{
	pixel_x = -7;
	pixel_y = -3
	},
/obj/item/food/cakeslice/pound_cake_slice{
	pixel_x = -7;
	pixel_y = -6
	},
/obj/item/food/cakeslice/hardware_cake_slice{
	name = "synth cake slice";
	pixel_x = 7
	},
/obj/item/food/cakeslice/hardware_cake_slice{
	name = "synth cake slice";
	pixel_x = 7;
	pixel_y = -3
	},
/obj/item/food/cakeslice/hardware_cake_slice{
	name = "synth cake slice";
	pixel_x = 7;
	pixel_y = -6
	},
/obj/structure/window/reinforced/spawner/directional/east,
/obj/structure/window/reinforced/spawner/directional/south,
/turf/open/floor/iron/freezer{
	baseturfs = /turf/open/misc/asteroid/basalt/lava_land_surface
	},
/area/station/commons/kiosk)
"JK" = (
/obj/machinery/computer/atmos_control/noreconnect{
	atmos_chambers = list("lizardgaslava"="Plasma Supply");
	dir = 8;
	name = "gas tank monitor";
	desc = "This computer connects to and controls the sensors and equipment in a nearby pressurised gas reservoir."
	},
/turf/open/floor/iron/large,
/area/station/commons/kiosk)
"KL" = (
/obj/structure/table/reinforced,
/obj/item/reagent_containers/cup/bottle/syrup_bottle/liqueur{
	pixel_x = 13;
	pixel_y = 16
	},
/obj/item/reagent_containers/cup/bottle/syrup_bottle/caramel{
	pixel_y = 16;
	pixel_x = 3
	},
/obj/item/reagent_containers/cup/bottle/syrup_bottle/korta_nectar{
	pixel_y = 16;
	pixel_x = -7
	},
/obj/item/storage/fancy/coffee_condi_display{
	pixel_x = -6;
	pixel_y = 3
	},
/obj/item/storage/box/coffeepack{
	pixel_x = 9;
	pixel_y = 8
	},
/obj/item/reagent_containers/cup/glass/bottle/juice/cream{
	pixel_x = 8;
	pixel_y = 1
	},
/turf/open/floor/iron/dark/textured_large,
/area/station/commons/kiosk)
"LI" = (
/turf/closed/wall,
/area/station/commons/kiosk)
"NP" = (
/obj/structure/table/reinforced,
/turf/open/floor/iron/large,
/area/station/commons/kiosk)
"Ps" = (
/obj/effect/turf_decal/siding/white/corner{
	dir = 4
	},
/obj/effect/turf_decal/siding/white/corner,
/obj/effect/landmark/start/hangover,
/turf/open/floor/iron/dark,
/area/station/commons/kiosk)
"PA" = (
/obj/effect/turf_decal/siding/white/corner{
	dir = 1
	},
/obj/effect/turf_decal/siding/white/corner{
	dir = 8
	},
/obj/machinery/firealarm/directional/east,
/obj/effect/landmark/start/hangover,
/turf/open/floor/iron/dark,
/area/station/commons/kiosk)
"PP" = (
/obj/effect/turf_decal/siding/white/corner,
/obj/effect/turf_decal/siding/white/corner{
	dir = 4
	},
/turf/open/floor/iron/dark,
/area/station/commons/kiosk)
"Qs" = (
/obj/structure/rack,
/obj/item/reagent_containers/condiment/vegetable_oil{
	pixel_y = 5;
	pixel_x = -1
	},
/obj/item/reagent_containers/condiment/vegetable_oil{
	pixel_y = 1;
	pixel_x = 3
	},
/obj/item/reagent_containers/condiment/olive_oil,
/turf/open/floor/iron/large,
/area/station/commons/kiosk)
"Ri" = (
/obj/effect/turf_decal/siding/white{
	dir = 4
	},
/obj/effect/landmark/start/hangover,
/turf/open/floor/iron/dark,
/area/station/commons/kiosk)
"Tq" = (
/obj/structure/rack,
/obj/item/food/candy,
/obj/item/food/candy,
/obj/item/food/candy,
/obj/item/food/chocolatebar,
/obj/item/food/chocolatebar{
	pixel_y = 3
	},
/obj/item/food/chocolatebar{
	pixel_y = 6
	},
/turf/open/floor/iron/large,
/area/station/commons/kiosk)
"Tx" = (
/obj/structure/table/reinforced,
/obj/machinery/microwave/frontier_printed,
/obj/structure/sign/poster/contraband/microwave/directional/east,
/turf/open/floor/iron/large,
/area/station/commons/kiosk)
"TJ" = (
/obj/machinery/atmospherics/components/unary/vent_scrubber/on/layer2{
	dir = 1
	},
/turf/open/floor/iron/dark,
/area/station/commons/kiosk)
"TQ" = (
/obj/machinery/door/airlock/public/glass{
	name = "Wawastation Convienence Store"
	},
/turf/open/floor/iron/dark,
/area/station/commons/kiosk)
"TZ" = (
/turf/open/floor/iron/dark,
/area/station/commons/kiosk)
"Ur" = (
/obj/structure/closet/crate/freezer,
/obj/item/food/vendor_tray_meal/sushi,
/obj/item/food/vendor_tray_meal/sushi,
/obj/item/food/vendor_tray_meal/sushi,
/obj/item/food/vendor_tray_meal/sushi,
/obj/item/food/vendor_tray_meal/sushi,
/obj/item/food/nigiri_sushi,
/obj/item/food/nigiri_sushi,
/obj/item/food/nigiri_sushi,
/obj/item/food/nigiri_sushi,
/obj/item/food/nigiri_sushi,
/obj/structure/window/reinforced/spawner/directional/west,
/obj/structure/sign/poster/contraband/starkist/directional/north,
/turf/open/floor/iron/freezer{
	baseturfs = /turf/open/misc/asteroid/basalt/lava_land_surface
	},
/area/station/commons/kiosk)
"Wm" = (
/obj/item/food/cheese/mozzarella{
	pixel_y = 5;
	pixel_x = -5
	},
/obj/item/food/cheese/mozzarella{
	pixel_y = -4;
	pixel_x = 1
	},
/obj/item/food/cheese/wheel,
/obj/item/food/cheese/cheese_curds,
/obj/item/food/cheese/curd_cheese,
/obj/structure/closet/crate/freezer,
/obj/structure/window/reinforced/spawner/directional/east,
/obj/structure/window/reinforced/spawner/directional/south,
/turf/open/floor/iron/freezer{
	baseturfs = /turf/open/misc/asteroid/basalt/lava_land_surface
	},
/area/station/commons/kiosk)
"XL" = (
/obj/effect/turf_decal/siding/white{
	dir = 8
	},
/turf/open/floor/iron/large,
/area/station/commons/kiosk)
"Yh" = (
/obj/effect/turf_decal/siding/white{
	dir = 8
	},
/obj/effect/landmark/start/assistant,
/turf/open/floor/iron/dark,
/area/station/commons/kiosk)
"ZP" = (
/obj/machinery/atmospherics/pipe/smart/manifold4w/supply/hidden/layer4,
/turf/open/floor/iron/dark,
/area/station/commons/kiosk)

(1,1,1) = {"
GB
GB
GB
GB
GB
GB
GB
GB
GB
GB
"}
(2,1,1) = {"
GB
LI
iB
KL
Fg
sx
oV
uD
DA
GB
"}
(3,1,1) = {"
GB
LI
tH
dp
XL
dp
XL
XL
DA
GB
"}
(4,1,1) = {"
GB
LI
kV
eM
HE
JK
NP
NP
DA
GB
"}
(5,1,1) = {"
GB
LI
zd
to
to
td
pr
pr
sY
GB
"}
(6,1,1) = {"
GB
LI
gD
ER
TJ
eG
ZP
TZ
DA
GB
"}
(7,1,1) = {"
GB
LI
FM
Ps
eL
fj
PP
Ri
TQ
GB
"}
(8,1,1) = {"
GB
LI
Ur
El
BU
Qs
mC
vb
DA
GB
"}
(9,1,1) = {"
GB
LI
kp
Ht
nO
fM
sR
jR
DA
GB
"}
(10,1,1) = {"
GB
LI
uq
El
Wm
vH
sR
Tq
DA
GB
"}
(11,1,1) = {"
GB
LI
oj
PA
Hy
Yh
gu
mo
DA
GB
"}
(12,1,1) = {"
GB
LI
LI
LI
LI
mi
eL
Ri
DA
GB
"}
(13,1,1) = {"
GB
rB
rB
rB
LI
Tx
Ck
aD
DA
GB
"}
(14,1,1) = {"
GB
rB
rB
rB
LI
LI
LI
LI
LI
GB
"}
