//MAP CONVERTED BY dmm2tgm.py THIS HEADER COMMENT PREVENTS RECONVERSION, DO NOT REMOVE
"a" = (
/obj/effect/turf_decal/tile/purple{
	dir = 1
	},
/obj/effect/turf_decal/tile/purple,
/obj/structure/disposalpipe/segment,
/turf/open/floor/iron,
/area/station/service/barber)
"b" = (
/obj/effect/turf_decal/tile/purple{
	dir = 1
	},
/obj/effect/turf_decal/tile/purple,
/obj/item/kirbyplants/random,
/obj/machinery/firealarm/directional/south,
/obj/machinery/light/warm/directional/south,
/turf/open/floor/iron,
/area/station/service/barber)
"f" = (
/obj/effect/turf_decal/tile/purple{
	dir = 1
	},
/obj/effect/turf_decal/tile/purple,
/obj/machinery/dryer,
/turf/closed/wall,
/area/station/service/barber)
"g" = (
/obj/effect/turf_decal/tile/purple{
	dir = 1
	},
/obj/effect/turf_decal/tile/purple,
/obj/machinery/door/airlock/public/glass{
	name = "Massage Parlour"
	},
/obj/structure/curtain/cloth/fancy/mechanical{
	id = "barbershopcurtains1"
	},
/obj/machinery/atmospherics/pipe/smart/manifold4w/supply/hidden/layer4,
/obj/machinery/atmospherics/pipe/smart/manifold4w/scrubbers/hidden/layer2,
/turf/open/floor/iron,
/area/station/service/barber)
"i" = (
/obj/machinery/camera/directional/north{
	c_tag = "Salon"
	},
/obj/effect/turf_decal/tile/purple{
	dir = 1
	},
/obj/effect/turf_decal/tile/purple,
/obj/structure/disposalpipe/segment{
	dir = 4
	},
/obj/structure/cable,
/obj/machinery/atmospherics/pipe/smart/manifold4w/supply/hidden/layer4,
/obj/machinery/atmospherics/pipe/smart/manifold4w/scrubbers/hidden/layer2,
/turf/open/floor/iron,
/area/station/service/barber)
"k" = (
/obj/effect/turf_decal/tile/purple{
	dir = 1
	},
/obj/effect/turf_decal/tile/purple,
/obj/structure/chair/comfy/barber_chair{
	dir = 1
	},
/turf/open/floor/iron,
/area/station/service/barber)
"m" = (
/obj/effect/turf_decal/tile/purple{
	dir = 1
	},
/obj/effect/turf_decal/tile/purple,
/obj/machinery/vending/barbervend,
/turf/open/floor/iron,
/area/station/service/barber)
"n" = (
/obj/effect/turf_decal/tile/purple{
	dir = 1
	},
/obj/effect/turf_decal/tile/purple,
/obj/structure/sink/directional/west,
/obj/structure/mirror/directional/east,
/obj/machinery/atmospherics/pipe/smart/manifold4w/scrubbers/hidden/layer2,
/turf/open/floor/iron,
/area/station/service/barber)
"o" = (
/turf/template_noop,
/area/template_noop)
"p" = (
/obj/effect/turf_decal/tile/purple{
	dir = 1
	},
/obj/effect/turf_decal/tile/purple,
/obj/structure/cable,
/obj/machinery/atmospherics/pipe/smart/manifold4w/scrubbers/hidden/layer2,
/obj/machinery/atmospherics/pipe/smart/manifold4w/supply/hidden/layer4,
/obj/structure/disposalpipe/segment{
	dir = 4
	},
/turf/open/floor/iron,
/area/station/service/barber)
"q" = (
/obj/effect/turf_decal/tile/purple{
	dir = 1
	},
/obj/effect/turf_decal/tile/purple,
/obj/machinery/door/window/right/directional/east,
/turf/open/floor/iron,
/area/station/service/barber)
"r" = (
/turf/template_noop,
/area/station/service/barber)
"s" = (
/obj/structure/curtain/cloth/fancy/mechanical{
	id = "barbershopcurtains1"
	},
/obj/effect/spawner/structure/window,
/turf/open/floor/plating,
/area/station/service/barber)
"u" = (
/obj/structure/table/glass,
/obj/effect/turf_decal/tile/purple{
	dir = 1
	},
/obj/effect/turf_decal/tile/purple,
/obj/item/reagent_containers/dropper,
/obj/item/hairbrush/comb{
	pixel_y = 10
	},
/obj/structure/mirror/directional/north,
/turf/open/floor/iron,
/area/station/service/barber)
"v" = (
/obj/effect/turf_decal/tile/purple{
	dir = 1
	},
/obj/effect/turf_decal/tile/purple,
/obj/structure/disposalpipe/trunk{
	dir = 8
	},
/obj/machinery/disposal/bin,
/obj/structure/window/spawner/directional/east,
/turf/open/floor/iron,
/area/station/service/barber)
"x" = (
/obj/effect/turf_decal/tile/purple{
	dir = 1
	},
/obj/effect/turf_decal/tile/purple,
/obj/machinery/atmospherics/pipe/smart/manifold4w/supply/hidden/layer4,
/obj/machinery/atmospherics/pipe/smart/manifold4w/scrubbers/hidden/layer2,
/turf/open/floor/iron,
/area/station/service/barber)
"z" = (
/obj/effect/turf_decal/tile/purple{
	dir = 1
	},
/obj/effect/turf_decal/tile/purple,
/obj/structure/disposalpipe/segment{
	dir = 9
	},
/obj/machinery/power/apc/auto_name/directional/east,
/obj/structure/cable,
/obj/machinery/atmospherics/components/unary/vent_pump/on/layer4{
	dir = 8
	},
/turf/open/floor/iron,
/area/station/service/barber)
"A" = (
/obj/effect/turf_decal/tile/purple{
	dir = 1
	},
/obj/effect/turf_decal/tile/purple,
/obj/machinery/atmospherics/components/unary/vent_scrubber/on/layer2{
	dir = 1
	},
/turf/open/floor/iron,
/area/station/service/barber)
"B" = (
/obj/effect/turf_decal/tile/purple{
	dir = 1
	},
/obj/effect/turf_decal/tile/purple,
/obj/machinery/light/warm/directional/south,
/obj/structure/chair/sofa/bench/right{
	dir = 1
	},
/turf/open/floor/iron,
/area/station/service/barber)
"C" = (
/obj/effect/turf_decal/tile/purple{
	dir = 1
	},
/obj/effect/turf_decal/tile/purple,
/obj/effect/landmark/start/barber,
/obj/effect/landmark/event_spawn,
/obj/machinery/button/curtain{
	id = "barbershopcurtains1";
	pixel_y = 32
	},
/obj/machinery/atmospherics/pipe/smart/manifold4w/supply/hidden/layer4,
/obj/machinery/atmospherics/pipe/smart/manifold4w/scrubbers/hidden/layer2,
/turf/open/floor/iron,
/area/station/service/barber)
"D" = (
/obj/effect/turf_decal/tile/purple{
	dir = 1
	},
/obj/effect/turf_decal/tile/purple,
/obj/structure/disposalpipe/segment{
	dir = 6
	},
/obj/machinery/firealarm/directional/north,
/obj/item/kirbyplants/random,
/turf/open/floor/iron,
/area/station/service/barber)
"E" = (
/obj/effect/turf_decal/tile/purple{
	dir = 1
	},
/obj/effect/turf_decal/tile/purple,
/obj/machinery/atmospherics/pipe/smart/manifold4w/scrubbers/hidden/layer2,
/obj/structure/cable,
/obj/structure/disposalpipe/segment{
	dir = 4
	},
/turf/open/floor/iron,
/area/station/service/barber)
"F" = (
/obj/effect/turf_decal/tile/purple{
	dir = 1
	},
/obj/effect/turf_decal/tile/purple,
/obj/effect/landmark/event_spawn,
/obj/structure/chair/office/light{
	dir = 4
	},
/obj/machinery/atmospherics/components/unary/vent_pump/on/layer4{
	dir = 1
	},
/turf/open/floor/iron,
/area/station/service/barber)
"G" = (
/obj/effect/turf_decal/tile/purple{
	dir = 1
	},
/obj/effect/turf_decal/tile/purple,
/turf/open/floor/iron,
/area/station/service/barber)
"H" = (
/obj/effect/turf_decal/tile/purple{
	dir = 1
	},
/obj/effect/turf_decal/tile/purple,
/obj/machinery/light/small/directional/east,
/turf/open/floor/iron,
/area/station/service/barber)
"I" = (
/obj/machinery/light/warm/directional/north,
/obj/effect/turf_decal/tile/purple{
	dir = 1
	},
/obj/effect/turf_decal/tile/purple,
/obj/structure/table/glass,
/obj/item/reagent_containers/spray/quantum_hair_dye{
	pixel_x = 6
	},
/obj/item/lipstick/random,
/turf/open/floor/iron,
/area/station/service/barber)
"L" = (
/obj/effect/turf_decal/tile/purple{
	dir = 1
	},
/obj/effect/turf_decal/tile/purple,
/obj/structure/chair/sofa/bench/left{
	dir = 1
	},
/obj/effect/landmark/start/hangover,
/turf/open/floor/iron,
/area/station/service/barber)
"M" = (
/obj/effect/turf_decal/tile/purple{
	dir = 1
	},
/obj/effect/turf_decal/tile/purple,
/obj/structure/chair/sofa/bench/right,
/turf/open/floor/iron,
/area/station/service/barber)
"N" = (
/obj/effect/turf_decal/tile/purple{
	dir = 1
	},
/obj/effect/turf_decal/tile/purple,
/obj/machinery/airalarm/directional/south,
/turf/open/floor/iron,
/area/station/service/barber)
"O" = (
/obj/effect/turf_decal/tile/purple{
	dir = 1
	},
/obj/effect/turf_decal/tile/purple,
/obj/structure/table/wood,
/obj/item/lipstick/random,
/turf/open/floor/iron,
/area/station/service/barber)
"P" = (
/obj/effect/turf_decal/tile/purple{
	dir = 1
	},
/obj/effect/turf_decal/tile/purple,
/obj/machinery/light_switch/directional/south,
/obj/item/kirbyplants/random,
/turf/open/floor/iron,
/area/station/service/barber)
"Q" = (
/obj/effect/turf_decal/tile/purple{
	dir = 1
	},
/obj/effect/turf_decal/tile/purple,
/obj/structure/table/glass,
/obj/item/lipstick/random,
/obj/item/hairbrush,
/turf/open/floor/iron,
/area/station/service/barber)
"R" = (
/obj/effect/turf_decal/tile/purple{
	dir = 1
	},
/obj/effect/turf_decal/tile/purple,
/turf/closed/wall,
/area/station/service/barber)
"S" = (
/obj/effect/turf_decal/tile/purple{
	dir = 1
	},
/obj/effect/turf_decal/tile/purple,
/obj/structure/bed/pod,
/obj/machinery/atmospherics/components/unary/vent_scrubber/on/layer2{
	dir = 1
	},
/obj/effect/landmark/start/hangover,
/turf/open/floor/iron,
/area/station/service/barber)
"T" = (
/obj/effect/turf_decal/tile/purple{
	dir = 1
	},
/obj/effect/turf_decal/tile/purple,
/obj/structure/closet/secure_closet/barber,
/turf/open/floor/iron,
/area/station/service/barber)
"U" = (
/obj/effect/turf_decal/tile/purple{
	dir = 1
	},
/obj/effect/turf_decal/tile/purple,
/obj/structure/chair/sofa/bench/left,
/turf/open/floor/iron,
/area/station/service/barber)
"V" = (
/turf/closed/wall,
/area/station/service/barber)
"X" = (
/obj/effect/turf_decal/tile/purple{
	dir = 1
	},
/obj/effect/turf_decal/tile/purple,
/obj/structure/table/glass,
/obj/item/razor{
	pixel_x = -6
	},
/obj/item/reagent_containers/spray/barbers_aid{
	pixel_x = 6
	},
/turf/open/floor/iron,
/area/station/service/barber)
"Y" = (
/obj/effect/turf_decal/tile/purple{
	dir = 1
	},
/obj/effect/turf_decal/tile/purple,
/obj/structure/table/wood,
/obj/item/book/manual/fish_catalog,
/turf/open/floor/iron,
/area/station/service/barber)

(1,1,1) = {"
o
o
o
o
r
r
r
r
r
r
r
o
"}
(2,1,1) = {"
o
o
o
V
u
k
E
M
Y
L
V
o
"}
(3,1,1) = {"
o
o
o
V
I
G
p
U
O
B
V
o
"}
(4,1,1) = {"
o
o
o
V
X
k
i
x
A
P
V
o
"}
(5,1,1) = {"
o
o
o
V
D
a
z
x
G
N
V
o
"}
(6,1,1) = {"
o
o
o
V
v
q
R
g
s
s
V
o
"}
(7,1,1) = {"
o
o
o
V
m
G
R
C
F
b
V
o
"}
(8,1,1) = {"
o
o
o
V
T
H
f
n
S
Q
V
o
"}
(9,1,1) = {"
o
o
o
V
V
V
V
V
V
V
V
o
"}
(10,1,1) = {"
o
o
o
o
o
o
o
o
o
o
o
o
"}
(11,1,1) = {"
o
o
o
o
o
o
o
o
o
o
o
o
"}
(12,1,1) = {"
o
o
o
o
o
o
o
o
o
o
o
o
"}
