//MAP CONVERTED BY dmm2tgm.py THIS HEADER COMMENT PREVENTS RECONVERSION, DO NOT REMOVE
"a" = (
/turf/open/floor/fake_snow/safe,
/area/trainstation/outdoor/rails)
"q" = (
/obj/structure/flora/bush/snow/style_random,
/turf/open/floor/fake_snow/safe,
/area/trainstation/outdoor/rails)
"A" = (
/turf/closed/indestructible/train_border,
/area/trainstation/outdoor/rails)
"B" = (
/obj/structure/flora/grass/green/style_3,
/turf/open/floor/fake_snow/safe,
/area/trainstation/outdoor/rails)
"U" = (
/obj/structure/flora/tree/pine/style_random,
/turf/open/floor/fake_snow/safe,
/area/trainstation/outdoor/rails)

(1,1,1) = {"
A
a
a
a
a
a
a
a
U
a
a
a
U
U
a
"}
(2,1,1) = {"
A
a
a
a
U
q
a
a
a
q
a
a
a
a
U
"}
(3,1,1) = {"
A
a
a
a
a
a
a
a
a
a
a
B
a
a
a
"}
(4,1,1) = {"
A
a
a
q
a
B
a
a
a
q
a
a
a
a
a
"}
(5,1,1) = {"
A
a
a
a
a
a
a
U
U
a
a
a
U
U
a
"}
(6,1,1) = {"
A
a
a
a
U
a
a
a
a
q
a
a
a
a
U
"}
(7,1,1) = {"
A
a
a
a
a
a
a
a
a
a
a
B
a
a
a
"}
(8,1,1) = {"
A
a
a
a
U
q
a
a
a
q
a
a
a
a
a
"}
(9,1,1) = {"
A
a
a
a
a
a
a
a
a
a
a
a
a
U
a
"}
(10,1,1) = {"
A
a
a
q
a
B
a
a
U
a
a
a
a
a
U
"}
(11,1,1) = {"
A
a
a
a
a
a
a
U
a
a
B
a
a
a
a
"}
(12,1,1) = {"
A
a
a
a
U
a
a
a
a
a
a
a
a
a
U
"}
(13,1,1) = {"
A
a
a
a
a
a
a
a
U
a
a
a
U
U
a
"}
(14,1,1) = {"
A
a
a
B
a
a
q
a
a
q
a
a
a
a
U
"}
(15,1,1) = {"
A
a
a
a
a
a
a
a
a
a
a
B
a
a
a
"}
(16,1,1) = {"
A
a
a
a
U
q
a
a
a
q
a
a
a
a
U
"}
(17,1,1) = {"
A
a
a
a
a
a
a
a
a
a
a
a
a
U
a
"}
(18,1,1) = {"
A
a
a
q
a
B
a
a
U
a
a
a
U
U
a
"}
(19,1,1) = {"
A
a
a
a
a
a
a
U
a
q
a
a
a
a
U
"}
(20,1,1) = {"
A
a
a
a
U
a
a
a
a
a
a
B
a
a
a
"}
(21,1,1) = {"
A
a
a
a
a
a
a
a
a
q
a
a
a
a
a
"}
(22,1,1) = {"
A
a
a
a
U
q
a
a
a
a
a
a
a
U
a
"}
(23,1,1) = {"
A
a
a
a
a
a
a
a
U
a
a
a
a
a
U
"}
(24,1,1) = {"
A
a
a
q
a
B
a
a
a
a
B
a
a
a
a
"}
(25,1,1) = {"
A
a
a
a
a
a
a
U
a
a
a
a
a
a
U
"}
(26,1,1) = {"
A
a
a
a
U
a
a
a
U
a
a
a
U
U
a
"}
(27,1,1) = {"
A
a
a
a
a
a
a
U
a
q
a
a
a
a
U
"}
(28,1,1) = {"
A
a
a
B
a
a
q
a
a
a
a
B
a
a
a
"}
(29,1,1) = {"
A
a
a
a
a
a
a
a
a
q
a
a
a
a
U
"}
(30,1,1) = {"
A
a
U
a
a
a
U
a
a
a
a
a
a
U
a
"}
(31,1,1) = {"
A
a
a
q
a
a
a
a
a
a
a
a
a
a
a
"}
(32,1,1) = {"
A
a
a
a
a
B
a
U
U
a
a
a
U
U
a
"}
(33,1,1) = {"
A
a
a
q
a
a
a
a
a
q
a
a
a
a
U
"}
(34,1,1) = {"
A
a
a
a
a
a
a
a
a
a
a
B
a
a
a
"}
(35,1,1) = {"
A
a
U
a
a
a
a
U
a
q
a
a
a
a
U
"}
(36,1,1) = {"
A
a
a
a
B
a
a
a
a
a
a
a
a
U
a
"}
(37,1,1) = {"
A
a
a
a
a
a
a
a
U
a
a
a
a
a
a
"}
(38,1,1) = {"
A
a
U
a
a
a
U
a
a
a
B
a
a
a
a
"}
(39,1,1) = {"
A
a
a
q
a
a
a
a
a
a
a
a
a
a
U
"}
(40,1,1) = {"
A
a
a
a
a
B
a
a
U
a
a
a
U
U
a
"}
(41,1,1) = {"
A
a
a
q
a
a
a
U
a
q
a
a
a
a
a
"}
(42,1,1) = {"
A
a
a
a
a
a
a
a
a
a
a
B
a
a
a
"}
(43,1,1) = {"
A
a
a
a
a
a
a
a
a
q
a
a
a
a
U
"}
(44,1,1) = {"
A
a
U
a
a
a
U
a
a
a
a
a
a
U
a
"}
(45,1,1) = {"
A
a
a
q
a
a
a
a
a
a
a
a
a
a
a
"}
(46,1,1) = {"
A
a
a
a
a
B
a
U
U
a
a
a
U
U
a
"}
(47,1,1) = {"
A
a
a
q
a
a
a
a
a
a
a
a
a
a
U
"}
(48,1,1) = {"
A
a
a
a
a
a
a
a
U
a
a
a
U
U
a
"}
(49,1,1) = {"
A
a
U
a
a
U
a
U
a
q
a
a
a
a
U
"}
(50,1,1) = {"
A
a
a
a
B
a
q
a
a
a
a
B
a
a
a
"}
(51,1,1) = {"
A
a
a
a
a
a
a
a
a
q
a
a
a
a
a
"}
(52,1,1) = {"
A
a
U
a
a
a
q
a
a
a
a
a
a
U
a
"}
(53,1,1) = {"
A
a
a
q
a
a
a
a
U
a
a
a
a
a
U
"}
(54,1,1) = {"
A
a
a
a
a
U
a
a
a
a
B
a
a
a
a
"}
(55,1,1) = {"
A
a
a
q
a
a
a
U
a
a
a
a
a
a
a
"}
(56,1,1) = {"
A
a
a
a
a
a
a
a
U
a
a
a
U
U
a
"}
(57,1,1) = {"
A
a
a
a
a
U
a
U
a
q
a
a
a
a
U
"}
(58,1,1) = {"
A
a
U
a
a
a
q
a
a
a
a
B
a
a
a
"}
(59,1,1) = {"
A
a
a
a
a
a
a
a
a
q
a
a
a
a
a
"}
(60,1,1) = {"
A
a
U
a
a
a
q
a
a
a
a
a
a
U
a
"}
(61,1,1) = {"
A
a
a
q
a
a
a
a
a
a
a
a
a
a
U
"}
(62,1,1) = {"
A
a
a
a
a
a
a
U
U
a
a
a
U
U
a
"}
(63,1,1) = {"
A
a
a
q
a
U
a
a
a
q
a
a
a
a
U
"}
(64,1,1) = {"
A
a
a
a
a
a
q
a
a
a
a
B
a
a
a
"}
(65,1,1) = {"
A
a
U
a
a
a
a
U
a
q
a
a
a
a
U
"}
(66,1,1) = {"
A
a
U
a
a
a
q
a
a
a
a
a
a
U
a
"}
(67,1,1) = {"
A
a
a
q
a
a
a
a
U
a
a
a
a
a
a
"}
(68,1,1) = {"
A
a
a
a
a
U
a
a
a
a
a
a
a
U
a
"}
(69,1,1) = {"
A
a
a
q
a
a
a
a
a
a
a
a
a
a
U
"}
(70,1,1) = {"
A
a
a
a
a
a
a
a
U
a
a
a
U
U
a
"}
(71,1,1) = {"
A
a
U
a
a
U
a
U
a
q
a
a
a
a
a
"}
(72,1,1) = {"
A
a
a
a
B
a
q
a
a
a
a
B
a
a
a
"}
(73,1,1) = {"
A
a
a
a
a
a
a
a
a
q
a
a
a
a
U
"}
(74,1,1) = {"
A
a
U
a
a
a
q
a
a
a
a
a
a
U
a
"}
(75,1,1) = {"
A
a
a
q
a
a
a
a
U
a
a
a
a
a
a
"}
(76,1,1) = {"
A
a
a
a
a
a
a
U
a
a
q
a
a
a
a
"}
(77,1,1) = {"
A
a
a
q
a
U
a
a
a
a
a
a
a
a
U
"}
(78,1,1) = {"
A
a
a
a
a
a
a
a
a
a
a
a
a
a
a
"}
(79,1,1) = {"
A
a
a
a
a
U
a
U
a
U
a
a
a
U
U
"}
(80,1,1) = {"
A
a
U
a
a
a
q
a
a
a
q
a
a
a
a
"}
(81,1,1) = {"
A
a
a
q
a
a
a
a
B
a
a
a
B
a
a
"}
(82,1,1) = {"
A
a
a
a
a
a
q
a
a
a
q
a
a
a
a
"}
(83,1,1) = {"
A
a
a
q
a
a
a
a
a
a
a
a
a
a
U
"}
(84,1,1) = {"
A
a
a
a
a
U
a
U
a
U
a
a
a
a
a
"}
(85,1,1) = {"
A
a
U
a
a
a
a
a
a
a
a
a
a
a
U
"}
(86,1,1) = {"
A
a
a
a
B
a
a
a
a
a
a
a
a
a
a
"}
(87,1,1) = {"
A
a
a
a
a
U
a
a
U
a
a
a
U
U
a
"}
(88,1,1) = {"
A
a
U
a
a
a
q
a
a
q
a
a
a
a
U
"}
(89,1,1) = {"
A
a
a
q
a
a
a
a
a
a
a
B
a
a
a
"}
(90,1,1) = {"
A
a
a
a
a
a
q
B
a
q
a
a
a
a
a
"}
(91,1,1) = {"
A
a
a
q
a
a
a
a
a
a
a
a
a
U
a
"}
(92,1,1) = {"
A
a
a
a
a
a
a
a
U
a
a
a
a
a
U
"}
(93,1,1) = {"
A
a
a
a
a
U
a
a
a
a
B
a
a
a
a
"}
(94,1,1) = {"
A
a
U
a
a
a
q
a
a
a
a
a
a
a
U
"}
(95,1,1) = {"
A
a
a
a
a
a
a
a
U
a
a
a
U
U
a
"}
(96,1,1) = {"
A
a
U
a
a
a
q
U
a
q
a
a
a
a
U
"}
(97,1,1) = {"
A
a
a
q
a
a
a
a
a
a
a
B
a
a
a
"}
(98,1,1) = {"
A
a
a
a
a
U
a
a
a
q
a
a
a
a
U
"}
(99,1,1) = {"
A
a
a
q
a
a
a
a
a
a
a
a
a
U
a
"}
(100,1,1) = {"
A
a
a
a
a
a
a
a
a
a
a
a
a
a
a
"}
(101,1,1) = {"
A
a
U
a
a
U
a
a
U
a
a
a
U
U
a
"}
(102,1,1) = {"
A
a
a
a
B
a
q
a
a
q
a
a
a
a
U
"}
(103,1,1) = {"
A
a
a
a
a
a
a
B
a
a
a
B
a
a
a
"}
(104,1,1) = {"
A
a
U
a
a
a
q
a
a
q
a
a
a
a
U
"}
(105,1,1) = {"
A
a
a
q
a
a
a
a
a
a
a
a
a
U
a
"}
(106,1,1) = {"
A
a
a
a
a
U
a
a
U
a
a
a
a
a
a
"}
(107,1,1) = {"
A
a
a
q
a
a
a
a
a
a
B
a
a
a
a
"}
(108,1,1) = {"
A
a
a
a
a
a
a
a
a
a
a
a
a
a
U
"}
(109,1,1) = {"
A
a
a
a
a
a
a
U
U
a
a
a
U
U
a
"}
(110,1,1) = {"
A
a
U
a
a
a
U
a
a
q
a
a
a
a
a
"}
(111,1,1) = {"
A
a
a
q
a
a
a
a
a
a
a
B
a
a
a
"}
(112,1,1) = {"
A
a
a
a
a
B
a
B
a
q
a
a
a
a
U
"}
(113,1,1) = {"
A
a
a
q
a
a
a
a
a
a
a
a
a
U
a
"}
(114,1,1) = {"
A
a
a
a
a
a
a
a
a
a
a
a
a
a
a
"}
(115,1,1) = {"
A
a
U
a
a
a
U
a
U
a
a
a
U
U
a
"}
(116,1,1) = {"
A
a
a
a
a
a
a
a
a
a
a
a
a
a
U
"}
(117,1,1) = {"
A
a
a
a
a
a
a
a
U
a
a
a
U
U
a
"}
(118,1,1) = {"
A
a
U
a
a
U
a
U
a
q
a
a
a
a
U
"}
(119,1,1) = {"
A
a
a
q
a
a
q
a
a
a
a
B
a
a
a
"}
(120,1,1) = {"
A
a
a
a
a
a
a
a
a
q
a
a
a
a
a
"}
(121,1,1) = {"
A
a
a
q
a
a
a
a
a
a
a
a
a
U
a
"}
(122,1,1) = {"
A
a
a
a
a
a
a
U
U
a
a
a
a
a
U
"}
(123,1,1) = {"
A
a
U
a
a
a
a
a
a
a
B
a
a
a
a
"}
(124,1,1) = {"
A
a
a
a
q
a
a
a
a
a
a
a
a
a
a
"}
(125,1,1) = {"
A
a
a
a
a
a
a
a
U
a
a
a
U
U
a
"}
(126,1,1) = {"
A
a
a
a
a
a
a
a
a
q
a
a
a
a
U
"}
(127,1,1) = {"
A
a
a
U
a
a
a
U
a
a
a
B
a
a
a
"}
(128,1,1) = {"
A
a
a
a
q
a
a
a
a
q
a
a
a
a
a
"}
(129,1,1) = {"
A
a
B
a
a
a
B
a
a
a
a
a
a
U
a
"}
(130,1,1) = {"
A
a
a
a
q
a
a
a
a
a
a
a
a
a
U
"}
(131,1,1) = {"
A
a
a
a
a
a
a
a
U
a
a
a
U
U
a
"}
(132,1,1) = {"
A
a
a
U
a
a
a
a
a
q
a
a
a
a
U
"}
(133,1,1) = {"
A
a
a
a
a
a
a
a
a
a
a
B
a
a
a
"}
(134,1,1) = {"
A
a
a
a
a
a
a
a
a
q
a
a
a
a
U
"}
(135,1,1) = {"
A
a
U
a
a
a
U
U
a
a
a
a
a
U
a
"}
(136,1,1) = {"
A
a
a
q
a
a
a
a
U
a
a
a
a
a
a
"}
(137,1,1) = {"
A
a
a
a
a
B
a
a
a
a
a
a
a
U
a
"}
(138,1,1) = {"
A
a
a
U
a
q
a
a
a
a
a
a
a
a
U
"}
(139,1,1) = {"
A
a
a
a
a
a
a
a
U
a
a
a
U
U
a
"}
(140,1,1) = {"
A
a
B
a
a
a
a
a
a
q
a
a
a
a
a
"}
(141,1,1) = {"
A
a
a
a
U
a
a
a
a
a
a
B
a
a
a
"}
(142,1,1) = {"
A
a
a
U
a
a
a
a
a
q
a
a
a
a
U
"}
(143,1,1) = {"
A
a
a
a
U
a
a
a
a
a
a
a
a
U
a
"}
(144,1,1) = {"
A
a
q
a
a
q
a
a
U
a
a
a
a
a
a
"}
(145,1,1) = {"
A
a
a
a
a
a
a
B
a
a
q
a
a
a
a
"}
(146,1,1) = {"
A
a
a
U
a
q
a
a
a
a
a
a
a
a
U
"}
(147,1,1) = {"
A
a
a
a
a
a
a
a
a
a
a
a
a
a
a
"}
(148,1,1) = {"
A
a
a
U
U
a
a
a
a
U
a
a
a
U
U
"}
(149,1,1) = {"
A
a
a
a
a
a
B
a
a
a
q
a
a
a
a
"}
(150,1,1) = {"
A
a
q
a
a
a
a
a
B
a
a
a
B
a
a
"}
(151,1,1) = {"
A
a
a
a
U
a
a
a
a
a
q
a
a
a
a
"}
(152,1,1) = {"
A
a
a
U
a
q
a
a
a
a
a
a
a
a
U
"}
(153,1,1) = {"
A
a
a
a
a
a
a
B
a
U
a
a
a
a
a
"}
(154,1,1) = {"
A
a
B
a
a
q
a
a
a
a
a
a
a
a
U
"}
(155,1,1) = {"
A
a
a
a
a
a
a
a
a
a
a
a
a
a
a
"}
(156,1,1) = {"
A
a
a
U
a
a
a
a
U
a
a
a
U
U
U
"}
(157,1,1) = {"
A
a
a
a
U
a
a
a
a
q
a
a
a
a
a
"}
(158,1,1) = {"
A
a
q
a
a
q
a
a
a
a
a
B
a
a
a
"}
(159,1,1) = {"
A
a
a
a
a
a
a
B
a
a
a
a
a
a
U
"}
(160,1,1) = {"
A
a
a
U
a
q
a
a
a
a
U
a
a
U
a
"}
(161,1,1) = {"
A
a
a
a
a
a
a
a
a
U
a
a
a
a
a
"}
(162,1,1) = {"
A
a
a
U
U
a
a
a
a
a
a
a
U
U
a
"}
(163,1,1) = {"
A
a
a
a
a
a
a
a
a
U
a
a
a
a
U
"}
(164,1,1) = {"
A
a
a
U
a
a
a
a
a
a
U
a
U
U
a
"}
(165,1,1) = {"
A
a
a
a
U
a
a
a
U
U
a
a
a
a
U
"}
(166,1,1) = {"
A
a
q
a
a
q
a
a
a
a
a
B
a
a
a
"}
(167,1,1) = {"
A
a
a
a
a
a
a
B
a
a
a
a
a
a
a
"}
(168,1,1) = {"
A
a
a
U
a
q
a
a
a
a
U
a
a
U
a
"}
(169,1,1) = {"
A
a
a
a
a
a
a
a
a
U
a
a
a
a
U
"}
(170,1,1) = {"
A
a
B
a
U
a
a
a
a
a
a
a
a
a
a
"}
(171,1,1) = {"
A
a
a
a
a
a
q
a
a
a
a
a
a
a
a
"}
(172,1,1) = {"
A
a
a
U
a
a
a
a
a
a
U
a
U
U
a
"}
(173,1,1) = {"
A
a
a
a
a
a
a
a
a
a
a
a
a
a
U
"}
(174,1,1) = {"
A
a
q
a
a
U
a
a
a
U
U
B
a
a
a
"}
(175,1,1) = {"
A
a
a
a
a
a
q
a
a
a
a
a
a
a
a
"}
(176,1,1) = {"
A
a
a
U
B
a
a
a
B
a
a
a
a
U
a
"}
(177,1,1) = {"
A
a
a
a
a
a
q
a
a
a
a
a
a
a
U
"}
(178,1,1) = {"
A
a
a
U
a
a
a
a
a
a
U
a
U
U
a
"}
(179,1,1) = {"
A
a
a
a
a
U
a
a
a
a
a
a
a
a
U
"}
(180,1,1) = {"
A
a
q
a
a
a
a
a
a
a
U
B
a
a
a
"}
(181,1,1) = {"
A
a
a
a
a
a
a
a
a
a
a
a
a
a
U
"}
(182,1,1) = {"
A
a
a
U
U
a
a
a
U
U
U
a
a
U
a
"}
(183,1,1) = {"
A
a
a
a
a
q
a
a
a
a
a
a
a
a
a
"}
(184,1,1) = {"
A
a
a
U
a
a
a
B
a
a
a
a
a
U
a
"}
(185,1,1) = {"
A
a
a
a
a
a
a
a
a
a
a
a
a
a
U
"}
(186,1,1) = {"
A
a
a
U
q
a
a
a
U
a
a
a
U
U
a
"}
(187,1,1) = {"
A
a
a
a
a
a
a
a
a
q
a
a
a
a
a
"}
(188,1,1) = {"
A
a
q
a
B
a
a
B
a
a
a
B
a
a
a
"}
(189,1,1) = {"
A
a
a
a
a
a
U
a
a
q
a
a
a
a
U
"}
(190,1,1) = {"
A
a
a
U
a
a
a
a
a
a
a
a
a
U
a
"}
(191,1,1) = {"
A
a
a
a
a
a
a
a
U
a
a
a
a
a
a
"}
(192,1,1) = {"
A
a
a
a
a
a
a
U
a
a
q
a
a
a
a
"}
(193,1,1) = {"
A
a
a
a
U
a
a
a
a
a
a
a
a
a
U
"}
(194,1,1) = {"
A
a
a
a
a
a
a
a
a
a
a
a
a
a
a
"}
(195,1,1) = {"
A
a
a
a
U
q
a
a
a
U
a
a
a
U
U
"}
(196,1,1) = {"
A
a
a
a
a
a
a
a
a
a
q
a
a
a
a
"}
(197,1,1) = {"
A
a
a
q
a
B
a
a
B
a
a
a
B
a
a
"}
(198,1,1) = {"
A
a
a
a
a
a
a
U
a
a
q
a
a
a
a
"}
(199,1,1) = {"
A
a
a
a
U
a
a
a
a
a
a
a
a
a
U
"}
(200,1,1) = {"
A
a
a
a
a
a
a
a
a
U
a
a
a
a
a
"}
(201,1,1) = {"
A
a
a
a
U
a
a
a
a
a
a
a
a
a
U
"}
(202,1,1) = {"
A
a
a
a
a
a
a
a
a
a
a
a
a
a
a
"}
(203,1,1) = {"
A
a
a
U
q
a
a
a
U
a
a
a
U
U
U
"}
(204,1,1) = {"
A
a
a
a
a
a
a
a
a
q
a
a
a
a
a
"}
(205,1,1) = {"
A
a
q
a
B
a
a
B
a
a
a
B
a
a
a
"}
(206,1,1) = {"
A
a
a
a
a
a
a
a
a
a
a
a
a
a
a
"}
(207,1,1) = {"
A
a
a
a
U
q
a
a
a
U
a
a
a
U
U
"}
(208,1,1) = {"
A
a
a
a
a
a
a
a
a
a
q
a
a
a
a
"}
(209,1,1) = {"
A
a
a
q
a
B
a
a
B
a
a
a
B
a
a
"}
(210,1,1) = {"
A
a
a
a
a
a
a
U
a
a
q
a
a
a
a
"}
(211,1,1) = {"
A
a
a
a
U
a
a
a
a
a
a
a
a
a
U
"}
(212,1,1) = {"
A
a
a
a
a
a
a
a
a
a
a
a
a
a
a
"}
(213,1,1) = {"
A
a
a
a
U
q
a
a
a
U
a
a
a
U
U
"}
(214,1,1) = {"
A
a
a
a
a
a
a
a
a
a
q
a
a
a
a
"}
(215,1,1) = {"
A
a
a
q
a
B
a
a
B
a
a
a
B
a
a
"}
(216,1,1) = {"
A
a
a
a
a
a
a
U
a
a
q
a
a
a
a
"}
(217,1,1) = {"
A
a
a
a
U
a
a
a
a
a
a
a
a
a
U
"}
(218,1,1) = {"
A
a
a
a
a
a
a
a
a
U
a
a
a
a
a
"}
(219,1,1) = {"
A
a
a
B
a
a
q
a
a
a
a
B
a
a
a
"}
(220,1,1) = {"
A
a
a
a
a
a
a
a
a
a
a
a
a
a
a
"}
(221,1,1) = {"
A
a
a
a
U
q
a
a
a
U
a
a
a
U
U
"}
(222,1,1) = {"
A
a
a
a
a
a
a
a
a
a
q
a
a
a
a
"}
(223,1,1) = {"
A
a
a
q
a
B
a
a
B
a
a
a
B
a
a
"}
(224,1,1) = {"
A
a
a
a
a
a
a
U
a
a
q
a
a
a
a
"}
(225,1,1) = {"
A
a
a
a
U
a
a
a
a
a
a
a
a
a
U
"}
(226,1,1) = {"
A
a
a
a
a
a
a
a
a
a
a
a
a
a
a
"}
(227,1,1) = {"
A
a
a
a
U
q
a
a
a
U
a
a
a
U
U
"}
(228,1,1) = {"
A
a
a
a
a
a
a
a
a
a
q
a
a
a
a
"}
(229,1,1) = {"
A
a
a
q
a
B
a
a
B
a
a
a
B
a
a
"}
(230,1,1) = {"
A
a
a
a
a
a
a
U
a
a
q
a
a
a
a
"}
(231,1,1) = {"
A
a
a
a
U
a
a
a
a
a
a
a
a
a
U
"}
(232,1,1) = {"
A
a
a
a
a
a
a
a
a
U
a
a
a
a
a
"}
(233,1,1) = {"
A
a
a
B
a
a
q
a
a
a
a
B
a
a
a
"}
(234,1,1) = {"
A
a
a
a
a
a
a
a
a
a
a
a
a
a
a
"}
(235,1,1) = {"
A
a
a
a
U
q
a
a
a
U
a
a
a
U
U
"}
(236,1,1) = {"
A
a
a
a
a
a
a
a
a
a
q
a
a
a
a
"}
(237,1,1) = {"
A
a
a
q
a
B
a
a
B
a
a
a
B
a
a
"}
(238,1,1) = {"
A
a
a
a
a
a
a
U
a
a
q
a
a
a
a
"}
(239,1,1) = {"
A
a
a
a
U
a
a
a
a
a
a
a
a
a
U
"}
(240,1,1) = {"
A
a
a
a
a
a
a
a
a
a
a
a
a
a
a
"}
(241,1,1) = {"
A
a
a
a
U
q
a
a
a
U
a
a
a
U
U
"}
(242,1,1) = {"
A
a
a
a
a
a
a
a
a
a
a
a
a
a
a
"}
(243,1,1) = {"
A
a
a
a
U
q
a
a
a
U
a
a
a
U
U
"}
(244,1,1) = {"
A
a
a
a
a
a
a
a
a
a
q
a
a
a
a
"}
(245,1,1) = {"
A
a
a
q
a
B
a
a
B
a
a
a
B
a
a
"}
(246,1,1) = {"
A
a
a
a
a
a
a
U
a
a
q
a
a
a
a
"}
(247,1,1) = {"
A
a
a
a
U
a
a
a
a
a
a
a
a
a
U
"}
(248,1,1) = {"
A
a
a
a
a
a
a
a
a
U
a
a
a
a
a
"}
(249,1,1) = {"
A
a
a
B
a
a
q
a
a
a
a
B
a
a
a
"}
(250,1,1) = {"
A
a
a
a
a
a
a
a
a
a
a
a
a
a
a
"}
(251,1,1) = {"
A
a
a
a
U
q
a
a
a
U
a
a
a
U
U
"}
(252,1,1) = {"
A
a
a
a
a
a
a
a
a
a
q
a
a
a
a
"}
(253,1,1) = {"
A
a
a
q
a
B
a
a
B
a
a
a
B
a
a
"}
(254,1,1) = {"
A
a
a
a
a
a
a
U
a
a
q
a
a
a
a
"}
(255,1,1) = {"
A
a
a
a
U
a
a
a
a
a
a
a
a
a
U
"}
