//MAP CONVERTED BY dmm2tgm.py THIS HEADER COMMENT PREVENTS RECONVERSION, DO NOT REMOVE
"ch" = (
/obj/structure/chair/sofa/middle/brown{
	dir = 8
	},
/turf/open/floor/carpet,
/area/trainstation/indoors/station)
"cH" = (
/obj/effect/spawner/random/structure/shipping_container/blank,
/turf/open/misc/asphalt,
/area/trainstation/indoors/station)
"dh" = (
/obj/effect/spawner/random/structure/shipping_container/station_appropriate,
/turf/open/misc/asphalt,
/area/trainstation/indoors/station)
"ds" = (
/obj/effect/spawner/random/structure/shipping_container/gas,
/turf/open/misc/asphalt,
/area/trainstation/indoors/station)
"eQ" = (
/obj/structure/chair/sofa/left/brown{
	dir = 8
	},
/turf/open/floor/carpet,
/area/trainstation/indoors/station)
"gm" = (
/obj/effect/spawner/random/structure/shipping_container/gas,
/obj/effect/decal/cleanable/dirt,
/turf/open/misc/asphalt/no_border,
/area/trainstation/indoors/station)
"gn" = (
/obj/structure/chair/sofa/corner/brown,
/turf/open/floor/carpet,
/area/trainstation/indoors/station)
"hv" = (
/turf/open/floor/iron/dark,
/area/trainstation/indoors/station)
"hK" = (
/obj/effect/spawner/random/trash/box,
/turf/open/misc/asphalt/no_border,
/area/trainstation/indoors/station)
"ih" = (
/obj/effect/decal/cleanable/dirt,
/obj/effect/decal/cleanable/dirt,
/turf/open/indestructible/train_platform,
/area/trainstation/indoors/station)
"in" = (
/obj/effect/spawner/random/structure/shipping_container/station_appropriate,
/turf/open/misc/asphalt/no_border,
/area/trainstation/indoors/station)
"jq" = (
/obj/effect/decal/cleanable/glitter,
/turf/open/indestructible/train_platform/top,
/area/trainstation/indoors/station)
"jE" = (
/obj/structure/flora/tree/pine/style_random,
/obj/structure/flora/bush/snow/style_random,
/turf/open/misc/asteroid/snow/indestructible,
/area/trainstation/outdoor)
"jM" = (
/obj/structure/fence/interlink{
	dir = 4
	},
/turf/open/misc/asphalt,
/area/trainstation/indoors/station)
"kv" = (
/obj/effect/spawner/random/trash/mess,
/turf/open/indestructible/train_platform/bottom,
/area/trainstation/indoors/station)
"lf" = (
/obj/effect/spawner/random/trash/box,
/obj/effect/spawner/random/trash/garbage,
/turf/open/floor/iron/dark,
/area/trainstation/indoors/station)
"lh" = (
/turf/open/indestructible/train_platform/top,
/area/trainstation/indoors/station)
"lJ" = (
/obj/structure/marker_beacon/burgundy,
/turf/open/misc/asphalt,
/area/trainstation/indoors/station)
"lN" = (
/obj/effect/spawner/random/engineering/material,
/turf/open/misc/asphalt,
/area/trainstation/indoors/station)
"mm" = (
/obj/effect/spawner/random/structure/shipping_container/blank,
/turf/open/misc/asphalt/no_border,
/area/trainstation/indoors/station)
"nT" = (
/obj/structure/marker_beacon/burgundy,
/obj/effect/decal/cleanable/dirt,
/turf/open/misc/asphalt/no_border,
/area/trainstation/indoors/station)
"oc" = (
/obj/effect/decal/cleanable/glitter,
/turf/open/indestructible/train_platform/bottom,
/area/trainstation/indoors/station)
"pm" = (
/obj/effect/spawner/random/trash/box,
/turf/open/indestructible/train_platform,
/area/trainstation/indoors/station)
"qT" = (
/obj/item/flashlight{
	pixel_x = 1;
	pixel_y = 5
	},
/turf/open/indestructible/train_platform/top,
/area/trainstation/indoors/station)
"rh" = (
/obj/effect/spawner/random/trash/garbage,
/turf/open/misc/asphalt,
/area/trainstation/indoors/station)
"rl" = (
/obj/effect/spawner/random/trash/mess,
/turf/open/indestructible/train_platform/top,
/area/trainstation/indoors/station)
"sb" = (
/turf/open/misc/asphalt,
/area/trainstation/indoors/station)
"so" = (
/obj/structure/flora/tree/dead/style_random,
/turf/open/misc/asteroid/snow/indestructible,
/area/trainstation/outdoor)
"tF" = (
/obj/effect/spawner/random/structure/shipping_container/gas,
/turf/open/misc/asphalt/no_border,
/area/trainstation/indoors/station)
"ui" = (
/obj/effect/spawner/random/structure/barricade,
/turf/open/misc/asphalt/no_border,
/area/trainstation/indoors/station)
"ve" = (
/obj/structure/table/wood,
/obj/item/storage/fancy/donut_box,
/turf/open/floor/carpet,
/area/trainstation/indoors/station)
"vu" = (
/obj/effect/decal/cleanable/dirt,
/obj/effect/decal/cleanable/glitter,
/turf/open/indestructible/train_platform,
/area/trainstation/indoors/station)
"vJ" = (
/obj/effect/spawner/random/trash/garbage,
/obj/effect/decal/cleanable/dirt,
/turf/open/misc/asphalt/no_border,
/area/trainstation/indoors/station)
"wl" = (
/obj/effect/spawner/random/trash/garbage,
/turf/open/floor/iron/dark,
/area/trainstation/indoors/station)
"ws" = (
/obj/effect/turf_decal/trimline,
/obj/structure/marker_beacon/burgundy,
/turf/open/indestructible/train_platform,
/area/trainstation/indoors/station)
"xB" = (
/obj/effect/decal/cleanable/dirt,
/obj/effect/decal/cleanable/dirt,
/turf/open/misc/asphalt/no_border,
/area/trainstation/indoors/station)
"zk" = (
/turf/closed/indestructible/rock/snow/ice/ore,
/area/trainstation/outdoor)
"zK" = (
/obj/effect/turf_decal/siding/thinplating/dark{
	dir = 8
	},
/obj/machinery/light/floor,
/turf/open/floor/carpet,
/area/trainstation/indoors/station)
"AP" = (
/obj/structure/chair/sofa/right/brown,
/turf/open/floor/carpet,
/area/trainstation/indoors/station)
"Bj" = (
/obj/structure/fence/interlink,
/turf/open/misc/asphalt/no_border,
/area/trainstation/indoors/station)
"Ci" = (
/obj/effect/decal/cleanable/dirt,
/turf/open/indestructible/train_platform,
/area/trainstation/indoors/station)
"CJ" = (
/obj/effect/decal/cleanable/dirt,
/turf/open/indestructible/train_platform/top,
/area/trainstation/indoors/station)
"CN" = (
/obj/effect/decal/cleanable/dirt,
/turf/open/misc/asphalt,
/area/trainstation/indoors/station)
"Ex" = (
/turf/open/indestructible/train_platform/bottom,
/area/trainstation/indoors/station)
"EB" = (
/obj/effect/decal/cleanable/glitter,
/turf/open/indestructible/train_platform,
/area/trainstation/indoors/station)
"EO" = (
/obj/structure/flora/tree/pine/style_random,
/turf/open/misc/asteroid/snow/indestructible,
/area/trainstation/outdoor)
"Fd" = (
/obj/machinery/computer/trainstation_control,
/turf/open/floor/iron/dark,
/area/trainstation/indoors/station)
"FH" = (
/turf/closed/indestructible/rock/snow/ice/ore,
/area/trainstation/indoors/station)
"FM" = (
/turf/closed/wall/city/siding,
/area/trainstation/indoors/station)
"FZ" = (
/turf/open/indestructible/train_platform,
/area/trainstation/indoors/station)
"Gm" = (
/turf/closed/wall/city/siding/style/style_2,
/area/trainstation/indoors/station)
"GP" = (
/obj/effect/decal/cleanable/dirt,
/turf/open/indestructible/train_platform/bottom,
/area/trainstation/indoors/station)
"GR" = (
/obj/item/flashlight{
	pixel_x = 1;
	pixel_y = 5
	},
/obj/effect/decal/cleanable/glitter,
/turf/open/indestructible/train_platform/top,
/area/trainstation/indoors/station)
"HR" = (
/obj/structure/flora/tree/dead/style_random,
/obj/structure/flora/bush/snow/style_random,
/turf/open/misc/asteroid/snow/indestructible,
/area/trainstation/outdoor)
"HZ" = (
/obj/structure/fence/corner,
/turf/open/misc/asphalt/no_border,
/area/trainstation/indoors/station)
"IK" = (
/obj/effect/spawner/random/trash/box,
/obj/effect/decal/cleanable/dirt,
/turf/open/misc/asphalt/no_border,
/area/trainstation/indoors/station)
"KM" = (
/obj/structure/chair/sofa/middle/brown{
	dir = 8
	},
/obj/machinery/light/warm/directional/east,
/turf/open/floor/carpet,
/area/trainstation/indoors/station)
"LE" = (
/turf/open/misc/asphalt/no_border,
/area/trainstation/indoors/station)
"Mu" = (
/turf/open/misc/asteroid/snow/indestructible,
/area/trainstation/outdoor)
"Nl" = (
/obj/effect/turf_decal/trimline,
/obj/structure/marker_beacon/burgundy,
/obj/effect/decal/cleanable/dirt,
/obj/effect/decal/cleanable/glitter,
/turf/open/indestructible/train_platform,
/area/trainstation/indoors/station)
"Pn" = (
/obj/structure/marker_beacon/burgundy,
/turf/open/misc/asphalt/no_border,
/area/trainstation/indoors/station)
"Po" = (
/obj/effect/turf_decal/siding/thinplating/dark{
	dir = 8
	},
/obj/item/kirbyplants/random,
/turf/open/floor/carpet,
/area/trainstation/indoors/station)
"PP" = (
/obj/effect/turf_decal/siding/thinplating/dark{
	dir = 8
	},
/turf/open/floor/carpet,
/area/trainstation/indoors/station)
"Qu" = (
/obj/machinery/light/floor,
/turf/open/floor/iron/dark,
/area/trainstation/indoors/station)
"QI" = (
/obj/structure/table/wood,
/obj/machinery/coffeemaker/impressa,
/obj/item/storage/box/coffeepack,
/turf/open/floor/carpet,
/area/trainstation/indoors/station)
"QN" = (
/turf/open/floor/carpet,
/area/trainstation/indoors/station)
"RE" = (
/obj/effect/spawner/random/structure/shipping_container/gas,
/turf/open/floor/iron/dark,
/area/trainstation/indoors/station)
"RV" = (
/obj/effect/spawner/random/trash/box,
/turf/open/indestructible/train_platform/top,
/area/trainstation/indoors/station)
"SM" = (
/obj/effect/decal/cleanable/dirt,
/obj/effect/decal/cleanable/dirt,
/turf/open/indestructible/train_platform/top,
/area/trainstation/indoors/station)
"Um" = (
/obj/effect/turf_decal/trimline,
/obj/structure/marker_beacon/burgundy,
/obj/effect/decal/cleanable/dirt,
/turf/open/indestructible/train_platform,
/area/trainstation/indoors/station)
"UA" = (
/obj/structure/table/wood,
/obj/machinery/microwave/engineering/cell_included,
/turf/open/floor/carpet,
/area/trainstation/indoors/station)
"Wj" = (
/obj/machinery/door/airlock/shuttle/ferry,
/turf/open/floor/iron/dark,
/area/trainstation/indoors/station)
"WF" = (
/obj/effect/spawner/random/trash/garbage,
/turf/open/misc/asphalt/no_border,
/area/trainstation/indoors/station)
"WH" = (
/obj/effect/spawner/random/trash/box,
/turf/open/misc/asphalt,
/area/trainstation/indoors/station)
"WJ" = (
/obj/effect/decal/cleanable/dirt,
/obj/effect/decal/cleanable/glitter,
/turf/open/indestructible/train_platform/bottom,
/area/trainstation/indoors/station)
"Xc" = (
/obj/structure/flora/rock/style_random,
/turf/open/misc/asteroid/snow/indestructible,
/area/trainstation/outdoor)
"Xq" = (
/obj/structure/flora/bush/snow/style_random,
/turf/open/misc/asteroid/snow/indestructible,
/area/trainstation/outdoor)
"Xv" = (
/obj/machinery/door/airlock/shuttle/ferry,
/turf/open/misc/asphalt/no_border,
/area/trainstation/indoors/station)
"XD" = (
/obj/effect/spawner/random/engineering/material,
/turf/open/misc/asphalt/no_border,
/area/trainstation/indoors/station)
"Yh" = (
/obj/effect/spawner/random/structure/barricade,
/turf/open/misc/asphalt,
/area/trainstation/indoors/station)
"Ym" = (
/obj/effect/spawner/random/trash/box,
/turf/open/floor/iron/dark,
/area/trainstation/indoors/station)
"Ze" = (
/obj/effect/spawner/random/trash/garbage,
/turf/open/indestructible/train_platform/top,
/area/trainstation/indoors/station)
"ZA" = (
/obj/effect/decal/cleanable/dirt,
/turf/open/misc/asphalt/no_border,
/area/trainstation/indoors/station)
"ZM" = (
/obj/effect/spawner/random/structure/shipping_container/gas,
/obj/effect/decal/cleanable/dirt,
/turf/open/misc/asphalt,
/area/trainstation/indoors/station)

(1,1,1) = {"
FH
FH
FH
FH
FH
FH
FH
FH
FH
FH
FH
FH
FH
FH
FH
"}
(2,1,1) = {"
FH
FH
FH
FH
FH
FH
FH
FH
FH
FH
FH
FH
FH
FH
FH
"}
(3,1,1) = {"
FH
FM
FM
FM
FM
FM
FM
FM
FM
FM
FM
FM
FM
FM
FM
"}
(4,1,1) = {"
FH
FM
sb
sb
sb
sb
sb
sb
sb
ds
sb
jM
Ex
FZ
lh
"}
(5,1,1) = {"
FH
FM
sb
sb
ds
sb
lN
sb
sb
sb
sb
jM
Ex
FZ
CJ
"}
(6,1,1) = {"
FH
FM
sb
sb
LE
ZA
IK
ZA
LE
LE
sb
jM
Ex
FZ
lh
"}
(7,1,1) = {"
FH
Gm
sb
sb
ZA
LE
tF
LE
LE
tF
sb
jM
Ex
ws
lh
"}
(8,1,1) = {"
FH
Gm
sb
sb
ZA
ZA
ZA
LE
LE
LE
sb
jM
Ex
FZ
lh
"}
(9,1,1) = {"
FH
Gm
sb
sb
mm
LE
LE
LE
ZA
LE
sb
jM
Ex
FZ
lh
"}
(10,1,1) = {"
FH
Gm
sb
sb
LE
LE
gm
LE
LE
tF
sb
jM
Ex
FZ
lh
"}
(11,1,1) = {"
FH
Gm
sb
sb
LE
Pn
LE
LE
LE
LE
sb
jM
Ex
FZ
lh
"}
(12,1,1) = {"
FH
Gm
sb
sb
LE
LE
ZA
ZA
LE
LE
sb
jM
Ex
FZ
lh
"}
(13,1,1) = {"
FH
Gm
sb
sb
LE
LE
ZA
LE
nT
mm
sb
jM
Ex
ws
lh
"}
(14,1,1) = {"
FH
Gm
Yh
Yh
ui
ui
LE
WF
LE
LE
sb
jM
Ex
FZ
RV
"}
(15,1,1) = {"
FH
Gm
sb
sb
ZA
gm
LE
LE
LE
LE
sb
jM
Ex
FZ
lh
"}
(16,1,1) = {"
FH
Gm
sb
sb
LE
ZA
LE
LE
LE
LE
sb
jM
GP
FZ
qT
"}
(17,1,1) = {"
FH
Gm
sb
WH
ZA
LE
LE
LE
LE
LE
sb
jM
Ex
FZ
lh
"}
(18,1,1) = {"
FH
Gm
sb
sb
LE
ZA
LE
tF
LE
gm
sb
jM
Ex
FZ
lh
"}
(19,1,1) = {"
FH
FM
sb
sb
LE
vJ
LE
LE
LE
LE
sb
jM
Ex
ws
lh
"}
(20,1,1) = {"
FH
FM
sb
ds
XD
ZA
LE
LE
LE
LE
sb
jM
Ex
FZ
lh
"}
(21,1,1) = {"
FH
Gm
sb
sb
ZA
LE
LE
LE
LE
LE
sb
jM
Ex
FZ
lh
"}
(22,1,1) = {"
FH
FM
sb
sb
LE
LE
LE
hK
LE
LE
sb
jM
Ex
FZ
Ze
"}
(23,1,1) = {"
FH
FM
sb
sb
hK
LE
LE
LE
LE
ZA
sb
jM
Ex
FZ
rl
"}
(24,1,1) = {"
FH
Gm
sb
sb
ZA
LE
LE
mm
LE
tF
sb
jM
oc
EB
lh
"}
(25,1,1) = {"
FH
Gm
sb
sb
tF
LE
LE
LE
LE
LE
sb
jM
Ex
Um
lh
"}
(26,1,1) = {"
FH
FM
WH
lJ
ZA
LE
LE
LE
LE
LE
sb
jM
Ex
FZ
lh
"}
(27,1,1) = {"
FH
FM
sb
sb
LE
LE
LE
LE
LE
LE
sb
jM
Ex
FZ
lh
"}
(28,1,1) = {"
FH
FM
sb
CN
LE
LE
LE
LE
LE
tF
sb
jM
Ex
FZ
lh
"}
(29,1,1) = {"
FH
FM
sb
sb
ui
LE
LE
tF
LE
LE
sb
jM
Ex
FZ
lh
"}
(30,1,1) = {"
FH
FM
sb
ds
ui
LE
LE
LE
LE
ZA
sb
jM
Ex
Ci
lh
"}
(31,1,1) = {"
FH
FM
sb
CN
ui
LE
LE
LE
LE
ZA
sb
jM
oc
Um
lh
"}
(32,1,1) = {"
FH
FM
sb
sb
ui
LE
LE
XD
LE
tF
sb
jM
Ex
FZ
lh
"}
(33,1,1) = {"
FH
FM
sb
ZM
LE
mm
LE
WF
Pn
LE
sb
jM
oc
FZ
lh
"}
(34,1,1) = {"
FH
FM
sb
CN
LE
LE
LE
LE
LE
LE
sb
jM
oc
Ci
lh
"}
(35,1,1) = {"
FH
FM
sb
sb
LE
LE
LE
LE
LE
LE
sb
jM
Ex
Ci
lh
"}
(36,1,1) = {"
FH
FM
sb
WH
LE
LE
LE
LE
LE
LE
sb
jM
Ex
FZ
jq
"}
(37,1,1) = {"
FH
Gm
sb
CN
ZA
LE
LE
tF
LE
tF
CN
jM
oc
ws
lh
"}
(38,1,1) = {"
FH
Gm
sb
sb
LE
hK
LE
LE
LE
LE
sb
jM
Ex
FZ
lh
"}
(39,1,1) = {"
FH
Gm
sb
dh
LE
LE
LE
LE
LE
LE
sb
jM
Ex
FZ
lh
"}
(40,1,1) = {"
FH
FM
CN
sb
LE
hK
LE
LE
LE
in
sb
jM
Ex
pm
CJ
"}
(41,1,1) = {"
FH
Gm
sb
sb
LE
LE
LE
LE
LE
LE
sb
jM
Ex
FZ
lh
"}
(42,1,1) = {"
FH
Gm
CN
cH
LE
LE
LE
ZA
LE
LE
sb
jM
Ex
FZ
lh
"}
(43,1,1) = {"
FH
Gm
sb
sb
LE
ui
ZA
in
XD
LE
sb
jM
Ex
ws
CJ
"}
(44,1,1) = {"
FH
FM
sb
sb
LE
ui
ZA
LE
LE
LE
sb
jM
Ex
FZ
lh
"}
(45,1,1) = {"
FH
FM
sb
cH
LE
ui
LE
LE
LE
LE
CN
jM
Ex
Ci
lh
"}
(46,1,1) = {"
FH
Gm
sb
sb
LE
LE
ui
ui
LE
LE
sb
jM
Ex
FZ
lh
"}
(47,1,1) = {"
FH
FM
sb
CN
LE
LE
ZA
LE
LE
mm
sb
jM
Ex
FZ
lh
"}
(48,1,1) = {"
FH
FM
sb
sb
LE
ZA
LE
LE
LE
LE
sb
jM
Ex
vu
lh
"}
(49,1,1) = {"
FH
Gm
sb
WH
LE
ZA
mm
LE
LE
LE
CN
jM
Ex
Um
lh
"}
(50,1,1) = {"
FH
FM
sb
sb
LE
ZA
LE
LE
WF
LE
sb
jM
Ex
FZ
jq
"}
(51,1,1) = {"
FH
Gm
sb
cH
LE
ZA
LE
LE
LE
LE
CN
jM
Ex
Ci
lh
"}
(52,1,1) = {"
FH
Gm
sb
sb
LE
IK
LE
LE
LE
LE
sb
jM
Ex
FZ
GR
"}
(53,1,1) = {"
FH
Gm
sb
sb
ZA
ZA
LE
ZA
LE
mm
sb
jM
Ex
Ci
lh
"}
(54,1,1) = {"
FH
Gm
cH
sb
LE
ui
ui
LE
LE
ZA
CN
jM
Ex
FZ
jq
"}
(55,1,1) = {"
FH
Gm
sb
sb
LE
ZA
LE
LE
LE
LE
sb
jM
Ex
Um
lh
"}
(56,1,1) = {"
FH
FM
sb
sb
LE
mm
ZA
Pn
mm
LE
sb
jM
Ex
EB
lh
"}
(57,1,1) = {"
FH
Gm
WH
sb
Pn
ZA
LE
LE
LE
LE
sb
jM
Ex
EB
lh
"}
(58,1,1) = {"
FH
FM
sb
sb
LE
LE
ZA
LE
LE
LE
sb
jM
WJ
FZ
lh
"}
(59,1,1) = {"
FH
Gm
sb
sb
LE
LE
LE
ZA
LE
LE
sb
jM
GP
FZ
lh
"}
(60,1,1) = {"
FH
Gm
sb
sb
mm
ZA
LE
LE
LE
LE
sb
jM
Ex
FZ
lh
"}
(61,1,1) = {"
FH
FM
Yh
sb
LE
LE
hK
LE
LE
mm
sb
jM
GP
Nl
lh
"}
(62,1,1) = {"
FH
Gm
Yh
sb
LE
LE
LE
ZA
LE
LE
sb
jM
Ex
FZ
lh
"}
(63,1,1) = {"
FH
FM
Yh
sb
LE
ZA
mm
ZA
LE
LE
sb
jM
GP
FZ
lh
"}
(64,1,1) = {"
FH
Gm
sb
sb
LE
LE
LE
XD
LE
LE
sb
jM
Ex
EB
lh
"}
(65,1,1) = {"
FH
FM
sb
sb
LE
ZA
LE
xB
LE
LE
sb
jM
Ex
FZ
lh
"}
(66,1,1) = {"
FH
Gm
sb
ds
LE
ZA
LE
LE
LE
LE
sb
jM
Ex
FZ
lh
"}
(67,1,1) = {"
FH
FM
sb
sb
LE
ZA
LE
hK
Pn
mm
sb
jM
GP
Um
lh
"}
(68,1,1) = {"
FH
FM
sb
sb
LE
ZA
LE
LE
LE
LE
sb
jM
GP
FZ
lh
"}
(69,1,1) = {"
FH
FM
sb
sb
LE
ZA
tF
LE
LE
LE
sb
jM
Ex
Ci
lh
"}
(70,1,1) = {"
FH
Gm
sb
sb
LE
nT
LE
ZA
LE
LE
sb
jM
Ex
Ci
lh
"}
(71,1,1) = {"
FH
Gm
sb
sb
LE
LE
LE
ZA
WF
LE
sb
jM
Ex
FZ
lh
"}
(72,1,1) = {"
FH
FM
WH
sb
tF
ZA
LE
ZA
LE
LE
sb
jM
Ex
ih
lh
"}
(73,1,1) = {"
FH
Gm
sb
sb
LE
ZA
tF
ZA
LE
tF
sb
jM
Ex
ws
lh
"}
(74,1,1) = {"
FH
Gm
sb
sb
Pn
LE
LE
LE
ZA
LE
sb
jM
Ex
FZ
lh
"}
(75,1,1) = {"
FH
Gm
sb
sb
LE
ZA
LE
LE
LE
LE
sb
jM
kv
Ci
lh
"}
(76,1,1) = {"
FH
Gm
sb
rh
LE
LE
LE
XD
ZA
LE
sb
jM
Ex
FZ
rl
"}
(77,1,1) = {"
FH
FM
sb
sb
LE
tF
LE
LE
LE
LE
sb
jM
Ex
Ci
lh
"}
(78,1,1) = {"
FH
FM
ds
sb
LE
ZA
ZA
hK
ZA
LE
sb
jM
Ex
Ci
lh
"}
(79,1,1) = {"
FH
FM
sb
sb
Pn
LE
LE
LE
tF
LE
sb
jM
Ex
ws
lh
"}
(80,1,1) = {"
FH
FM
sb
sb
LE
LE
LE
LE
ZA
LE
sb
jM
Ex
vu
lh
"}
(81,1,1) = {"
FH
FM
sb
sb
LE
LE
LE
ZA
ZA
LE
sb
jM
Ex
FZ
lh
"}
(82,1,1) = {"
FH
FM
sb
sb
LE
tF
ZA
ZA
LE
LE
sb
jM
Ex
FZ
lh
"}
(83,1,1) = {"
FH
FM
Yh
sb
LE
LE
ZA
ZA
LE
LE
sb
jM
Ex
pm
lh
"}
(84,1,1) = {"
FH
FM
Yh
sb
Pn
LE
ZA
hK
ZA
tF
sb
jM
Ex
FZ
lh
"}
(85,1,1) = {"
FH
FM
Yh
sb
LE
LE
LE
XD
LE
LE
sb
jM
Ex
ws
lh
"}
(86,1,1) = {"
FH
Gm
sb
ds
LE
LE
ZA
ZA
LE
LE
sb
jM
Ex
FZ
lh
"}
(87,1,1) = {"
FH
Gm
sb
sb
LE
IK
LE
LE
WF
LE
sb
jM
Ex
Ci
lh
"}
(88,1,1) = {"
FH
FM
sb
sb
LE
ZA
ui
ui
ZA
LE
sb
jM
Ex
FZ
lh
"}
(89,1,1) = {"
FH
Gm
sb
sb
LE
ZA
LE
tF
LE
LE
sb
jM
Ex
FZ
lh
"}
(90,1,1) = {"
FH
FM
sb
ds
LE
ZA
Pn
ZA
LE
LE
sb
jM
Ex
FZ
lh
"}
(91,1,1) = {"
FH
FM
sb
sb
LE
LE
LE
LE
LE
LE
sb
jM
Ex
FZ
lh
"}
(92,1,1) = {"
FH
Gm
sb
sb
LE
ZA
LE
ZA
nT
tF
sb
jM
Ex
ws
CJ
"}
(93,1,1) = {"
FH
Gm
sb
sb
LE
IK
ZA
LE
LE
LE
sb
jM
Ex
FZ
SM
"}
(94,1,1) = {"
FH
Gm
sb
sb
LE
ZA
hK
LE
ZA
LE
sb
jM
Ex
FZ
lh
"}
(95,1,1) = {"
FH
Gm
sb
rh
LE
LE
hK
hK
ZA
LE
sb
jM
Ex
FZ
lh
"}
(96,1,1) = {"
FH
Gm
sb
sb
ZA
tF
LE
LE
LE
LE
sb
jM
Ex
vu
lh
"}
(97,1,1) = {"
FH
Gm
sb
ds
LE
LE
hK
LE
IK
LE
sb
jM
Ex
Ci
lh
"}
(98,1,1) = {"
FH
Gm
sb
sb
LE
LE
LE
LE
LE
LE
sb
jM
WJ
Um
lh
"}
(99,1,1) = {"
FH
FM
sb
sb
sb
sb
sb
sb
sb
sb
sb
jM
oc
FZ
lh
"}
(100,1,1) = {"
FH
FM
sb
sb
sb
sb
sb
WH
sb
sb
sb
jM
Ex
FZ
lh
"}
(101,1,1) = {"
FH
FM
FM
FM
FM
Wj
FM
FM
FM
FM
Bj
HZ
Ex
FZ
lh
"}
(102,1,1) = {"
FH
FM
hv
wl
hv
wl
Ym
hv
hv
FM
LE
LE
Ex
FZ
lh
"}
(103,1,1) = {"
FH
FM
hv
lf
Ym
hv
hv
hv
wl
FM
LE
LE
Ex
FZ
lh
"}
(104,1,1) = {"
FH
FM
hv
RE
Ym
Qu
hv
RE
hv
Xv
LE
LE
Ex
ws
lh
"}
(105,1,1) = {"
FH
Gm
hv
hv
hv
hv
hv
hv
Ym
FM
LE
LE
GP
FZ
lh
"}
(106,1,1) = {"
FH
Gm
hv
hv
hv
RE
hv
hv
Ym
FM
LE
LE
Ex
FZ
lh
"}
(107,1,1) = {"
FH
Gm
hv
Ym
hv
hv
Ym
Ym
hv
FM
LE
LE
Ex
FZ
lh
"}
(108,1,1) = {"
FH
Gm
hv
hv
hv
hv
Ym
hv
wl
Gm
LE
LE
Ex
FZ
lh
"}
(109,1,1) = {"
FH
Gm
hv
hv
hv
hv
hv
wl
hv
Gm
LE
LE
GP
FZ
lh
"}
(110,1,1) = {"
FH
FM
hv
wl
hv
hv
hv
hv
hv
FM
LE
LE
GP
ws
lh
"}
(111,1,1) = {"
FH
FM
hv
hv
hv
hv
hv
hv
hv
Gm
LE
LE
GP
FZ
lh
"}
(112,1,1) = {"
FH
FM
hv
hv
hv
hv
hv
hv
hv
Gm
LE
LE
Ex
FZ
lh
"}
(113,1,1) = {"
FH
FM
Fd
hv
hv
hv
hv
hv
hv
FM
LE
LE
Ex
FZ
lh
"}
(114,1,1) = {"
FH
FM
Po
PP
PP
zK
PP
PP
PP
Xv
LE
LE
Ex
Ci
lh
"}
(115,1,1) = {"
FH
FM
AP
QN
QN
QN
QN
QN
QI
FM
LE
LE
Ex
FZ
lh
"}
(116,1,1) = {"
FH
FM
gn
KM
ch
eQ
QN
UA
ve
FM
LE
LE
Ex
FZ
lh
"}
(117,1,1) = {"
FH
FM
FM
FM
FM
FM
FM
FM
FM
FM
FM
FM
FM
FM
FM
"}
(118,1,1) = {"
zk
Mu
Mu
EO
Mu
Mu
Xc
Mu
so
Mu
Mu
EO
Mu
so
Mu
"}
(119,1,1) = {"
zk
Mu
Mu
Mu
Mu
Mu
Mu
Mu
EO
Mu
Mu
Mu
Mu
EO
Mu
"}
(120,1,1) = {"
zk
EO
Mu
Xq
Mu
Mu
Mu
Mu
Mu
Mu
Mu
Xq
Mu
Mu
Mu
"}
(121,1,1) = {"
zk
Mu
Mu
jE
HR
HR
EO
Mu
Xq
Mu
Mu
jE
HR
Xq
Mu
"}
(122,1,1) = {"
zk
EO
Mu
Mu
Mu
Mu
Mu
Mu
jE
HR
Mu
Mu
Mu
jE
HR
"}
(123,1,1) = {"
zk
Mu
Mu
EO
Mu
Mu
EO
Xc
Mu
so
Mu
EO
Mu
Mu
Mu
"}
(124,1,1) = {"
zk
Mu
Mu
Mu
Mu
Mu
Mu
Mu
Mu
EO
Mu
Mu
Mu
EO
Mu
"}
(125,1,1) = {"
zk
EO
Mu
Mu
Mu
Mu
Mu
Mu
Mu
Mu
Mu
Mu
Mu
Mu
Mu
"}
(126,1,1) = {"
zk
Mu
Mu
EO
Mu
Mu
EO
EO
Mu
Xq
Mu
EO
Mu
Mu
Mu
"}
(127,1,1) = {"
zk
Mu
Mu
Mu
Mu
Mu
Mu
Mu
Mu
jE
HR
Mu
Mu
EO
Mu
"}
(128,1,1) = {"
zk
Mu
Mu
Mu
Mu
Mu
Mu
EO
Mu
Mu
Mu
Mu
Mu
Mu
Mu
"}
(129,1,1) = {"
zk
EO
Mu
Mu
jE
jE
Mu
Mu
Mu
EO
Mu
Mu
jE
Mu
Mu
"}
(130,1,1) = {"
zk
Mu
Mu
Mu
Mu
Mu
EO
Mu
Mu
Mu
Mu
Mu
Mu
Mu
jE
"}
(131,1,1) = {"
zk
Mu
EO
Xc
Xq
Xq
Mu
EO
Mu
Mu
Mu
Xc
Xq
Mu
Mu
"}
(132,1,1) = {"
zk
Mu
Mu
Mu
Mu
Mu
Mu
Mu
Mu
EO
Mu
Mu
Mu
Xc
Xq
"}
(133,1,1) = {"
zk
EO
Mu
EO
Mu
Mu
Mu
Mu
Xc
Mu
so
Mu
Mu
Mu
Mu
"}
(134,1,1) = {"
zk
Mu
Mu
Mu
Mu
EO
Mu
Mu
EO
Xc
Mu
Mu
EO
EO
Mu
"}
(135,1,1) = {"
zk
Xc
Mu
so
Mu
Mu
Mu
Mu
Mu
Mu
Mu
Mu
Mu
Mu
Mu
"}
(136,1,1) = {"
zk
Mu
EO
Xc
Xc
EO
Mu
EO
Mu
EO
Mu
Mu
Mu
so
Mu
"}
(137,1,1) = {"
zk
Mu
Xq
Mu
Mu
Mu
Mu
Mu
Mu
Mu
EO
Mu
Mu
so
Mu
"}
(138,1,1) = {"
zk
Mu
Mu
Xq
Mu
Mu
EO
Xc
Mu
so
Mu
Mu
Mu
Mu
Mu
"}
(139,1,1) = {"
zk
Mu
Mu
jE
HR
Mu
EO
Mu
Mu
EO
Xc
Mu
Mu
EO
Mu
"}
(140,1,1) = {"
zk
Mu
Mu
Mu
Mu
Mu
Mu
Mu
Mu
Mu
Mu
Mu
Mu
Mu
Xq
"}
(141,1,1) = {"
zk
Mu
Mu
EO
Mu
Mu
EO
EO
Mu
Mu
EO
Xc
Mu
Mu
EO
"}
(142,1,1) = {"
zk
Xq
Mu
Mu
Mu
Mu
Mu
EO
Mu
Mu
EO
Xc
Mu
Mu
EO
"}
(143,1,1) = {"
zk
EO
Mu
so
EO
EO
Mu
Mu
Mu
Mu
Mu
Mu
Mu
Mu
Mu
"}
(144,1,1) = {"
zk
Mu
Mu
Mu
Mu
Mu
Mu
EO
Mu
EO
Mu
EO
Mu
Mu
Mu
"}
(145,1,1) = {"
zk
Xq
EO
Mu
Mu
so
Mu
Mu
Mu
Mu
Mu
Mu
EO
Mu
Mu
"}
(146,1,1) = {"
zk
Xq
so
Xc
Mu
jE
Mu
Mu
EO
Xc
Mu
so
Mu
Mu
Mu
"}
(147,1,1) = {"
zk
EO
Mu
Mu
Mu
Mu
Mu
Mu
Xq
Mu
Mu
EO
Mu
EO
Xc
"}
(148,1,1) = {"
zk
Mu
Mu
EO
Mu
EO
EO
Mu
Mu
Mu
Mu
Mu
Mu
Mu
Mu
"}
(149,1,1) = {"
zk
Mu
Mu
Mu
so
Mu
Mu
Mu
Xq
EO
Mu
Xq
EO
Mu
EO
"}
(150,1,1) = {"
zk
Mu
Xq
EO
Mu
Mu
EO
Mu
Mu
Mu
Mu
jE
Mu
Mu
Mu
"}
(151,1,1) = {"
zk
Mu
Mu
Mu
Mu
Mu
Mu
EO
Mu
EO
Mu
Mu
Xc
Mu
so
"}
(152,1,1) = {"
zk
jE
Mu
EO
Mu
EO
Mu
EO
Mu
Mu
Mu
Mu
Mu
Mu
Mu
"}
(153,1,1) = {"
zk
Mu
Mu
Mu
Mu
Mu
Mu
Mu
EO
Mu
Mu
jE
Mu
EO
Mu
"}
(154,1,1) = {"
zk
Mu
EO
Mu
EO
Xc
Mu
so
Mu
Mu
Mu
Mu
Mu
Mu
Mu
"}
(155,1,1) = {"
zk
Mu
Mu
Mu
Xq
Mu
Mu
EO
Mu
EO
Xc
Xq
Mu
Mu
Mu
"}
(156,1,1) = {"
zk
Mu
Mu
Mu
Mu
Mu
Mu
Mu
Mu
Mu
Mu
Mu
Mu
EO
Mu
"}
(157,1,1) = {"
zk
EO
Mu
Mu
Xq
EO
Mu
Xq
EO
Mu
EO
Mu
Mu
Mu
Mu
"}
(158,1,1) = {"
zk
Mu
Xq
Mu
Mu
Mu
Mu
jE
Mu
Mu
Mu
Mu
Mu
Mu
Mu
"}
(159,1,1) = {"
zk
Xq
Mu
EO
Mu
EO
Mu
Mu
Xc
Mu
so
Mu
Mu
Mu
jE
"}
(160,1,1) = {"
zk
Xq
Mu
EO
Mu
Mu
EO
Xc
Mu
Mu
EO
Mu
Mu
Mu
Mu
"}
(161,1,1) = {"
zk
Mu
Mu
Mu
Mu
Mu
Mu
Mu
Mu
Mu
Mu
Mu
EO
Xc
Xq
"}
(162,1,1) = {"
zk
EO
Mu
EO
Mu
EO
Mu
EO
Mu
Mu
Mu
Mu
Mu
Mu
Mu
"}
(163,1,1) = {"
zk
Mu
Mu
Mu
Mu
Mu
Mu
Mu
EO
Mu
Mu
EO
Mu
EO
Mu
"}
(164,1,1) = {"
zk
Mu
Mu
Mu
EO
Xc
Mu
so
Mu
Mu
Mu
Mu
Mu
Mu
Mu
"}
(165,1,1) = {"
zk
Mu
EO
Mu
Xq
Mu
Mu
EO
Mu
EO
Xc
Xc
Mu
so
Mu
"}
(166,1,1) = {"
zk
Mu
Mu
Mu
Mu
Mu
Mu
Mu
Mu
Mu
Mu
Mu
Mu
EO
Mu
"}
(167,1,1) = {"
zk
Mu
Mu
Mu
Xq
EO
Mu
Xq
EO
Mu
EO
Mu
Mu
Mu
Mu
"}
(168,1,1) = {"
zk
EO
Mu
Mu
EO
Mu
Mu
EO
Xc
Mu
Mu
EO
Mu
Xq
Mu
"}
(169,1,1) = {"
zk
Mu
Xq
EO
Mu
EO
Mu
Mu
EO
Xc
Mu
Mu
EO
jE
HR
"}
(170,1,1) = {"
zk
Xq
Mu
EO
EO
Mu
Mu
Mu
Mu
Mu
Mu
Mu
Mu
Mu
Mu
"}
(171,1,1) = {"
zk
Xq
Mu
Mu
Mu
EO
Mu
EO
Mu
EO
Mu
Mu
Mu
EO
Mu
"}
(172,1,1) = {"
zk
Mu
Mu
EO
Mu
Mu
Mu
Mu
Mu
Mu
EO
Mu
Mu
Mu
Mu
"}
(173,1,1) = {"
zk
EO
Mu
so
Mu
Mu
EO
Xc
Mu
so
Mu
Mu
Mu
Mu
Mu
"}
(174,1,1) = {"
zk
Mu
Mu
Mu
Mu
Mu
Xq
Mu
Mu
EO
Mu
EO
Xc
EO
Mu
"}
(175,1,1) = {"
zk
Mu
Mu
Mu
Mu
Mu
Mu
Mu
Mu
Mu
Mu
Mu
Mu
Mu
Mu
"}
(176,1,1) = {"
zk
EO
Mu
Mu
Mu
Mu
Xq
EO
Mu
Xq
EO
Mu
EO
Mu
Mu
"}
(177,1,1) = {"
zk
Mu
Mu
EO
EO
Mu
Mu
Mu
Mu
jE
Mu
Mu
Mu
Mu
jE
"}
(178,1,1) = {"
zk
Mu
Mu
Mu
so
EO
Mu
EO
Mu
Mu
Xc
Mu
so
Mu
Mu
"}
(179,1,1) = {"
zk
Mu
Xq
EO
Mu
Mu
EO
Xc
Xq
EO
Xc
Mu
EO
Xc
Xq
"}
(180,1,1) = {"
zk
Mu
Mu
Mu
Mu
Mu
Mu
Mu
Mu
Xq
Mu
Mu
Mu
Mu
Mu
"}
(181,1,1) = {"
zk
jE
Mu
EO
Mu
EO
Mu
EO
Mu
Xq
Mu
EO
Mu
EO
Mu
"}
(182,1,1) = {"
zk
Mu
Mu
Mu
Mu
Mu
Mu
Mu
Mu
Mu
EO
Mu
Mu
Mu
Mu
"}
(183,1,1) = {"
zk
Mu
EO
Mu
EO
Xc
Mu
so
Mu
Mu
Mu
Xc
Mu
so
Mu
"}
(184,1,1) = {"
zk
Mu
Mu
Mu
Xq
Mu
Mu
EO
Mu
so
EO
Mu
Mu
Mu
jE
"}
(185,1,1) = {"
zk
Mu
Mu
Mu
Mu
Mu
Mu
EO
Mu
Mu
EO
Xc
Mu
Mu
EO
"}
(186,1,1) = {"
zk
EO
Mu
Mu
Xq
EO
Mu
Mu
Mu
Mu
Mu
Mu
Mu
Mu
Mu
"}
(187,1,1) = {"
zk
Mu
Xq
Mu
Mu
Mu
Mu
EO
Mu
EO
Mu
EO
Mu
Mu
Mu
"}
(188,1,1) = {"
zk
Xq
Mu
EO
Mu
EO
Mu
Mu
Mu
Mu
Mu
Mu
EO
Mu
Mu
"}
(189,1,1) = {"
zk
Xq
EO
Mu
Mu
EO
Xc
Mu
EO
Xc
Mu
so
Mu
Mu
Mu
"}
(190,1,1) = {"
zk
Mu
Mu
Mu
Mu
Mu
Mu
Mu
Xq
Mu
Mu
EO
Mu
EO
Xc
"}
(191,1,1) = {"
zk
EO
EO
Mu
EO
Mu
EO
Mu
Mu
Mu
Mu
Mu
Mu
Mu
Mu
"}
(192,1,1) = {"
zk
Mu
Mu
Mu
Mu
Mu
Mu
Mu
Xq
EO
Mu
Xq
EO
Mu
EO
"}
(193,1,1) = {"
zk
Mu
Mu
EO
Xc
Mu
so
Mu
Mu
Mu
Mu
jE
Mu
Mu
Mu
"}
(194,1,1) = {"
zk
EO
Mu
Xq
Mu
Mu
EO
EO
Mu
EO
Mu
Mu
Xc
Mu
so
"}
(195,1,1) = {"
zk
Mu
Mu
Mu
Mu
Mu
Mu
EO
Mu
EO
Mu
Mu
Xc
Mu
so
"}
(196,1,1) = {"
zk
Mu
Mu
Xq
EO
Mu
Xq
EO
Mu
EO
Mu
Mu
Xc
Mu
so
"}
(197,1,1) = {"
zk
Mu
Mu
Mu
EO
Mu
Mu
Mu
Xq
EO
Mu
Xq
EO
Mu
EO
"}
(198,1,1) = {"
zk
Mu
EO
Mu
Mu
EO
Mu
Mu
Mu
Mu
Mu
jE
Mu
Mu
Mu
"}
(199,1,1) = {"
zk
jE
Mu
EO
EO
Mu
Mu
EO
Mu
Mu
EO
Xc
Mu
Mu
EO
"}
(200,1,1) = {"
zk
Mu
Mu
Mu
Mu
EO
Mu
Mu
Mu
Mu
Mu
Mu
Mu
Mu
Mu
"}
(201,1,1) = {"
zk
Mu
EO
Mu
Mu
Mu
Mu
EO
Mu
EO
Mu
EO
Mu
Mu
Mu
"}
(202,1,1) = {"
zk
Mu
Mu
Mu
Mu
Mu
EO
Mu
Mu
Mu
Mu
Mu
EO
Mu
Mu
"}
(203,1,1) = {"
zk
Mu
Mu
Mu
Mu
Mu
Xq
Mu
EO
Xc
Mu
so
Mu
Mu
Mu
"}
(204,1,1) = {"
zk
EO
Mu
Mu
Mu
Mu
Mu
Mu
Xq
Mu
Mu
EO
Mu
EO
Xc
"}
(205,1,1) = {"
zk
Mu
Xq
Mu
Mu
Mu
Xq
Mu
Mu
Mu
Mu
Mu
Mu
Mu
Mu
"}
(206,1,1) = {"
zk
Xq
Mu
EO
EO
Mu
Mu
Mu
Xq
EO
Mu
Xq
EO
Mu
EO
"}
(207,1,1) = {"
zk
Xq
Mu
Mu
Xc
EO
Mu
Mu
Mu
Mu
Mu
jE
Mu
Mu
Mu
"}
(208,1,1) = {"
zk
Mu
Mu
EO
Mu
Mu
Mu
EO
Mu
EO
Mu
Mu
Xc
Mu
so
"}
(209,1,1) = {"
zk
EO
Mu
so
Mu
EO
Mu
Mu
Mu
Mu
Mu
Mu
EO
Mu
Mu
"}
(210,1,1) = {"
zk
Mu
Mu
Mu
Mu
Mu
Mu
EO
Mu
EO
Mu
Mu
Mu
Mu
jE
"}
(211,1,1) = {"
zk
Mu
Mu
Mu
jE
Mu
Mu
Mu
Mu
Xc
EO
Mu
Xq
Mu
Mu
"}
(212,1,1) = {"
zk
Xq
EO
Mu
Mu
so
Mu
EO
Mu
Mu
Mu
Mu
jE
HR
Xq
"}
(213,1,1) = {"
zk
Xq
so
Xc
Mu
jE
Mu
so
Mu
Mu
EO
Mu
Mu
Mu
Mu
"}
(214,1,1) = {"
zk
EO
Mu
Mu
Mu
Mu
Mu
Mu
Mu
EO
Mu
Mu
EO
Mu
Mu
"}
(215,1,1) = {"
zk
Mu
Mu
EO
Mu
EO
Mu
Mu
jE
Mu
Mu
Mu
Mu
Mu
Mu
"}
(216,1,1) = {"
zk
Mu
Mu
Mu
so
Mu
Mu
EO
Mu
Mu
EO
Xc
Mu
Mu
EO
"}
(217,1,1) = {"
zk
Mu
Xq
EO
Mu
Mu
EO
Mu
Mu
Mu
Mu
Mu
Mu
Mu
Mu
"}
(218,1,1) = {"
zk
Mu
Mu
Mu
Mu
Mu
Mu
EO
Mu
EO
Mu
EO
Mu
Mu
Mu
"}
(219,1,1) = {"
zk
jE
Mu
EO
Mu
EO
Mu
Mu
Mu
Mu
Mu
Mu
EO
Mu
Mu
"}
(220,1,1) = {"
zk
Mu
Mu
Mu
Mu
Mu
Mu
Mu
EO
Xc
Mu
so
Mu
Mu
Mu
"}
(221,1,1) = {"
zk
Mu
EO
Mu
EO
Xc
Mu
Mu
Xq
Mu
Mu
EO
Mu
EO
Xc
"}
(222,1,1) = {"
zk
Mu
Mu
Mu
Xq
Mu
Mu
Mu
Mu
Mu
Mu
Mu
Mu
Mu
Mu
"}
(223,1,1) = {"
zk
Mu
Mu
Mu
Mu
Mu
Mu
Mu
Xq
EO
Mu
Xq
EO
Mu
EO
"}
(224,1,1) = {"
zk
EO
Mu
Mu
Xq
EO
Mu
Mu
Mu
Mu
Mu
jE
Mu
Mu
Mu
"}
(225,1,1) = {"
zk
Mu
Xq
Mu
Mu
Mu
Mu
EO
Mu
EO
Mu
Mu
Xc
Mu
so
"}
(226,1,1) = {"
zk
Xq
Mu
EO
Mu
EO
Mu
Mu
Mu
Mu
Xc
Mu
so
Mu
Mu
"}
(227,1,1) = {"
zk
Xq
Mu
Mu
Xc
Mu
Mu
EO
Mu
EO
Mu
Mu
Mu
EO
Mu
"}
(228,1,1) = {"
zk
Mu
Mu
EO
Mu
Mu
Mu
Mu
Mu
Mu
EO
Mu
Mu
Mu
Mu
"}
(229,1,1) = {"
zk
EO
Mu
so
Mu
EO
Mu
Mu
Mu
Xc
Mu
EO
Mu
Xq
Mu
"}
(230,1,1) = {"
zk
Mu
Mu
Mu
Mu
Mu
Mu
EO
Mu
EO
EO
Mu
Mu
jE
HR
"}
(231,1,1) = {"
zk
Mu
Mu
Mu
jE
Mu
Mu
Mu
Mu
Xq
Mu
EO
Mu
Mu
Mu
"}
(232,1,1) = {"
zk
Mu
Mu
EO
Mu
EO
Xc
Mu
Mu
Mu
Mu
Mu
Mu
EO
Mu
"}
(233,1,1) = {"
zk
Xq
Mu
Mu
Mu
Xq
Mu
Mu
EO
jE
EO
Mu
Mu
Mu
Mu
"}
(234,1,1) = {"
zk
EO
Mu
so
EO
Mu
EO
Mu
Mu
Mu
Mu
EO
Mu
Mu
Mu
"}
(235,1,1) = {"
zk
Mu
Mu
Mu
Mu
Mu
Mu
Mu
EO
Mu
Mu
Mu
Mu
EO
Mu
"}
(236,1,1) = {"
zk
Xq
EO
Mu
Mu
so
Mu
EO
Mu
Mu
Mu
Mu
Mu
Mu
Mu
"}
(237,1,1) = {"
zk
Xq
so
Xc
Mu
jE
Mu
so
Mu
EO
EO
Mu
Mu
Mu
Mu
"}
(238,1,1) = {"
zk
EO
Mu
Mu
Mu
Mu
Mu
Mu
Mu
Mu
Mu
EO
Mu
Mu
jE
"}
(239,1,1) = {"
zk
Mu
Mu
EO
Mu
EO
Mu
Xc
Mu
so
Mu
Mu
Mu
Mu
Mu
"}
(240,1,1) = {"
zk
Mu
Mu
Mu
so
Mu
Mu
Mu
Mu
EO
Mu
Mu
EO
Xc
Xq
"}
(241,1,1) = {"
zk
Mu
Xq
EO
Mu
Mu
EO
Mu
Mu
Mu
Mu
Mu
Mu
Mu
Mu
"}
(242,1,1) = {"
zk
Mu
Mu
Mu
Mu
Mu
Mu
EO
Mu
Xq
Mu
EO
Mu
EO
Mu
"}
(243,1,1) = {"
zk
jE
Mu
EO
Mu
EO
Mu
Mu
Mu
jE
HR
Mu
Mu
Mu
Mu
"}
(244,1,1) = {"
zk
Mu
Mu
Mu
Mu
Mu
Mu
EO
Mu
Mu
Mu
Xc
Mu
so
Mu
"}
(245,1,1) = {"
zk
Mu
EO
Mu
EO
Xc
Mu
Mu
Mu
EO
Mu
Mu
EO
EO
Mu
"}
(246,1,1) = {"
zk
Mu
Mu
Mu
Xq
Mu
Mu
Mu
Mu
Mu
Mu
Mu
Mu
Mu
Mu
"}
(247,1,1) = {"
zk
Mu
Mu
Mu
Mu
Mu
Mu
EO
Mu
Mu
Mu
Xc
Mu
so
Mu
"}
(248,1,1) = {"
zk
EO
Mu
Mu
Xq
EO
Mu
Mu
Mu
EO
Mu
Mu
Mu
EO
Mu
"}
(249,1,1) = {"
zk
Mu
Xq
Mu
Mu
Mu
Mu
Mu
Mu
Mu
Mu
Mu
Mu
Mu
Mu
"}
(250,1,1) = {"
zk
Xq
Mu
EO
Mu
EO
Mu
Mu
Mu
Mu
Mu
Mu
so
Mu
Mu
"}
(251,1,1) = {"
zk
Xq
Mu
Mu
Xc
Mu
Mu
EO
Mu
Mu
jE
Mu
EO
Mu
HR
"}
(252,1,1) = {"
zk
Mu
Mu
EO
Mu
Mu
Mu
Mu
Mu
Mu
Mu
Mu
Mu
Mu
Mu
"}
(253,1,1) = {"
zk
EO
Mu
so
Mu
EO
Mu
Mu
EO
Xc
Xq
Mu
Xq
Mu
Mu
"}
(254,1,1) = {"
zk
Mu
Mu
Mu
Mu
Mu
Mu
Mu
Mu
Mu
Mu
Mu
jE
HR
Mu
"}
(255,1,1) = {"
zk
Mu
Mu
Mu
jE
Mu
Mu
EO
Mu
EO
Mu
Mu
Mu
Mu
Mu
"}
