//MAP CONVERTED BY dmm2tgm.py THIS HEADER COMMENT PREVENTS RECONVERSION, DO NOT REMOVE
"a" = (
/turf/open/floor/fake_snow/safe,
/area/trainstation/outdoor/rails)
"q" = (
/turf/closed/mineral/random/icy_planet,
/area/trainstation/outdoor/rails)
"A" = (
/turf/closed/indestructible/train_border,
/area/trainstation/outdoor/rails)
"B" = (
/obj/structure/flora/grass/green/style_3,
/turf/open/floor/fake_snow/safe,
/area/trainstation/outdoor/rails)
"N" = (
/turf/closed/mineral/random/icy_planet/snow,
/area/trainstation/outdoor/rails)
"U" = (
/obj/structure/flora/tree/pine/style_random,
/turf/open/floor/fake_snow/safe,
/area/trainstation/outdoor/rails)

(1,1,1) = {"
A
q
q
q
q
q
q
q
q
q
q
a
a
a
a
"}
(2,1,1) = {"
A
q
q
q
q
q
q
q
q
q
q
a
a
a
a
"}
(3,1,1) = {"
A
q
q
q
q
q
q
q
q
q
q
a
a
a
a
"}
(4,1,1) = {"
A
q
q
q
q
q
q
q
q
q
q
a
a
a
a
"}
(5,1,1) = {"
A
q
q
q
q
q
q
q
q
q
a
a
a
a
a
"}
(6,1,1) = {"
A
q
q
q
q
q
q
q
q
q
a
a
a
a
a
"}
(7,1,1) = {"
A
q
q
q
q
q
q
q
q
q
a
B
a
a
a
"}
(8,1,1) = {"
A
q
q
q
q
q
q
q
q
q
a
a
a
a
a
"}
(9,1,1) = {"
A
q
q
q
q
q
q
q
q
q
a
a
a
U
a
"}
(10,1,1) = {"
A
q
q
q
q
q
q
q
q
q
a
a
a
a
U
"}
(11,1,1) = {"
A
q
q
q
q
q
q
q
q
q
a
a
a
a
a
"}
(12,1,1) = {"
A
q
q
q
q
q
q
q
q
q
a
a
a
a
U
"}
(13,1,1) = {"
A
q
q
q
q
q
q
q
q
q
a
a
U
U
a
"}
(14,1,1) = {"
A
q
q
q
q
q
q
q
q
q
a
a
a
a
U
"}
(15,1,1) = {"
A
q
q
q
q
q
q
q
q
q
a
B
a
a
a
"}
(16,1,1) = {"
A
q
q
q
q
q
q
q
q
q
a
a
a
a
U
"}
(17,1,1) = {"
A
q
q
q
q
q
q
q
q
q
a
a
a
U
a
"}
(18,1,1) = {"
A
q
q
q
q
q
q
q
q
q
a
a
a
a
a
"}
(19,1,1) = {"
A
q
q
q
q
q
q
q
q
q
N
a
U
U
a
"}
(20,1,1) = {"
A
q
q
q
q
q
q
q
q
q
N
a
a
a
a
"}
(21,1,1) = {"
A
q
q
q
q
q
q
q
q
q
N
a
a
a
a
"}
(22,1,1) = {"
A
q
q
q
q
q
q
q
q
N
N
a
a
a
a
"}
(23,1,1) = {"
A
q
q
q
q
q
q
q
q
N
N
a
a
a
a
"}
(24,1,1) = {"
A
q
q
q
q
q
q
q
q
N
N
a
a
a
a
"}
(25,1,1) = {"
A
q
q
q
q
q
q
q
q
N
N
a
a
a
a
"}
(26,1,1) = {"
A
q
q
q
q
q
q
q
q
N
N
N
a
a
a
"}
(27,1,1) = {"
A
q
q
q
q
q
q
q
q
N
N
N
a
a
a
"}
(28,1,1) = {"
A
q
q
q
q
q
q
q
q
N
N
N
a
a
a
"}
(29,1,1) = {"
A
q
q
q
q
q
q
q
q
N
N
N
a
a
a
"}
(30,1,1) = {"
A
q
q
q
q
q
q
q
q
N
N
N
a
a
a
"}
(31,1,1) = {"
A
q
q
q
q
q
q
q
q
N
N
a
a
a
a
"}
(32,1,1) = {"
A
q
q
q
q
q
q
q
q
N
N
a
a
a
a
"}
(33,1,1) = {"
A
q
q
q
q
q
q
q
q
N
N
a
a
a
a
"}
(34,1,1) = {"
A
q
q
q
q
q
q
q
N
N
N
a
a
a
a
"}
(35,1,1) = {"
A
q
q
q
q
q
q
q
N
N
a
a
a
a
a
"}
(36,1,1) = {"
A
q
q
q
q
q
q
q
N
q
a
a
a
a
a
"}
(37,1,1) = {"
A
q
q
q
q
q
q
q
q
q
a
a
a
a
a
"}
(38,1,1) = {"
A
q
q
q
q
q
q
q
q
q
a
B
a
a
a
"}
(39,1,1) = {"
A
q
q
q
q
q
q
q
q
q
a
a
a
a
a
"}
(40,1,1) = {"
A
q
q
q
q
q
q
q
q
q
a
a
a
U
a
"}
(41,1,1) = {"
A
q
q
q
q
q
q
q
q
q
a
a
a
a
U
"}
(42,1,1) = {"
A
q
q
q
q
q
q
q
q
q
a
a
a
a
a
"}
(43,1,1) = {"
A
q
q
q
q
q
q
q
q
N
a
a
a
a
U
"}
(44,1,1) = {"
A
q
q
q
q
q
q
q
q
N
a
a
U
U
a
"}
(45,1,1) = {"
A
q
q
q
q
q
q
q
q
N
N
a
a
a
U
"}
(46,1,1) = {"
A
q
q
q
q
q
q
q
q
N
N
B
a
a
a
"}
(47,1,1) = {"
A
q
q
q
q
q
q
q
q
N
N
a
a
a
U
"}
(48,1,1) = {"
A
q
q
q
q
q
q
q
q
N
N
a
a
U
a
"}
(49,1,1) = {"
A
q
q
q
q
q
q
q
q
N
N
a
a
a
a
"}
(50,1,1) = {"
A
q
q
q
q
q
q
q
q
N
N
a
U
U
a
"}
(51,1,1) = {"
A
q
q
q
q
q
q
q
q
N
N
N
N
a
a
"}
(52,1,1) = {"
A
q
q
q
q
q
q
q
q
N
N
N
N
a
a
"}
(53,1,1) = {"
A
q
q
q
q
q
q
q
q
N
N
N
a
a
a
"}
(54,1,1) = {"
A
q
q
q
q
q
q
q
q
N
N
N
a
a
a
"}
(55,1,1) = {"
A
q
q
q
q
q
q
q
q
N
N
N
a
a
a
"}
(56,1,1) = {"
A
q
q
q
q
q
q
q
q
N
N
N
a
a
a
"}
(57,1,1) = {"
A
q
q
q
q
q
q
q
q
N
N
a
a
a
a
"}
(58,1,1) = {"
A
q
q
q
q
q
q
q
q
N
a
a
a
a
a
"}
(59,1,1) = {"
A
q
q
q
q
q
q
q
q
N
a
a
a
a
a
"}
(60,1,1) = {"
A
q
q
q
q
q
q
q
q
N
a
a
a
a
a
"}
(61,1,1) = {"
A
q
q
q
q
q
q
q
q
q
q
a
a
a
a
"}
(62,1,1) = {"
A
q
q
q
q
q
q
q
q
q
q
a
a
a
a
"}
(63,1,1) = {"
A
q
q
q
q
q
q
q
q
q
q
a
a
a
a
"}
(64,1,1) = {"
A
q
q
q
q
q
q
q
q
q
q
a
a
a
a
"}
(65,1,1) = {"
A
q
q
q
q
q
q
q
q
q
q
q
a
a
a
"}
(66,1,1) = {"
A
q
q
q
q
q
q
q
q
q
q
q
a
a
a
"}
(67,1,1) = {"
A
q
q
q
q
q
q
q
q
q
q
a
a
a
a
"}
(68,1,1) = {"
A
q
q
q
q
q
q
q
q
q
q
a
a
a
a
"}
(69,1,1) = {"
A
q
q
q
q
q
q
q
q
q
q
B
a
a
a
"}
(70,1,1) = {"
A
q
q
q
q
q
q
q
q
q
a
a
a
a
a
"}
(71,1,1) = {"
A
q
q
q
q
q
q
q
q
a
B
a
a
U
a
"}
(72,1,1) = {"
A
q
q
q
q
q
q
q
q
a
a
a
a
a
U
"}
(73,1,1) = {"
A
q
q
q
q
q
q
q
q
a
a
a
a
a
a
"}
(74,1,1) = {"
A
q
q
q
q
q
q
q
q
a
a
a
a
a
U
"}
(75,1,1) = {"
A
q
q
q
q
q
q
q
q
a
a
a
U
U
a
"}
(76,1,1) = {"
A
q
q
q
q
q
q
q
q
a
a
a
a
a
U
"}
(77,1,1) = {"
A
q
q
q
q
q
q
q
q
a
a
B
a
a
a
"}
(78,1,1) = {"
A
q
q
q
q
q
q
q
q
a
a
a
a
a
U
"}
(79,1,1) = {"
A
q
q
q
q
q
q
q
q
a
B
a
a
U
a
"}
(80,1,1) = {"
A
q
q
q
q
q
q
q
q
a
a
a
a
a
a
"}
(81,1,1) = {"
A
q
q
q
q
q
q
q
q
a
a
a
U
U
a
"}
(82,1,1) = {"
A
q
q
q
q
q
q
q
q
B
a
a
a
a
a
"}
(83,1,1) = {"
A
q
q
q
q
q
q
q
q
a
a
a
a
a
a
"}
(84,1,1) = {"
A
q
q
q
q
q
q
q
q
a
a
U
a
U
a
"}
(85,1,1) = {"
A
q
q
q
q
q
q
q
q
a
a
a
U
a
U
"}
(86,1,1) = {"
A
q
q
q
q
q
q
q
q
a
a
a
a
a
a
"}
(87,1,1) = {"
A
q
q
q
q
q
q
q
q
a
a
a
U
a
U
"}
(88,1,1) = {"
A
q
q
q
q
q
q
q
q
a
U
U
a
U
a
"}
(89,1,1) = {"
A
q
q
q
q
q
q
q
q
a
a
a
U
a
U
"}
(90,1,1) = {"
A
q
q
q
q
q
q
q
q
B
a
a
a
a
a
"}
(91,1,1) = {"
A
q
q
q
q
q
q
q
q
a
a
a
U
a
U
"}
(92,1,1) = {"
A
q
q
q
q
q
q
q
q
a
a
U
a
U
a
"}
(93,1,1) = {"
A
q
q
q
q
q
q
q
q
a
a
a
a
a
a
"}
(94,1,1) = {"
A
q
q
q
q
q
q
q
q
a
U
U
a
U
a
"}
(95,1,1) = {"
A
q
q
q
q
q
q
q
a
a
a
a
U
a
a
"}
(96,1,1) = {"
A
q
q
q
q
q
q
q
a
B
a
a
a
a
a
"}
(97,1,1) = {"
A
q
q
q
q
q
q
q
a
a
a
B
a
a
a
"}
(98,1,1) = {"
A
q
q
q
q
q
q
q
a
a
a
a
a
a
a
"}
(99,1,1) = {"
A
q
q
q
q
q
q
q
a
a
a
a
a
U
a
"}
(100,1,1) = {"
A
q
q
q
q
q
q
a
a
a
U
a
a
a
U
"}
(101,1,1) = {"
A
q
q
q
q
q
q
a
a
a
a
a
a
a
a
"}
(102,1,1) = {"
A
q
q
q
q
q
q
a
a
a
a
a
a
a
U
"}
(103,1,1) = {"
A
q
q
q
q
q
q
a
a
a
a
a
U
U
a
"}
(104,1,1) = {"
A
q
q
q
q
q
q
a
a
a
a
a
a
a
U
"}
(105,1,1) = {"
A
q
q
q
q
q
N
N
a
a
a
B
a
a
a
"}
(106,1,1) = {"
A
q
q
q
q
q
N
N
a
a
a
a
a
a
U
"}
(107,1,1) = {"
A
q
q
q
q
q
N
N
N
N
a
a
a
U
a
"}
(108,1,1) = {"
A
q
q
q
q
q
N
N
N
N
a
a
a
a
a
"}
(109,1,1) = {"
A
q
q
q
q
q
N
N
N
N
a
a
U
U
a
"}
(110,1,1) = {"
A
q
q
q
q
q
N
N
N
N
a
a
a
a
U
"}
(111,1,1) = {"
A
q
q
q
q
q
N
N
N
a
a
B
a
a
a
"}
(112,1,1) = {"
A
q
q
q
q
q
N
N
N
a
a
a
a
a
U
"}
(113,1,1) = {"
A
q
q
q
q
q
N
N
N
a
a
a
a
U
a
"}
(114,1,1) = {"
A
q
q
q
q
q
N
N
N
a
a
a
a
a
a
"}
(115,1,1) = {"
A
q
q
q
q
q
N
N
a
a
a
a
U
U
a
"}
(116,1,1) = {"
A
q
q
q
q
q
N
N
a
a
a
a
a
a
a
"}
(117,1,1) = {"
A
q
q
q
q
q
N
a
a
a
B
a
a
a
a
"}
(118,1,1) = {"
A
q
q
q
q
q
N
a
a
a
B
a
a
a
a
"}
(119,1,1) = {"
A
q
q
q
q
q
N
a
a
a
a
a
a
a
a
"}
(120,1,1) = {"
A
q
q
q
q
q
N
a
a
a
a
a
U
a
a
"}
(121,1,1) = {"
A
q
q
q
q
q
q
q
q
a
a
a
a
U
a
"}
(122,1,1) = {"
A
q
q
q
q
q
q
q
q
a
a
a
a
a
a
"}
(123,1,1) = {"
A
q
q
q
q
q
q
q
q
a
a
a
a
U
a
"}
(124,1,1) = {"
A
q
q
q
q
q
q
q
q
a
a
U
U
a
a
"}
(125,1,1) = {"
A
q
q
q
q
q
q
q
q
a
a
a
a
U
a
"}
(126,1,1) = {"
A
q
q
q
q
q
q
q
q
B
a
a
a
a
a
"}
(127,1,1) = {"
A
q
q
q
q
q
q
q
q
a
a
a
a
U
a
"}
(128,1,1) = {"
A
q
q
q
q
q
q
q
q
a
a
U
a
a
a
"}
(129,1,1) = {"
A
q
q
q
q
q
q
q
q
a
a
a
U
a
a
"}
(130,1,1) = {"
A
q
q
q
q
q
q
q
q
a
a
a
a
a
U
"}
(131,1,1) = {"
A
q
q
q
q
q
q
q
q
a
a
a
U
a
a
"}
(132,1,1) = {"
A
q
q
q
q
q
q
q
q
a
U
U
a
a
U
"}
(133,1,1) = {"
A
q
q
q
q
q
q
q
q
a
a
a
U
U
a
"}
(134,1,1) = {"
A
q
q
q
q
q
q
q
B
B
a
a
a
a
U
"}
(135,1,1) = {"
A
q
q
q
q
q
q
q
a
a
a
a
U
a
a
"}
(136,1,1) = {"
A
q
q
q
q
q
q
q
a
a
a
U
a
a
U
"}
(137,1,1) = {"
A
q
q
q
q
q
q
q
a
a
a
a
a
U
a
"}
(138,1,1) = {"
A
q
q
q
q
q
q
q
a
a
U
U
a
a
a
"}
(139,1,1) = {"
A
q
q
q
q
q
q
q
a
a
a
U
a
a
a
"}
(140,1,1) = {"
A
q
q
q
q
q
q
q
a
a
a
a
a
U
a
"}
(141,1,1) = {"
A
q
q
q
q
q
q
q
a
a
U
U
a
a
U
"}
(142,1,1) = {"
A
q
q
q
q
q
q
q
B
a
U
U
a
a
a
"}
(143,1,1) = {"
A
q
q
q
q
q
q
q
a
a
a
U
a
a
U
"}
(144,1,1) = {"
A
q
q
q
q
q
q
q
a
a
U
a
U
U
a
"}
(145,1,1) = {"
A
q
q
q
q
q
q
q
a
a
a
a
a
a
U
"}
(146,1,1) = {"
A
q
q
q
q
q
q
q
a
U
U
a
a
a
a
"}
(147,1,1) = {"
A
q
q
q
q
q
q
q
q
a
a
a
a
a
U
"}
(148,1,1) = {"
A
q
q
q
q
q
q
q
q
a
a
a
a
U
a
"}
(149,1,1) = {"
A
q
q
q
q
q
q
q
q
a
a
B
a
a
a
"}
(150,1,1) = {"
A
q
q
q
q
q
q
q
q
a
a
a
a
a
a
"}
(151,1,1) = {"
A
q
q
q
q
q
q
q
q
a
a
a
a
U
a
"}
(152,1,1) = {"
A
q
q
q
q
q
q
q
q
a
a
a
a
a
U
"}
(153,1,1) = {"
A
q
q
q
q
q
q
q
q
a
a
a
a
a
a
"}
(154,1,1) = {"
A
q
q
q
q
q
q
q
q
a
a
a
a
a
U
"}
(155,1,1) = {"
A
q
q
q
q
q
q
q
q
a
a
a
U
U
a
"}
(156,1,1) = {"
A
q
q
q
q
q
q
q
q
a
B
a
a
a
U
"}
(157,1,1) = {"
A
q
q
q
q
q
q
q
q
a
a
a
a
a
a
"}
(158,1,1) = {"
A
q
q
q
q
q
q
q
q
a
a
a
U
a
U
"}
(159,1,1) = {"
A
q
q
q
q
q
q
q
q
a
a
a
a
U
a
"}
(160,1,1) = {"
A
q
q
q
q
q
q
q
a
a
a
a
a
a
a
"}
(161,1,1) = {"
A
q
q
q
q
q
q
q
a
a
a
a
a
U
a
"}
(162,1,1) = {"
A
q
q
q
q
q
q
q
a
a
a
U
U
a
a
"}
(163,1,1) = {"
A
q
q
q
q
q
q
q
a
a
a
a
a
U
a
"}
(164,1,1) = {"
A
q
q
q
q
q
q
q
a
B
a
B
a
a
a
"}
(165,1,1) = {"
A
q
q
q
q
q
q
q
a
a
a
a
a
a
a
"}
(166,1,1) = {"
A
q
q
q
q
q
q
q
a
a
a
a
a
U
a
"}
(167,1,1) = {"
A
q
q
q
q
q
q
q
a
a
a
a
a
a
U
"}
(168,1,1) = {"
A
q
q
q
q
q
q
q
a
B
a
a
a
a
a
"}
(169,1,1) = {"
A
q
q
q
q
q
q
q
a
a
a
a
a
a
U
"}
(170,1,1) = {"
A
q
q
q
q
q
q
a
a
a
a
a
U
U
a
"}
(171,1,1) = {"
A
q
q
q
q
q
q
a
a
a
a
a
a
a
U
"}
(172,1,1) = {"
A
q
q
q
q
q
q
a
a
a
a
B
a
a
a
"}
(173,1,1) = {"
A
q
q
q
q
q
q
a
a
a
a
a
a
a
U
"}
(174,1,1) = {"
A
q
q
q
q
q
q
B
a
a
U
a
a
U
a
"}
(175,1,1) = {"
A
q
q
q
q
q
q
a
a
a
a
a
a
a
a
"}
(176,1,1) = {"
A
q
q
q
q
q
q
a
a
B
a
a
U
U
a
"}
(177,1,1) = {"
A
q
q
q
q
q
q
a
a
a
a
a
U
a
a
"}
(178,1,1) = {"
A
q
q
q
q
q
q
a
a
a
a
U
a
a
U
"}
(179,1,1) = {"
A
q
q
q
q
q
q
a
a
a
a
a
a
U
a
"}
(180,1,1) = {"
A
q
q
q
q
q
q
a
U
a
U
U
a
a
U
"}
(181,1,1) = {"
A
q
q
q
q
q
q
a
a
a
U
a
a
U
a
"}
(182,1,1) = {"
A
q
q
q
q
q
q
B
a
a
a
U
a
a
a
"}
(183,1,1) = {"
A
q
q
q
q
q
q
a
a
a
U
a
U
U
a
"}
(184,1,1) = {"
A
q
q
q
q
q
q
a
a
U
a
a
a
a
a
"}
(185,1,1) = {"
A
q
q
q
q
q
q
a
a
a
a
a
U
U
a
"}
(186,1,1) = {"
A
q
q
q
q
q
q
a
U
U
a
U
a
a
a
"}
(187,1,1) = {"
A
q
q
q
q
q
q
a
a
a
a
a
U
a
a
"}
(188,1,1) = {"
A
q
q
q
q
q
q
a
a
B
a
a
a
a
a
"}
(189,1,1) = {"
A
q
q
q
q
q
q
a
a
a
a
a
U
a
a
"}
(190,1,1) = {"
A
q
q
q
q
q
q
a
a
a
a
U
a
a
a
"}
(191,1,1) = {"
A
q
q
q
q
q
q
a
a
a
a
a
a
a
a
"}
(192,1,1) = {"
A
q
q
q
q
q
q
a
a
a
U
U
a
U
a
"}
(193,1,1) = {"
A
q
q
q
q
q
q
a
a
a
a
a
a
a
a
"}
(194,1,1) = {"
A
q
q
q
q
q
q
a
a
a
a
a
a
U
a
"}
(195,1,1) = {"
A
q
q
q
q
q
q
a
a
a
a
U
U
a
a
"}
(196,1,1) = {"
A
q
q
q
q
q
q
q
a
a
a
B
a
a
a
"}
(197,1,1) = {"
A
q
q
q
q
q
q
q
a
a
B
a
a
a
a
"}
(198,1,1) = {"
A
q
q
q
q
q
q
q
a
a
a
a
a
U
a
"}
(199,1,1) = {"
A
q
q
q
q
q
q
q
a
a
a
a
a
a
U
"}
(200,1,1) = {"
A
q
q
q
q
q
q
q
a
a
a
a
a
a
a
"}
(201,1,1) = {"
A
q
q
q
q
q
q
q
a
a
a
a
a
a
U
"}
(202,1,1) = {"
A
q
q
q
q
q
q
q
q
a
a
a
U
U
a
"}
(203,1,1) = {"
A
q
q
q
q
q
q
q
q
a
a
a
a
a
U
"}
(204,1,1) = {"
A
q
q
q
q
q
q
q
q
a
a
B
a
a
a
"}
(205,1,1) = {"
A
q
q
q
q
q
q
q
q
a
B
a
a
a
U
"}
(206,1,1) = {"
A
q
q
q
q
q
q
q
q
q
a
a
a
U
a
"}
(207,1,1) = {"
A
q
q
q
q
q
q
q
q
q
B
a
a
a
a
"}
(208,1,1) = {"
A
q
q
q
q
q
q
q
q
q
a
a
U
U
a
"}
(209,1,1) = {"
A
q
q
q
q
q
q
q
q
q
a
a
a
U
a
"}
(210,1,1) = {"
A
q
q
q
q
q
q
q
q
q
a
a
a
a
a
"}
(211,1,1) = {"
A
q
q
q
q
q
q
q
q
q
a
a
U
U
a
"}
(212,1,1) = {"
A
q
q
q
q
q
q
q
q
q
a
a
a
U
a
"}
(213,1,1) = {"
A
q
q
q
q
q
q
q
q
q
a
U
U
a
a
"}
(214,1,1) = {"
A
q
q
q
q
q
q
q
q
q
a
a
a
U
a
"}
(215,1,1) = {"
A
q
q
q
q
q
q
q
q
q
B
a
a
a
a
"}
(216,1,1) = {"
A
q
q
q
q
q
q
q
q
q
a
a
a
U
a
"}
(217,1,1) = {"
A
q
q
q
q
q
q
q
q
a
a
a
U
a
a
"}
(218,1,1) = {"
A
q
q
q
q
q
q
q
q
a
a
a
a
a
a
"}
(219,1,1) = {"
A
q
q
q
q
q
q
q
a
a
a
U
U
a
a
"}
(220,1,1) = {"
A
q
q
q
q
q
q
q
a
a
a
a
a
a
a
"}
(221,1,1) = {"
A
q
q
q
q
q
q
q
a
a
B
a
a
a
a
"}
(222,1,1) = {"
A
q
q
q
q
q
q
q
a
a
a
a
a
a
a
"}
(223,1,1) = {"
A
q
q
q
q
q
q
q
a
a
a
a
U
a
a
"}
(224,1,1) = {"
A
q
q
q
q
q
q
q
a
a
a
a
a
U
a
"}
(225,1,1) = {"
A
q
q
q
q
q
q
q
a
a
a
B
a
a
a
"}
(226,1,1) = {"
A
q
q
q
q
q
q
q
q
a
a
a
a
a
a
"}
(227,1,1) = {"
A
q
q
q
q
q
q
q
q
a
a
a
a
U
a
"}
(228,1,1) = {"
A
q
q
q
q
q
q
q
q
B
a
a
a
a
U
"}
(229,1,1) = {"
A
q
q
q
q
q
q
q
q
a
a
a
a
a
a
"}
(230,1,1) = {"
A
q
q
q
q
q
q
q
q
a
a
a
a
a
U
"}
(231,1,1) = {"
A
q
q
q
q
q
q
q
q
a
a
a
U
U
a
"}
(232,1,1) = {"
A
q
q
q
q
q
q
q
q
a
a
a
a
a
U
"}
(233,1,1) = {"
A
q
q
q
q
q
q
q
q
a
a
B
a
a
a
"}
(234,1,1) = {"
A
q
q
q
q
q
q
q
q
a
U
a
a
a
U
"}
(235,1,1) = {"
A
q
q
q
q
q
q
q
q
a
a
a
a
U
a
"}
(236,1,1) = {"
A
q
q
q
q
q
q
q
q
B
a
a
a
a
a
"}
(237,1,1) = {"
A
q
q
q
q
q
q
q
q
a
a
a
U
U
a
"}
(238,1,1) = {"
A
q
q
q
q
q
q
q
q
a
a
a
U
U
a
"}
(239,1,1) = {"
A
q
q
q
q
q
q
q
q
a
a
a
a
a
U
"}
(240,1,1) = {"
A
q
q
q
q
q
q
q
q
a
U
B
a
a
a
"}
(241,1,1) = {"
A
q
q
q
q
q
q
q
q
a
a
a
a
a
U
"}
(242,1,1) = {"
A
q
q
q
q
q
q
q
q
a
a
a
a
U
a
"}
(243,1,1) = {"
A
q
q
q
q
q
q
q
q
a
a
a
a
a
a
"}
(244,1,1) = {"
A
q
q
q
q
q
q
q
q
a
a
a
U
U
a
"}
(245,1,1) = {"
A
q
q
q
q
q
q
q
q
a
a
a
a
a
U
"}
(246,1,1) = {"
A
q
q
q
q
q
q
q
q
a
a
B
a
a
a
"}
(247,1,1) = {"
A
q
q
q
q
q
q
q
a
a
B
a
a
a
U
"}
(248,1,1) = {"
A
q
q
q
q
q
q
q
a
a
a
a
a
U
a
"}
(249,1,1) = {"
A
q
q
q
q
q
q
q
a
a
a
a
a
a
a
"}
(250,1,1) = {"
A
q
q
q
q
q
q
q
a
a
a
a
U
U
a
"}
(251,1,1) = {"
A
q
q
q
q
q
q
q
a
a
a
a
a
U
a
"}
(252,1,1) = {"
A
q
q
q
q
q
q
q
a
a
a
a
a
a
U
"}
(253,1,1) = {"
A
q
q
q
q
q
q
q
a
a
a
a
a
a
a
"}
(254,1,1) = {"
A
q
q
q
q
q
q
q
a
a
a
a
a
a
U
"}
(255,1,1) = {"
A
q
q
q
q
q
q
a
a
a
B
a
U
U
a
"}
