//MAP CONVERTED BY dmm2tgm.py THIS HEADER COMMENT PREVENTS RECONVERSION, DO NOT REMOVE
"a" = (
/obj/effect/turf_decal/weather/snow/corner{
	dir = 1
	},
/obj/effect/turf_decal/weather/snow/corner,
/turf/open/floor/asphalt,
/area/trainstation/outdoor/rails)
"c" = (
/obj/structure/fence/interlink{
	dir = 8;
	pixel_y = -1
	},
/obj/effect/turf_decal/tile/dark/half{
	alpha = 55
	},
/turf/open/floor/black{
	name = "treacherous water";
	icon = 'icons/turf/beach.dmi';
	icon_state = "deepwater"
	},
/area/trainstation/outdoor/rails)
"g" = (
/turf/open/floor/plating/snowed/smoothed,
/area/trainstation/outdoor/rails)
"p" = (
/obj/effect/turf_decal/weather/snow,
/obj/effect/turf_decal/weather/snow/corner{
	dir = 5
	},
/obj/effect/turf_decal/weather/snow/corner,
/turf/open/floor/asphalt,
/area/trainstation/outdoor/rails)
"u" = (
/obj/effect/turf_decal/weather/snow,
/obj/effect/turf_decal/weather/snow/corner,
/obj/effect/turf_decal/weather/snow/corner{
	dir = 9
	},
/turf/open/floor/asphalt,
/area/trainstation/outdoor/rails)
"C" = (
/obj/structure/fence/interlink{
	dir = 8;
	pixel_y = -1
	},
/obj/effect/turf_decal/tile/dark/half{
	alpha = 55
	},
/obj/structure/prop/city/street_off{
	pixel_y = -13
	},
/turf/open/floor/black{
	name = "treacherous water";
	icon = 'icons/turf/beach.dmi';
	icon_state = "deepwater"
	},
/area/trainstation/outdoor/rails)
"K" = (
/turf/open/floor/fake_snow/safe,
/area/trainstation/outdoor/rails)
"L" = (
/turf/open/water/deep_beach/lethal,
/area/trainstation/outdoor/rails)
"O" = (
/obj/effect/turf_decal/weather/snow,
/obj/effect/turf_decal/weather/snow/corner{
	dir = 1
	},
/obj/effect/turf_decal/weather/snow/corner,
/turf/open/floor/asphalt,
/area/trainstation/outdoor/rails)
"U" = (
/turf/closed/indestructible/train_border,
/area/trainstation/outdoor/rails)

(1,1,1) = {"
U
L
L
L
L
L
L
L
L
L
L
L
c
K
g
"}
(2,1,1) = {"
U
L
L
L
L
L
L
L
L
L
L
L
c
K
g
"}
(3,1,1) = {"
U
L
L
L
L
L
L
L
L
L
L
L
c
K
g
"}
(4,1,1) = {"
U
L
L
L
L
L
L
L
L
L
L
L
c
K
g
"}
(5,1,1) = {"
U
L
L
L
L
L
L
L
L
L
L
L
c
K
g
"}
(6,1,1) = {"
U
L
L
L
L
L
L
L
L
L
L
L
c
K
K
"}
(7,1,1) = {"
U
L
L
L
L
L
L
L
L
L
L
L
c
K
g
"}
(8,1,1) = {"
U
L
L
L
L
L
L
L
L
L
L
L
c
K
g
"}
(9,1,1) = {"
U
L
L
L
L
L
L
L
L
L
L
L
c
K
g
"}
(10,1,1) = {"
U
L
L
L
L
L
L
L
L
L
L
L
c
K
g
"}
(11,1,1) = {"
U
L
L
L
L
L
L
L
L
L
L
L
c
K
g
"}
(12,1,1) = {"
U
L
L
L
L
L
L
L
L
L
L
L
c
K
g
"}
(13,1,1) = {"
U
L
L
L
L
L
L
L
L
L
L
L
c
K
g
"}
(14,1,1) = {"
U
L
L
L
L
L
L
L
L
L
L
L
c
K
K
"}
(15,1,1) = {"
U
L
L
L
L
L
L
L
L
L
L
L
c
K
K
"}
(16,1,1) = {"
U
L
L
L
L
L
L
L
L
L
L
L
c
K
K
"}
(17,1,1) = {"
U
L
L
L
L
L
L
L
L
L
L
L
c
K
K
"}
(18,1,1) = {"
U
L
L
L
L
L
L
L
L
L
L
L
c
K
K
"}
(19,1,1) = {"
U
L
L
L
L
L
L
L
L
L
L
L
c
K
g
"}
(20,1,1) = {"
U
L
L
L
L
L
L
L
L
L
L
L
c
K
g
"}
(21,1,1) = {"
U
L
L
L
L
L
L
L
L
L
L
L
c
K
g
"}
(22,1,1) = {"
U
L
L
L
L
L
L
L
L
L
L
L
c
K
g
"}
(23,1,1) = {"
U
L
L
L
L
L
L
L
L
L
L
L
c
K
g
"}
(24,1,1) = {"
U
L
L
L
L
L
L
L
L
L
L
L
C
K
g
"}
(25,1,1) = {"
U
L
L
L
L
L
L
L
L
L
L
L
c
K
g
"}
(26,1,1) = {"
U
L
L
L
L
L
L
L
L
L
L
L
c
K
g
"}
(27,1,1) = {"
U
L
L
L
L
L
L
L
L
L
L
L
c
K
g
"}
(28,1,1) = {"
U
L
L
L
L
L
L
L
L
L
L
L
c
K
g
"}
(29,1,1) = {"
U
L
L
L
L
L
L
L
L
L
L
L
c
K
g
"}
(30,1,1) = {"
U
L
L
L
L
L
L
L
L
L
L
L
c
K
g
"}
(31,1,1) = {"
U
L
L
L
L
L
L
L
L
L
L
L
c
K
g
"}
(32,1,1) = {"
U
L
L
L
L
L
L
L
L
L
L
L
C
K
g
"}
(33,1,1) = {"
U
L
L
L
L
L
L
L
L
L
L
L
c
K
g
"}
(34,1,1) = {"
U
L
L
L
L
L
L
L
L
L
L
L
c
K
g
"}
(35,1,1) = {"
U
L
L
L
L
L
L
L
L
L
L
L
c
K
g
"}
(36,1,1) = {"
U
L
L
L
L
L
L
L
L
L
L
L
c
K
g
"}
(37,1,1) = {"
U
L
L
L
L
L
L
L
L
L
L
L
c
K
g
"}
(38,1,1) = {"
U
L
L
L
L
L
L
L
L
L
L
L
c
K
g
"}
(39,1,1) = {"
U
L
L
L
L
L
L
L
L
L
L
L
c
K
u
"}
(40,1,1) = {"
U
L
L
L
L
L
L
L
L
L
L
L
C
K
O
"}
(41,1,1) = {"
U
L
L
L
L
L
L
L
L
L
L
L
c
K
O
"}
(42,1,1) = {"
U
L
L
L
L
L
L
L
L
L
L
L
c
K
O
"}
(43,1,1) = {"
U
L
L
L
L
L
L
L
L
L
L
L
c
K
a
"}
(44,1,1) = {"
U
L
L
L
L
L
L
L
L
L
L
L
c
K
a
"}
(45,1,1) = {"
U
L
L
L
L
L
L
L
L
L
L
L
c
K
a
"}
(46,1,1) = {"
U
L
L
L
L
L
L
L
L
L
L
L
c
K
a
"}
(47,1,1) = {"
U
L
L
L
L
L
L
L
L
L
L
L
c
K
a
"}
(48,1,1) = {"
U
L
L
L
L
L
L
L
L
L
L
L
C
K
a
"}
(49,1,1) = {"
U
L
L
L
L
L
L
L
L
L
L
L
c
K
a
"}
(50,1,1) = {"
U
L
L
L
L
L
L
L
L
L
L
L
c
K
a
"}
(51,1,1) = {"
U
L
L
L
L
L
L
L
L
L
L
L
c
K
a
"}
(52,1,1) = {"
U
L
L
L
L
L
L
L
L
L
L
L
c
K
O
"}
(53,1,1) = {"
U
L
L
L
L
L
L
L
L
L
L
L
c
K
O
"}
(54,1,1) = {"
U
L
L
L
L
L
L
L
L
L
L
L
c
K
O
"}
(55,1,1) = {"
U
L
L
L
L
L
L
L
L
L
L
L
c
K
O
"}
(56,1,1) = {"
U
L
L
L
L
L
L
L
L
L
L
L
C
K
a
"}
(57,1,1) = {"
U
L
L
L
L
L
L
L
L
L
L
L
c
K
O
"}
(58,1,1) = {"
U
L
L
L
L
L
L
L
L
L
L
L
c
K
O
"}
(59,1,1) = {"
U
L
L
L
L
L
L
L
L
L
L
L
c
K
a
"}
(60,1,1) = {"
U
L
L
L
L
L
L
L
L
L
L
L
c
K
O
"}
(61,1,1) = {"
U
L
L
L
L
L
L
L
L
L
L
L
c
K
O
"}
(62,1,1) = {"
U
L
L
L
L
L
L
L
L
L
L
L
c
K
O
"}
(63,1,1) = {"
U
L
L
L
L
L
L
L
L
L
L
L
c
K
a
"}
(64,1,1) = {"
U
L
L
L
L
L
L
L
L
L
L
L
C
K
a
"}
(65,1,1) = {"
U
L
L
L
L
L
L
L
L
L
L
L
c
K
a
"}
(66,1,1) = {"
U
L
L
L
L
L
L
L
L
L
L
L
c
K
a
"}
(67,1,1) = {"
U
L
L
L
L
L
L
L
L
L
L
L
c
K
a
"}
(68,1,1) = {"
U
L
L
L
L
L
L
L
L
L
L
L
c
K
a
"}
(69,1,1) = {"
U
L
L
L
L
L
L
L
L
L
L
L
c
K
a
"}
(70,1,1) = {"
U
L
L
L
L
L
L
L
L
L
L
L
c
K
a
"}
(71,1,1) = {"
U
L
L
L
L
L
L
L
L
L
L
L
c
K
a
"}
(72,1,1) = {"
U
L
L
L
L
L
L
L
L
L
L
L
C
K
a
"}
(73,1,1) = {"
U
L
L
L
L
L
L
L
L
L
L
L
c
K
a
"}
(74,1,1) = {"
U
L
L
L
L
L
L
L
L
L
L
L
c
K
a
"}
(75,1,1) = {"
U
L
L
L
L
L
L
L
L
L
L
L
c
K
a
"}
(76,1,1) = {"
U
L
L
L
L
L
L
L
L
L
L
L
c
K
a
"}
(77,1,1) = {"
U
L
L
L
L
L
L
L
L
L
L
L
c
K
a
"}
(78,1,1) = {"
U
L
L
L
L
L
L
L
L
L
L
L
c
K
a
"}
(79,1,1) = {"
U
L
L
L
L
L
L
L
L
L
L
L
c
K
O
"}
(80,1,1) = {"
U
L
L
L
L
L
L
L
L
L
L
L
c
K
O
"}
(81,1,1) = {"
U
L
L
L
L
L
L
L
L
L
L
L
C
K
O
"}
(82,1,1) = {"
U
L
L
L
L
L
L
L
L
L
L
L
c
K
a
"}
(83,1,1) = {"
U
L
L
L
L
L
L
L
L
L
L
L
c
K
O
"}
(84,1,1) = {"
U
L
L
L
L
L
L
L
L
L
L
L
c
K
a
"}
(85,1,1) = {"
U
L
L
L
L
L
L
L
L
L
L
L
c
K
a
"}
(86,1,1) = {"
U
L
L
L
L
L
L
L
L
L
L
L
c
K
a
"}
(87,1,1) = {"
U
L
L
L
L
L
L
L
L
L
L
L
c
K
a
"}
(88,1,1) = {"
U
L
L
L
L
L
L
L
L
L
L
L
c
K
a
"}
(89,1,1) = {"
U
L
L
L
L
L
L
L
L
L
L
L
c
K
a
"}
(90,1,1) = {"
U
L
L
L
L
L
L
L
L
L
L
L
C
K
a
"}
(91,1,1) = {"
U
L
L
L
L
L
L
L
L
L
L
L
c
K
a
"}
(92,1,1) = {"
U
L
L
L
L
L
L
L
L
L
L
L
c
K
O
"}
(93,1,1) = {"
U
L
L
L
L
L
L
L
L
L
L
L
c
K
O
"}
(94,1,1) = {"
U
L
L
L
L
L
L
L
L
L
L
L
c
K
O
"}
(95,1,1) = {"
U
L
L
L
L
L
L
L
L
L
L
L
c
K
a
"}
(96,1,1) = {"
U
L
L
L
L
L
L
L
L
L
L
L
c
K
a
"}
(97,1,1) = {"
U
L
L
L
L
L
L
L
L
L
L
L
c
K
a
"}
(98,1,1) = {"
U
L
L
L
L
L
L
L
L
L
L
L
C
K
a
"}
(99,1,1) = {"
U
L
L
L
L
L
L
L
L
L
L
L
c
K
a
"}
(100,1,1) = {"
U
L
L
L
L
L
L
L
L
L
L
L
c
K
a
"}
(101,1,1) = {"
U
L
L
L
L
L
L
L
L
L
L
L
c
K
a
"}
(102,1,1) = {"
U
L
L
L
L
L
L
L
L
L
L
L
c
K
a
"}
(103,1,1) = {"
U
L
L
L
L
L
L
L
L
L
L
L
c
K
a
"}
(104,1,1) = {"
U
L
L
L
L
L
L
L
L
L
L
L
c
K
a
"}
(105,1,1) = {"
U
L
L
L
L
L
L
L
L
L
L
L
c
K
a
"}
(106,1,1) = {"
U
L
L
L
L
L
L
L
L
L
L
L
C
K
a
"}
(107,1,1) = {"
U
L
L
L
L
L
L
L
L
L
L
L
c
K
a
"}
(108,1,1) = {"
U
L
L
L
L
L
L
L
L
L
L
L
c
K
a
"}
(109,1,1) = {"
U
L
L
L
L
L
L
L
L
L
L
L
c
K
a
"}
(110,1,1) = {"
U
L
L
L
L
L
L
L
L
L
L
L
c
K
a
"}
(111,1,1) = {"
U
L
L
L
L
L
L
L
L
L
L
L
c
K
O
"}
(112,1,1) = {"
U
L
L
L
L
L
L
L
L
L
L
L
c
K
O
"}
(113,1,1) = {"
U
L
L
L
L
L
L
L
L
L
L
L
c
K
O
"}
(114,1,1) = {"
U
L
L
L
L
L
L
L
L
L
L
L
C
K
a
"}
(115,1,1) = {"
U
L
L
L
L
L
L
L
L
L
L
L
c
K
a
"}
(116,1,1) = {"
U
L
L
L
L
L
L
L
L
L
L
L
c
K
O
"}
(117,1,1) = {"
U
L
L
L
L
L
L
L
L
L
L
L
c
K
a
"}
(118,1,1) = {"
U
L
L
L
L
L
L
L
L
L
L
L
c
K
O
"}
(119,1,1) = {"
U
L
L
L
L
L
L
L
L
L
L
L
c
K
a
"}
(120,1,1) = {"
U
L
L
L
L
L
L
L
L
L
L
L
c
K
O
"}
(121,1,1) = {"
U
L
L
L
L
L
L
L
L
L
L
L
c
K
O
"}
(122,1,1) = {"
U
L
L
L
L
L
L
L
L
L
L
L
C
K
O
"}
(123,1,1) = {"
U
L
L
L
L
L
L
L
L
L
L
L
c
K
p
"}
(124,1,1) = {"
U
L
L
L
L
L
L
L
L
L
L
L
c
K
g
"}
(125,1,1) = {"
U
L
L
L
L
L
L
L
L
L
L
L
c
K
g
"}
(126,1,1) = {"
U
L
L
L
L
L
L
L
L
L
L
L
c
K
g
"}
(127,1,1) = {"
U
L
L
L
L
L
L
L
L
L
L
L
c
K
g
"}
(128,1,1) = {"
U
L
L
L
L
L
L
L
L
L
L
L
c
K
g
"}
(129,1,1) = {"
U
L
L
L
L
L
L
L
L
L
L
L
c
K
g
"}
(130,1,1) = {"
U
L
L
L
L
L
L
L
L
L
L
L
C
K
g
"}
(131,1,1) = {"
U
L
L
L
L
L
L
L
L
L
L
L
c
K
g
"}
(132,1,1) = {"
U
L
L
L
L
L
L
L
L
L
L
L
c
K
g
"}
(133,1,1) = {"
U
L
L
L
L
L
L
L
L
L
L
L
c
K
g
"}
(134,1,1) = {"
U
L
L
L
L
L
L
L
L
L
L
L
c
K
g
"}
(135,1,1) = {"
U
L
L
L
L
L
L
L
L
L
L
L
c
K
g
"}
(136,1,1) = {"
U
L
L
L
L
L
L
L
L
L
L
L
c
K
g
"}
(137,1,1) = {"
U
L
L
L
L
L
L
L
L
L
L
L
c
K
g
"}
(138,1,1) = {"
U
L
L
L
L
L
L
L
L
L
L
L
C
K
g
"}
(139,1,1) = {"
U
L
L
L
L
L
L
L
L
L
L
L
c
K
g
"}
(140,1,1) = {"
U
L
L
L
L
L
L
L
L
L
L
L
c
K
g
"}
(141,1,1) = {"
U
L
L
L
L
L
L
L
L
L
L
L
c
K
g
"}
(142,1,1) = {"
U
L
L
L
L
L
L
L
L
L
L
L
c
K
g
"}
(143,1,1) = {"
U
L
L
L
L
L
L
L
L
L
L
L
c
K
g
"}
(144,1,1) = {"
U
L
L
L
L
L
L
L
L
L
L
L
c
K
K
"}
(145,1,1) = {"
U
L
L
L
L
L
L
L
L
L
L
L
c
K
K
"}
(146,1,1) = {"
U
L
L
L
L
L
L
L
L
L
L
L
c
K
g
"}
(147,1,1) = {"
U
L
L
L
L
L
L
L
L
L
L
L
c
K
g
"}
(148,1,1) = {"
U
L
L
L
L
L
L
L
L
L
L
L
c
K
g
"}
(149,1,1) = {"
U
L
L
L
L
L
L
L
L
L
L
L
c
K
K
"}
(150,1,1) = {"
U
L
L
L
L
L
L
L
L
L
L
L
c
K
K
"}
(151,1,1) = {"
U
L
L
L
L
L
L
L
L
L
L
L
c
K
K
"}
(152,1,1) = {"
U
L
L
L
L
L
L
L
L
L
L
L
c
K
K
"}
(153,1,1) = {"
U
L
L
L
L
L
L
L
L
L
L
L
c
K
g
"}
(154,1,1) = {"
U
L
L
L
L
L
L
L
L
L
L
L
c
K
g
"}
(155,1,1) = {"
U
L
L
L
L
L
L
L
L
L
L
L
c
K
g
"}
(156,1,1) = {"
U
L
L
L
L
L
L
L
L
L
L
L
c
K
g
"}
(157,1,1) = {"
U
L
L
L
L
L
L
L
L
L
L
L
c
K
g
"}
(158,1,1) = {"
U
L
L
L
L
L
L
L
L
L
L
L
c
K
g
"}
(159,1,1) = {"
U
L
L
L
L
L
L
L
L
L
L
L
c
K
K
"}
(160,1,1) = {"
U
L
L
L
L
L
L
L
L
L
L
L
c
K
g
"}
(161,1,1) = {"
U
L
L
L
L
L
L
L
L
L
L
L
c
K
K
"}
(162,1,1) = {"
U
L
L
L
L
L
L
L
L
L
L
L
c
K
g
"}
(163,1,1) = {"
U
L
L
L
L
L
L
L
L
L
L
L
c
K
g
"}
(164,1,1) = {"
U
L
L
L
L
L
L
L
L
L
L
L
c
K
g
"}
(165,1,1) = {"
U
L
L
L
L
L
L
L
L
L
L
L
c
K
g
"}
(166,1,1) = {"
U
L
L
L
L
L
L
L
L
L
L
L
c
K
g
"}
(167,1,1) = {"
U
L
L
L
L
L
L
L
L
L
L
L
c
K
K
"}
(168,1,1) = {"
U
L
L
L
L
L
L
L
L
L
L
L
c
K
K
"}
(169,1,1) = {"
U
L
L
L
L
L
L
L
L
L
L
L
c
K
K
"}
(170,1,1) = {"
U
L
L
L
L
L
L
L
L
L
L
L
c
K
K
"}
(171,1,1) = {"
U
L
L
L
L
L
L
L
L
L
L
L
c
K
K
"}
(172,1,1) = {"
U
L
L
L
L
L
L
L
L
L
L
L
c
K
K
"}
(173,1,1) = {"
U
L
L
L
L
L
L
L
L
L
L
L
c
K
K
"}
(174,1,1) = {"
U
L
L
L
L
L
L
L
L
L
L
L
c
K
K
"}
(175,1,1) = {"
U
L
L
L
L
L
L
L
L
L
L
L
c
K
K
"}
(176,1,1) = {"
U
L
L
L
L
L
L
L
L
L
L
L
c
K
K
"}
(177,1,1) = {"
U
L
L
L
L
L
L
L
L
L
L
L
c
K
g
"}
(178,1,1) = {"
U
L
L
L
L
L
L
L
L
L
L
L
c
K
g
"}
(179,1,1) = {"
U
L
L
L
L
L
L
L
L
L
L
L
c
K
g
"}
(180,1,1) = {"
U
L
L
L
L
L
L
L
L
L
L
L
c
K
K
"}
(181,1,1) = {"
U
L
L
L
L
L
L
L
L
L
L
L
c
K
g
"}
(182,1,1) = {"
U
L
L
L
L
L
L
L
L
L
L
L
c
K
g
"}
(183,1,1) = {"
U
L
L
L
L
L
L
L
L
L
L
L
c
K
g
"}
(184,1,1) = {"
U
L
L
L
L
L
L
L
L
L
L
L
c
K
g
"}
(185,1,1) = {"
U
L
L
L
L
L
L
L
L
L
L
L
c
K
K
"}
(186,1,1) = {"
U
L
L
L
L
L
L
L
L
L
L
L
c
K
K
"}
(187,1,1) = {"
U
L
L
L
L
L
L
L
L
L
L
L
c
K
K
"}
(188,1,1) = {"
U
L
L
L
L
L
L
L
L
L
L
L
c
K
K
"}
(189,1,1) = {"
U
L
L
L
L
L
L
L
L
L
L
L
c
K
K
"}
(190,1,1) = {"
U
L
L
L
L
L
L
L
L
L
L
L
c
K
K
"}
(191,1,1) = {"
U
L
L
L
L
L
L
L
L
L
L
L
c
K
g
"}
(192,1,1) = {"
U
L
L
L
L
L
L
L
L
L
L
L
c
K
K
"}
(193,1,1) = {"
U
L
L
L
L
L
L
L
L
L
L
L
c
K
g
"}
(194,1,1) = {"
U
L
L
L
L
L
L
L
L
L
L
L
c
K
g
"}
(195,1,1) = {"
U
L
L
L
L
L
L
L
L
L
L
L
c
K
K
"}
(196,1,1) = {"
U
L
L
L
L
L
L
L
L
L
L
L
c
K
K
"}
(197,1,1) = {"
U
L
L
L
L
L
L
L
L
L
L
L
c
K
K
"}
(198,1,1) = {"
U
L
L
L
L
L
L
L
L
L
L
L
c
K
g
"}
(199,1,1) = {"
U
L
L
L
L
L
L
L
L
L
L
L
c
K
g
"}
(200,1,1) = {"
U
L
L
L
L
L
L
L
L
L
L
L
c
K
g
"}
(201,1,1) = {"
U
L
L
L
L
L
L
L
L
L
L
L
c
K
g
"}
(202,1,1) = {"
U
L
L
L
L
L
L
L
L
L
L
L
c
K
g
"}
(203,1,1) = {"
U
L
L
L
L
L
L
L
L
L
L
L
c
K
g
"}
(204,1,1) = {"
U
L
L
L
L
L
L
L
L
L
L
L
c
K
g
"}
(205,1,1) = {"
U
L
L
L
L
L
L
L
L
L
L
L
c
K
g
"}
(206,1,1) = {"
U
L
L
L
L
L
L
L
L
L
L
L
c
K
g
"}
(207,1,1) = {"
U
L
L
L
L
L
L
L
L
L
L
L
c
K
g
"}
(208,1,1) = {"
U
L
L
L
L
L
L
L
L
L
L
L
c
K
K
"}
(209,1,1) = {"
U
L
L
L
L
L
L
L
L
L
L
L
c
K
K
"}
(210,1,1) = {"
U
L
L
L
L
L
L
L
L
L
L
L
c
K
K
"}
(211,1,1) = {"
U
L
L
L
L
L
L
L
L
L
L
L
c
K
K
"}
(212,1,1) = {"
U
L
L
L
L
L
L
L
L
L
L
L
c
K
K
"}
(213,1,1) = {"
U
L
L
L
L
L
L
L
L
L
L
L
c
K
g
"}
(214,1,1) = {"
U
L
L
L
L
L
L
L
L
L
L
L
c
K
g
"}
(215,1,1) = {"
U
L
L
L
L
L
L
L
L
L
L
L
c
K
g
"}
(216,1,1) = {"
U
L
L
L
L
L
L
L
L
L
L
L
c
K
g
"}
(217,1,1) = {"
U
L
L
L
L
L
L
L
L
L
L
L
c
K
g
"}
(218,1,1) = {"
U
L
L
L
L
L
L
L
L
L
L
L
c
K
g
"}
(219,1,1) = {"
U
L
L
L
L
L
L
L
L
L
L
L
c
K
K
"}
(220,1,1) = {"
U
L
L
L
L
L
L
L
L
L
L
L
c
K
g
"}
(221,1,1) = {"
U
L
L
L
L
L
L
L
L
L
L
L
c
K
g
"}
(222,1,1) = {"
U
L
L
L
L
L
L
L
L
L
L
L
c
K
g
"}
(223,1,1) = {"
U
L
L
L
L
L
L
L
L
L
L
L
c
K
g
"}
(224,1,1) = {"
U
L
L
L
L
L
L
L
L
L
L
L
c
K
K
"}
(225,1,1) = {"
U
L
L
L
L
L
L
L
L
L
L
L
c
K
K
"}
(226,1,1) = {"
U
L
L
L
L
L
L
L
L
L
L
L
c
K
g
"}
(227,1,1) = {"
U
L
L
L
L
L
L
L
L
L
L
L
c
K
g
"}
(228,1,1) = {"
U
L
L
L
L
L
L
L
L
L
L
L
c
K
K
"}
(229,1,1) = {"
U
L
L
L
L
L
L
L
L
L
L
L
c
K
g
"}
(230,1,1) = {"
U
L
L
L
L
L
L
L
L
L
L
L
c
K
K
"}
(231,1,1) = {"
U
L
L
L
L
L
L
L
L
L
L
L
c
K
K
"}
(232,1,1) = {"
U
L
L
L
L
L
L
L
L
L
L
L
c
K
g
"}
(233,1,1) = {"
U
L
L
L
L
L
L
L
L
L
L
L
c
K
K
"}
(234,1,1) = {"
U
L
L
L
L
L
L
L
L
L
L
L
c
K
K
"}
(235,1,1) = {"
U
L
L
L
L
L
L
L
L
L
L
L
c
K
g
"}
(236,1,1) = {"
U
L
L
L
L
L
L
L
L
L
L
L
c
K
K
"}
(237,1,1) = {"
U
L
L
L
L
L
L
L
L
L
L
L
c
K
K
"}
(238,1,1) = {"
U
L
L
L
L
L
L
L
L
L
L
L
c
K
K
"}
(239,1,1) = {"
U
L
L
L
L
L
L
L
L
L
L
L
c
K
K
"}
(240,1,1) = {"
U
L
L
L
L
L
L
L
L
L
L
L
c
K
K
"}
(241,1,1) = {"
U
L
L
L
L
L
L
L
L
L
L
L
c
K
g
"}
(242,1,1) = {"
U
L
L
L
L
L
L
L
L
L
L
L
c
K
K
"}
(243,1,1) = {"
U
L
L
L
L
L
L
L
L
L
L
L
c
K
g
"}
(244,1,1) = {"
U
L
L
L
L
L
L
L
L
L
L
L
c
K
g
"}
(245,1,1) = {"
U
L
L
L
L
L
L
L
L
L
L
L
c
K
K
"}
(246,1,1) = {"
U
L
L
L
L
L
L
L
L
L
L
L
c
K
g
"}
(247,1,1) = {"
U
L
L
L
L
L
L
L
L
L
L
L
c
K
K
"}
(248,1,1) = {"
U
L
L
L
L
L
L
L
L
L
L
L
c
K
K
"}
(249,1,1) = {"
U
L
L
L
L
L
L
L
L
L
L
L
c
K
K
"}
(250,1,1) = {"
U
L
L
L
L
L
L
L
L
L
L
L
c
K
K
"}
(251,1,1) = {"
U
L
L
L
L
L
L
L
L
L
L
L
c
K
K
"}
(252,1,1) = {"
U
L
L
L
L
L
L
L
L
L
L
L
c
K
K
"}
(253,1,1) = {"
U
L
L
L
L
L
L
L
L
L
L
L
c
K
K
"}
(254,1,1) = {"
U
L
L
L
L
L
L
L
L
L
L
L
c
K
K
"}
(255,1,1) = {"
U
L
L
L
L
L
L
L
L
L
L
L
c
K
K
"}
