//MAP CONVERTED BY dmm2tgm.py THIS HEADER COMMENT PREVENTS RECONVERSION, DO NOT REMOVE
"a" = (
/turf/open/moving/rails/r3,
/area/trainstation/outdoor/powered_light)
"d" = (
/turf/open/moving/rails/r2,
/area/trainstation/outdoor/powered_light)
"e" = (
/turf/open/indestructible/train_platform/bottom,
/area/trainstation/outdoor/powered_light)
"f" = (
/turf/open/indestructible/train_platform,
/area/trainstation/outdoor/powered_light)
"m" = (
/turf/open/moving/rails/r12,
/area/trainstation/outdoor/powered_light)
"q" = (
/turf/closed/indestructible/rock/snow/ice/ore,
/area/trainstation/outdoor/powered_light)
"s" = (
/turf/open/moving/rails/l12,
/area/trainstation/outdoor/powered_light)
"u" = (
/turf/open/space/basic,
/area/trainstation/outdoor/powered_light)
"x" = (
/turf/open/moving/rails/l2,
/area/trainstation/outdoor/powered_light)
"y" = (
/turf/closed/wall/city/siding/style,
/area/trainstation/outdoor/powered_light)
"B" = (
/turf/open/moving/rails/r13,
/area/trainstation/outdoor/powered_light)
"C" = (
/turf/open/moving/rails/l13,
/area/trainstation/outdoor/powered_light)
"H" = (
/obj/docking_port/stationary/cargo_station,
/turf/open/moving/rails/r12,
/area/trainstation/outdoor/powered_light)
"K" = (
/turf/open/moving/rails/l4,
/area/trainstation/outdoor/powered_light)
"M" = (
/turf/open/misc/snow/actually_safe,
/area/trainstation/outdoor/powered_light)
"O" = (
/turf/open/moving/rails/l1,
/area/trainstation/outdoor/powered_light)
"R" = (
/turf/open/moving/rails/r4,
/area/trainstation/outdoor/powered_light)
"S" = (
/turf/open/indestructible/train_platform/top,
/area/trainstation/outdoor/powered_light)
"T" = (
/turf/open/moving/rails/l3,
/area/trainstation/outdoor/powered_light)
"Y" = (
/turf/closed/wall/city/siding/style/style_2,
/area/trainstation/outdoor/powered_light)

(1,1,1) = {"
q
q
M
M
O
x
T
T
K
T
T
T
T
T
K
T
T
s
C
e
f
f
f
f
f
f
f
f
f
S
"}
(2,1,1) = {"
q
q
M
M
O
d
a
a
R
a
a
a
a
a
R
a
a
m
B
e
f
f
f
f
f
f
f
f
f
S
"}
(3,1,1) = {"
q
q
M
M
O
x
T
T
K
T
T
T
T
T
K
T
T
s
C
e
f
f
f
f
f
f
f
f
f
S
"}
(4,1,1) = {"
q
q
M
M
O
d
a
a
R
a
a
a
a
a
R
a
a
m
B
e
f
f
f
f
f
f
f
f
f
S
"}
(5,1,1) = {"
q
q
M
M
O
x
T
T
K
T
T
T
T
T
K
T
T
s
C
e
f
f
f
f
f
f
f
f
f
S
"}
(6,1,1) = {"
q
q
M
M
O
d
a
a
R
a
a
a
a
a
R
a
a
m
B
e
f
f
f
f
f
f
f
f
f
S
"}
(7,1,1) = {"
q
q
M
M
O
x
T
T
K
T
T
T
T
T
K
T
T
s
C
e
f
f
f
f
f
f
f
f
f
S
"}
(8,1,1) = {"
q
q
M
M
O
d
a
a
R
a
a
a
a
a
R
a
a
m
B
e
f
f
f
f
f
f
f
f
f
S
"}
(9,1,1) = {"
q
q
M
M
O
x
T
T
K
T
T
T
T
T
K
T
T
s
C
e
f
f
f
f
f
f
f
f
f
S
"}
(10,1,1) = {"
q
q
M
M
O
d
a
a
R
a
a
a
a
a
R
a
a
m
B
e
f
f
f
f
f
f
f
f
f
S
"}
(11,1,1) = {"
q
q
q
M
O
x
T
T
K
T
T
T
T
T
K
T
T
s
C
e
f
f
f
f
f
f
f
f
f
S
"}
(12,1,1) = {"
q
q
q
M
O
d
a
a
R
a
a
a
a
a
R
a
a
m
B
e
f
f
f
f
f
f
f
f
f
S
"}
(13,1,1) = {"
q
q
q
M
O
x
T
T
K
T
T
T
T
T
K
T
T
s
C
e
f
f
f
f
f
f
f
f
f
S
"}
(14,1,1) = {"
q
q
q
M
O
d
a
a
R
a
a
a
a
a
R
a
a
m
B
e
f
f
f
f
f
f
f
f
f
S
"}
(15,1,1) = {"
q
q
q
M
O
x
T
T
K
T
T
T
T
T
K
T
T
s
C
e
f
f
f
f
f
f
f
f
f
S
"}
(16,1,1) = {"
q
q
q
M
O
d
a
a
R
a
a
a
a
a
R
a
a
m
B
e
f
f
f
f
f
f
f
f
f
S
"}
(17,1,1) = {"
q
q
q
M
O
x
T
T
K
T
T
T
T
T
K
T
T
s
C
e
f
f
f
f
f
f
f
f
f
S
"}
(18,1,1) = {"
q
q
q
M
O
d
a
a
R
a
a
a
a
a
R
a
a
m
B
e
f
f
f
f
f
f
f
f
f
S
"}
(19,1,1) = {"
q
q
q
M
O
x
T
T
K
T
T
T
T
T
K
T
T
s
C
e
f
f
f
f
f
f
f
f
f
S
"}
(20,1,1) = {"
q
q
M
M
O
d
a
a
R
a
a
a
a
a
R
a
a
m
B
e
f
f
f
f
f
f
f
f
f
S
"}
(21,1,1) = {"
q
q
M
M
O
x
T
T
K
T
T
T
T
T
K
T
T
s
C
e
f
f
f
f
f
f
f
f
f
S
"}
(22,1,1) = {"
q
q
M
M
O
d
a
a
R
a
a
a
a
a
R
a
a
m
B
e
f
f
f
f
f
f
f
f
f
S
"}
(23,1,1) = {"
q
q
M
M
O
x
T
T
K
T
T
T
T
T
K
T
T
s
C
e
f
f
f
f
f
f
f
f
f
S
"}
(24,1,1) = {"
q
q
M
M
O
d
a
a
R
a
a
a
a
a
R
a
a
m
B
e
f
f
f
f
f
f
f
f
f
S
"}
(25,1,1) = {"
q
q
M
M
O
x
T
T
K
T
T
T
T
T
K
T
T
s
C
e
f
f
f
f
f
f
f
f
f
S
"}
(26,1,1) = {"
q
q
M
M
O
d
a
a
R
a
a
a
a
a
R
a
a
H
B
e
f
f
f
f
f
f
f
f
f
S
"}
(27,1,1) = {"
q
q
M
M
O
x
T
T
K
T
T
T
T
T
K
T
T
s
C
e
f
f
f
f
f
f
f
f
f
S
"}
(28,1,1) = {"
q
q
M
M
O
d
a
a
R
a
a
a
a
a
R
a
a
m
B
e
f
f
f
f
f
f
f
f
f
S
"}
(29,1,1) = {"
q
q
M
M
O
x
T
T
K
T
T
T
T
T
K
T
T
s
C
e
f
f
f
f
f
f
f
f
f
S
"}
(30,1,1) = {"
q
q
M
M
O
d
a
a
R
a
a
a
a
a
R
a
a
m
B
e
f
f
f
f
f
f
f
f
f
S
"}
(31,1,1) = {"
q
q
M
M
O
x
T
T
K
T
T
T
T
T
K
T
T
s
C
e
f
f
f
f
f
f
f
f
f
S
"}
(32,1,1) = {"
q
q
M
M
O
d
a
a
R
a
a
a
a
a
R
a
a
m
B
e
f
f
f
f
f
f
f
f
f
S
"}
(33,1,1) = {"
q
q
q
M
O
x
T
T
K
T
T
T
T
T
K
T
T
s
C
e
f
f
f
f
f
f
f
f
f
S
"}
(34,1,1) = {"
q
q
q
M
O
d
a
a
R
a
a
a
a
a
R
a
a
m
B
e
f
f
f
f
f
f
f
f
f
S
"}
(35,1,1) = {"
q
q
q
M
O
x
T
T
K
T
T
T
T
T
K
T
T
s
C
e
f
f
f
f
f
f
f
f
f
S
"}
(36,1,1) = {"
q
q
q
M
O
d
a
a
R
a
a
a
a
a
R
a
a
m
B
e
f
f
f
f
f
f
f
f
f
S
"}
(37,1,1) = {"
q
q
q
M
O
x
T
T
K
T
T
T
T
T
K
T
T
s
C
e
f
f
f
f
f
f
f
f
f
S
"}
(38,1,1) = {"
q
q
q
M
O
d
a
a
R
a
a
a
a
a
R
a
a
m
B
e
f
f
f
f
f
f
f
f
f
S
"}
(39,1,1) = {"
q
q
q
M
O
x
T
T
K
T
T
T
T
T
K
T
T
s
C
e
f
f
f
f
f
f
f
f
f
S
"}
(40,1,1) = {"
q
q
q
q
O
d
a
a
R
a
a
a
a
a
R
a
a
m
B
e
f
f
f
f
f
f
f
f
f
S
"}
(41,1,1) = {"
q
q
q
q
O
x
T
T
K
T
T
T
T
T
K
T
T
s
C
e
f
f
f
f
f
f
f
f
f
S
"}
(42,1,1) = {"
q
q
q
q
O
d
a
a
R
a
a
a
a
a
R
a
a
m
B
e
f
f
f
f
f
f
f
f
f
S
"}
(43,1,1) = {"
q
q
q
q
O
x
T
T
K
T
T
T
T
T
K
T
T
s
C
e
f
f
f
f
f
f
f
f
f
S
"}
(44,1,1) = {"
q
q
q
q
O
d
a
a
R
a
a
a
a
a
R
a
a
m
B
e
f
f
f
f
f
f
f
f
f
S
"}
(45,1,1) = {"
q
q
q
q
O
x
T
T
K
T
T
T
T
T
K
T
T
s
C
e
f
f
f
f
f
f
f
f
f
S
"}
(46,1,1) = {"
q
q
q
M
O
d
a
a
R
a
a
a
a
a
R
a
a
m
B
e
f
f
f
f
f
f
f
f
f
S
"}
(47,1,1) = {"
q
q
q
M
O
x
T
T
K
T
T
T
T
T
K
T
T
s
C
e
f
f
f
f
f
f
f
f
f
S
"}
(48,1,1) = {"
q
q
q
M
O
d
a
a
R
a
a
a
a
a
R
a
a
m
B
e
f
f
f
f
f
f
f
f
f
S
"}
(49,1,1) = {"
q
q
q
M
O
x
T
T
K
T
T
T
T
T
K
T
T
s
C
e
f
f
f
f
f
f
f
f
f
S
"}
(50,1,1) = {"
q
q
q
M
O
d
a
a
R
a
a
a
a
a
R
a
a
m
B
e
f
f
f
f
f
f
f
f
f
S
"}
(51,1,1) = {"
q
q
q
M
O
x
T
T
K
T
T
T
T
T
K
T
T
s
C
e
f
f
f
f
f
f
f
f
f
S
"}
(52,1,1) = {"
q
q
q
M
O
d
a
a
R
a
a
a
a
a
R
a
a
m
B
e
f
f
f
f
f
f
f
f
f
S
"}
(53,1,1) = {"
q
q
q
M
O
x
T
T
K
T
T
T
T
T
K
T
T
s
C
e
f
f
f
f
f
f
f
f
f
S
"}
(54,1,1) = {"
q
q
q
M
O
d
a
a
R
a
a
a
a
a
R
a
a
m
B
e
f
f
f
f
f
f
f
f
f
S
"}
(55,1,1) = {"
q
q
q
M
O
x
T
T
K
T
T
T
T
T
K
T
T
s
C
e
f
f
f
f
f
f
f
f
f
S
"}
(56,1,1) = {"
q
q
q
M
O
d
a
a
R
a
a
a
a
a
R
a
a
m
B
e
f
f
f
f
f
f
f
f
f
S
"}
(57,1,1) = {"
q
q
M
M
O
x
T
T
K
T
T
T
T
T
K
T
T
s
C
e
f
f
f
f
f
f
f
f
f
S
"}
(58,1,1) = {"
q
q
M
M
O
d
a
a
R
a
a
a
a
a
R
a
a
m
B
e
f
f
f
f
f
f
f
f
f
S
"}
(59,1,1) = {"
q
q
M
M
O
x
T
T
K
T
T
T
T
T
K
T
T
s
C
e
f
f
f
f
f
f
f
f
f
S
"}
(60,1,1) = {"
q
q
M
M
O
d
a
a
R
a
a
a
a
a
R
a
a
m
B
e
f
f
f
f
f
f
f
f
f
S
"}
(61,1,1) = {"
q
M
M
M
O
x
T
T
K
T
T
T
T
T
K
T
T
s
C
e
f
f
f
f
f
f
f
f
f
S
"}
(62,1,1) = {"
q
M
M
M
O
d
a
a
R
a
a
a
a
a
R
a
a
m
B
e
f
f
f
f
f
f
f
f
f
S
"}
(63,1,1) = {"
q
M
M
M
O
x
T
T
K
T
T
T
T
T
K
T
T
s
C
e
f
f
f
f
f
f
f
f
f
S
"}
(64,1,1) = {"
q
M
M
M
O
d
a
a
R
a
a
a
a
a
R
a
a
m
B
e
f
f
f
f
f
f
f
f
f
S
"}
(65,1,1) = {"
q
q
M
M
O
x
T
T
K
T
T
T
T
T
K
T
T
s
C
e
f
f
f
f
f
f
f
f
f
S
"}
(66,1,1) = {"
q
q
M
M
O
d
a
a
R
a
a
a
a
a
R
a
a
m
B
e
f
f
f
f
f
f
f
f
f
S
"}
(67,1,1) = {"
q
q
M
M
O
x
T
T
K
T
T
T
T
T
K
T
T
s
C
e
f
f
f
f
f
f
f
f
f
S
"}
(68,1,1) = {"
q
q
M
M
O
d
a
a
R
a
a
a
a
a
R
a
a
m
B
e
f
f
f
f
f
f
f
f
f
S
"}
(69,1,1) = {"
q
q
M
M
O
x
T
T
K
T
T
T
T
T
K
T
T
s
C
e
f
f
f
f
f
f
f
f
f
S
"}
(70,1,1) = {"
q
q
q
M
O
d
a
a
R
a
a
a
a
a
R
a
a
m
B
e
f
f
f
f
f
f
f
f
f
S
"}
(71,1,1) = {"
q
q
q
M
O
x
T
T
K
T
T
T
T
T
K
T
T
s
C
e
f
f
f
f
f
f
f
f
f
S
"}
(72,1,1) = {"
q
q
q
q
O
d
a
a
R
a
a
a
a
a
R
a
a
m
B
e
f
f
f
f
f
f
f
f
f
S
"}
(73,1,1) = {"
q
q
q
q
O
x
T
T
K
T
T
T
T
T
K
T
T
s
C
e
f
f
f
f
f
f
f
f
f
S
"}
(74,1,1) = {"
q
q
q
M
O
d
a
a
R
a
a
a
a
a
R
a
a
m
B
e
f
f
f
f
f
f
f
f
f
S
"}
(75,1,1) = {"
q
q
M
M
O
x
T
T
K
T
T
T
T
T
K
T
T
s
C
e
f
f
f
f
f
f
f
f
f
S
"}
(76,1,1) = {"
q
q
M
M
O
d
a
a
R
a
a
a
a
a
R
a
a
m
B
e
f
f
f
f
f
f
f
f
f
S
"}
(77,1,1) = {"
q
q
M
M
O
x
T
T
K
T
T
T
T
T
K
T
T
s
C
e
f
f
f
f
f
f
f
f
f
S
"}
(78,1,1) = {"
q
M
M
M
O
d
a
a
R
a
a
a
a
a
R
a
a
m
B
e
f
f
f
f
f
f
f
f
f
S
"}
(79,1,1) = {"
q
M
M
M
O
x
T
T
K
T
T
T
T
T
K
T
T
s
C
e
f
f
f
f
f
f
f
f
f
S
"}
(80,1,1) = {"
q
M
M
M
O
d
a
a
R
a
a
a
a
a
R
a
a
m
B
e
f
f
f
f
f
f
f
f
f
S
"}
(81,1,1) = {"
q
M
M
M
O
x
T
T
K
T
T
T
T
T
K
T
T
s
C
e
f
f
f
f
f
f
f
f
f
S
"}
(82,1,1) = {"
q
M
M
M
O
d
a
a
R
a
a
a
a
a
R
a
a
m
B
e
f
f
f
f
f
f
f
f
f
S
"}
(83,1,1) = {"
q
M
M
M
O
x
T
T
K
T
T
T
T
T
K
T
T
s
C
e
f
f
f
f
f
f
f
f
f
S
"}
(84,1,1) = {"
q
M
M
M
O
d
a
a
R
a
a
a
a
a
R
a
a
m
B
e
f
f
f
f
f
f
f
f
f
S
"}
(85,1,1) = {"
q
M
M
M
O
x
T
T
K
T
T
T
T
T
K
T
T
s
C
e
f
f
f
f
f
f
f
f
f
S
"}
(86,1,1) = {"
q
M
M
M
O
d
a
a
R
a
a
a
a
a
R
a
a
m
B
e
f
f
f
f
f
f
f
f
f
S
"}
(87,1,1) = {"
q
M
M
M
O
x
T
T
K
T
T
T
T
T
K
T
T
s
C
e
f
f
f
f
f
f
f
f
f
S
"}
(88,1,1) = {"
q
q
M
M
O
d
a
a
R
a
a
a
a
a
R
a
a
m
B
e
f
f
f
f
f
f
f
f
f
S
"}
(89,1,1) = {"
q
q
M
M
O
x
T
T
K
T
T
T
T
T
K
T
T
s
C
e
f
f
f
f
f
f
f
f
f
S
"}
(90,1,1) = {"
q
q
M
M
O
d
a
a
R
a
a
a
a
a
R
a
a
m
B
e
f
f
f
f
f
f
f
f
f
S
"}
(91,1,1) = {"
q
q
M
M
O
x
T
T
K
T
T
T
T
T
K
T
T
s
C
e
f
f
f
f
f
f
f
f
f
S
"}
(92,1,1) = {"
q
q
M
M
O
d
a
a
R
a
a
a
a
a
R
a
a
m
B
e
f
f
f
f
f
f
f
f
f
S
"}
(93,1,1) = {"
q
q
M
M
O
x
T
T
K
T
T
T
T
T
K
T
T
s
C
e
f
f
f
f
f
f
f
f
f
S
"}
(94,1,1) = {"
q
q
M
M
O
d
a
a
R
a
a
a
a
a
R
a
a
m
B
e
f
f
f
f
f
f
f
f
f
S
"}
(95,1,1) = {"
q
q
M
M
O
x
T
T
K
T
T
T
T
T
K
T
T
s
C
e
f
f
f
f
f
f
f
f
f
S
"}
(96,1,1) = {"
q
q
q
M
O
d
a
a
R
a
a
a
a
a
R
a
a
m
B
e
f
f
f
f
f
f
f
f
f
S
"}
(97,1,1) = {"
q
q
q
M
O
x
T
T
K
T
T
T
T
T
K
T
T
s
C
e
f
f
f
f
f
f
f
f
f
S
"}
(98,1,1) = {"
q
q
q
M
O
d
a
a
R
a
a
a
a
a
R
a
a
m
B
e
f
f
f
f
f
f
f
f
f
S
"}
(99,1,1) = {"
q
q
q
M
O
x
T
T
K
T
T
T
T
T
K
T
T
s
C
e
f
f
f
f
f
f
f
f
f
S
"}
(100,1,1) = {"
q
q
q
M
O
d
a
a
R
a
a
a
a
a
R
a
a
m
B
e
f
f
f
f
f
f
f
f
f
S
"}
(101,1,1) = {"
q
q
q
M
O
x
T
T
K
T
T
T
T
T
K
T
T
s
C
e
f
f
f
f
f
f
f
f
f
S
"}
(102,1,1) = {"
q
q
q
q
O
d
a
a
R
a
a
a
a
a
R
a
a
m
B
e
f
f
f
f
f
f
f
f
f
S
"}
(103,1,1) = {"
q
q
q
q
O
x
T
T
K
T
T
T
T
T
K
T
T
s
C
e
f
f
f
f
f
f
f
f
f
S
"}
(104,1,1) = {"
q
q
q
q
O
d
a
a
R
a
a
a
a
a
R
a
a
m
B
e
f
f
f
f
f
f
f
f
f
S
"}
(105,1,1) = {"
q
q
q
q
O
x
T
T
K
T
T
T
T
T
K
T
T
s
C
e
f
f
f
f
f
f
f
f
f
S
"}
(106,1,1) = {"
q
q
q
M
O
d
a
a
R
a
a
a
a
a
R
a
a
m
B
e
f
f
f
f
f
f
f
f
f
S
"}
(107,1,1) = {"
q
q
q
M
O
x
T
T
K
T
T
T
T
T
K
T
T
s
C
e
f
f
f
f
f
f
f
f
f
S
"}
(108,1,1) = {"
q
q
q
M
O
d
a
a
R
a
a
a
a
a
R
a
a
m
B
e
f
f
f
f
f
f
f
f
f
S
"}
(109,1,1) = {"
q
q
q
M
O
x
T
T
K
T
T
T
T
T
K
T
T
s
C
e
f
f
f
f
f
f
f
f
f
S
"}
(110,1,1) = {"
q
q
q
M
O
d
a
a
R
a
a
a
a
a
R
a
a
m
B
e
f
f
f
f
f
f
f
f
f
S
"}
(111,1,1) = {"
q
q
q
M
O
x
T
T
K
T
T
T
T
T
K
T
T
s
C
e
f
f
f
f
f
f
f
f
f
S
"}
(112,1,1) = {"
q
q
q
M
O
d
a
a
R
a
a
a
a
a
R
a
a
m
B
e
f
f
f
f
f
f
f
f
f
S
"}
(113,1,1) = {"
q
q
q
M
O
x
T
T
K
T
T
T
T
T
K
T
T
s
C
e
f
f
f
f
f
f
f
f
f
S
"}
(114,1,1) = {"
q
q
q
M
O
d
a
a
R
a
a
a
a
a
R
a
a
m
B
e
f
f
f
f
f
f
f
f
f
S
"}
(115,1,1) = {"
q
q
M
M
O
x
T
T
K
T
T
T
T
T
K
T
T
s
C
e
f
f
f
f
f
f
f
f
f
S
"}
(116,1,1) = {"
q
q
M
M
O
d
a
a
R
a
a
a
a
a
R
a
a
m
B
e
f
f
f
f
f
f
f
f
f
S
"}
(117,1,1) = {"
q
q
M
M
O
x
T
T
K
T
T
T
T
T
K
T
T
s
C
e
f
f
f
f
f
f
f
f
f
S
"}
(118,1,1) = {"
q
q
M
M
O
d
a
a
R
a
a
a
a
a
R
a
a
m
B
e
f
f
f
f
f
f
f
f
f
S
"}
(119,1,1) = {"
q
q
M
M
O
x
T
T
K
T
T
T
T
T
K
T
T
s
C
e
f
f
f
f
f
f
f
f
f
S
"}
(120,1,1) = {"
q
q
M
M
O
d
a
a
R
a
a
a
a
a
R
a
a
m
B
e
f
f
f
f
f
f
f
f
f
S
"}
(121,1,1) = {"
q
M
M
M
O
x
T
T
K
T
T
T
T
T
K
T
T
s
C
e
f
f
f
f
f
f
f
f
f
S
"}
(122,1,1) = {"
q
M
M
M
O
d
a
a
R
a
a
a
a
a
R
a
a
m
B
e
f
f
f
f
f
f
f
f
f
S
"}
(123,1,1) = {"
q
M
M
M
O
x
T
T
K
T
T
T
T
T
K
T
T
s
C
e
f
f
f
f
f
f
f
f
f
S
"}
(124,1,1) = {"
q
M
M
M
O
d
a
a
R
a
a
a
a
a
R
a
a
m
B
e
f
f
f
f
f
f
f
f
f
S
"}
(125,1,1) = {"
q
M
M
M
O
x
T
T
K
T
T
T
T
T
K
T
T
s
C
e
f
f
f
f
f
f
f
f
f
S
"}
(126,1,1) = {"
q
M
M
M
O
d
a
a
R
a
a
a
a
a
R
a
a
m
B
e
f
f
f
f
f
f
f
f
f
S
"}
(127,1,1) = {"
q
M
M
M
O
x
T
T
K
T
T
T
T
T
K
T
T
s
C
e
f
f
f
f
f
f
f
f
f
S
"}
(128,1,1) = {"
q
q
M
M
O
d
a
a
R
a
a
a
a
a
R
a
a
m
B
e
f
f
f
f
f
f
f
f
f
S
"}
(129,1,1) = {"
q
q
M
M
O
x
T
T
K
T
T
T
T
T
K
T
T
s
C
e
f
f
f
f
f
f
f
f
f
S
"}
(130,1,1) = {"
q
q
q
M
O
d
a
a
R
a
a
a
a
a
R
a
a
m
B
e
f
f
f
f
f
f
f
f
f
S
"}
(131,1,1) = {"
q
q
q
M
O
x
T
T
K
T
T
T
T
T
K
T
T
s
C
e
f
f
f
f
f
f
f
f
f
S
"}
(132,1,1) = {"
q
q
q
q
O
d
a
a
R
a
a
a
a
a
R
a
a
m
B
e
f
f
f
f
f
f
f
f
f
S
"}
(133,1,1) = {"
q
q
q
q
O
x
T
T
K
T
T
T
T
T
K
T
T
s
C
e
f
f
f
f
f
f
f
f
f
S
"}
(134,1,1) = {"
q
q
q
q
O
d
a
a
R
a
a
a
a
a
R
a
a
m
B
e
f
f
f
f
f
f
f
f
f
S
"}
(135,1,1) = {"
q
q
q
q
O
x
T
T
K
T
T
T
T
T
K
T
T
s
C
e
f
f
f
f
f
f
f
f
f
S
"}
(136,1,1) = {"
q
q
q
M
O
d
a
a
R
a
a
a
a
a
R
a
a
m
B
e
f
f
f
f
f
f
f
f
f
S
"}
(137,1,1) = {"
q
q
q
M
O
x
T
T
K
T
T
T
T
T
K
T
T
s
C
e
f
f
f
f
f
f
f
f
f
S
"}
(138,1,1) = {"
q
q
q
M
O
d
a
a
R
a
a
a
a
a
R
a
a
m
B
e
f
f
f
f
f
f
f
f
f
S
"}
(139,1,1) = {"
q
q
q
M
O
x
T
T
K
T
T
T
T
T
K
T
T
s
C
e
f
f
f
f
f
f
f
f
f
S
"}
(140,1,1) = {"
q
q
q
M
O
d
a
a
R
a
a
a
a
a
R
a
a
m
B
e
f
f
f
f
f
f
f
f
f
S
"}
(141,1,1) = {"
q
q
M
M
O
x
T
T
K
T
T
T
T
T
K
T
T
s
C
e
f
f
f
f
f
f
f
f
f
S
"}
(142,1,1) = {"
q
q
M
M
O
d
a
a
R
a
a
a
a
a
R
a
a
m
B
e
f
f
f
f
f
f
f
f
f
S
"}
(143,1,1) = {"
q
M
M
M
O
x
T
T
K
T
T
T
T
T
K
T
T
s
C
e
f
f
f
f
f
f
f
f
f
S
"}
(144,1,1) = {"
q
M
M
M
O
d
a
a
R
a
a
a
a
a
R
a
a
m
B
e
f
f
f
f
f
f
f
f
f
S
"}
(145,1,1) = {"
q
M
M
M
O
x
T
T
K
T
T
T
T
T
K
T
T
s
C
e
f
f
f
f
f
f
f
f
f
S
"}
(146,1,1) = {"
q
M
M
M
O
d
a
a
R
a
a
a
a
a
R
a
a
m
B
e
f
f
f
f
f
f
f
f
f
S
"}
(147,1,1) = {"
q
M
M
M
O
x
T
T
K
T
T
T
T
T
K
T
T
s
C
e
f
f
f
f
f
f
f
f
f
S
"}
(148,1,1) = {"
q
M
M
M
O
d
a
a
R
a
a
a
a
a
R
a
a
m
B
e
f
f
f
f
f
f
f
f
f
S
"}
(149,1,1) = {"
q
M
M
M
O
x
T
T
K
T
T
T
T
T
K
T
T
s
C
e
f
f
f
f
f
f
f
f
f
S
"}
(150,1,1) = {"
q
M
M
M
O
d
a
a
R
a
a
a
a
a
R
a
a
m
B
e
f
f
f
f
f
f
f
f
f
S
"}
(151,1,1) = {"
q
M
M
M
O
x
T
T
K
T
T
T
T
T
K
T
T
s
C
e
f
f
f
f
f
f
f
f
f
S
"}
(152,1,1) = {"
q
M
M
M
O
d
a
a
R
a
a
a
a
a
R
a
a
m
B
e
f
f
f
f
f
f
f
f
f
S
"}
(153,1,1) = {"
q
M
M
M
O
x
T
T
K
T
T
T
T
T
K
T
T
s
C
e
f
f
f
f
f
f
f
f
f
S
"}
(154,1,1) = {"
q
q
M
M
O
d
a
a
R
a
a
a
a
a
R
a
a
m
B
y
y
Y
Y
Y
Y
Y
y
u
y
y
"}
(155,1,1) = {"
q
q
M
M
O
x
T
T
K
T
T
T
T
T
K
T
T
s
C
Y
f
f
f
f
f
f
f
f
f
y
"}
(156,1,1) = {"
q
q
M
M
O
d
a
a
R
a
a
a
a
a
R
a
a
m
B
Y
f
f
f
f
f
f
f
f
f
y
"}
(157,1,1) = {"
q
q
M
M
O
x
T
T
K
T
T
T
T
T
K
T
T
s
C
y
f
f
f
f
f
f
f
f
f
y
"}
(158,1,1) = {"
q
q
M
M
O
d
a
a
R
a
a
a
a
a
R
a
a
m
B
y
y
u
y
Y
Y
y
Y
Y
y
y
"}
(159,1,1) = {"
q
q
M
M
O
x
T
T
K
T
T
T
T
T
K
T
T
s
C
M
M
M
M
M
M
M
M
M
M
M
"}
(160,1,1) = {"
q
q
M
M
O
d
a
a
R
a
a
a
a
a
R
a
a
m
B
M
M
M
M
M
M
M
M
M
M
M
"}
(161,1,1) = {"
q
q
q
M
O
x
T
T
K
T
T
T
T
T
K
T
T
s
C
M
M
M
M
M
M
M
M
M
M
M
"}
(162,1,1) = {"
q
q
q
M
O
d
a
a
R
a
a
a
a
a
R
a
a
m
B
M
M
M
M
M
M
M
M
M
M
M
"}
(163,1,1) = {"
q
q
q
M
O
x
T
T
K
T
T
T
T
T
K
T
T
s
C
M
M
M
M
M
M
M
M
M
M
M
"}
(164,1,1) = {"
q
q
q
M
O
d
a
a
R
a
a
a
a
a
R
a
a
m
B
M
M
M
M
M
M
M
M
M
M
M
"}
(165,1,1) = {"
q
q
q
M
O
x
T
T
K
T
T
T
T
T
K
T
T
s
C
M
M
M
M
M
M
M
M
M
M
M
"}
(166,1,1) = {"
q
q
q
M
O
d
a
a
R
a
a
a
a
a
R
a
a
m
B
M
M
M
M
M
M
M
M
M
M
M
"}
(167,1,1) = {"
q
q
q
M
O
x
T
T
K
T
T
T
T
T
K
T
T
s
C
M
M
M
M
M
M
M
M
M
M
M
"}
(168,1,1) = {"
q
q
q
M
O
d
a
a
R
a
a
a
a
a
R
a
a
m
B
M
M
M
M
M
M
M
M
M
M
M
"}
(169,1,1) = {"
q
q
q
M
O
x
T
T
K
T
T
T
T
T
K
T
T
s
C
M
M
M
M
M
M
M
M
M
M
M
"}
(170,1,1) = {"
q
q
q
M
O
d
a
a
R
a
a
a
a
a
R
a
a
m
B
M
M
M
M
M
M
M
M
M
M
M
"}
(171,1,1) = {"
q
q
q
M
O
x
T
T
K
T
T
T
T
T
K
T
T
s
C
M
M
M
M
M
M
M
M
M
M
M
"}
(172,1,1) = {"
q
q
q
M
O
d
a
a
R
a
a
a
a
a
R
a
a
m
B
M
M
M
M
M
M
M
M
M
M
M
"}
(173,1,1) = {"
q
q
q
M
O
x
T
T
K
T
T
T
T
T
K
T
T
s
C
M
M
M
M
M
M
M
M
M
M
M
"}
(174,1,1) = {"
q
q
q
M
O
d
a
a
R
a
a
a
a
a
R
a
a
m
B
M
M
M
M
M
M
M
M
M
M
M
"}
(175,1,1) = {"
q
q
q
M
O
x
T
T
K
T
T
T
T
T
K
T
T
s
C
M
M
M
M
M
M
M
M
M
M
M
"}
(176,1,1) = {"
q
q
q
M
O
d
a
a
R
a
a
a
a
a
R
a
a
m
B
M
M
M
M
M
M
M
M
M
M
M
"}
(177,1,1) = {"
q
q
q
M
O
x
T
T
K
T
T
T
T
T
K
T
T
s
C
M
M
M
M
M
M
M
M
M
M
M
"}
(178,1,1) = {"
q
q
q
M
O
d
a
a
R
a
a
a
a
a
R
a
a
m
B
M
M
M
M
M
M
M
M
M
M
M
"}
(179,1,1) = {"
q
q
q
M
O
x
T
T
K
T
T
T
T
T
K
T
T
s
C
M
M
M
M
M
M
M
M
M
M
M
"}
(180,1,1) = {"
q
q
q
M
O
d
a
a
R
a
a
a
a
a
R
a
a
m
B
M
M
M
M
M
M
M
M
M
M
M
"}
(181,1,1) = {"
q
q
q
M
O
x
T
T
K
T
T
T
T
T
K
T
T
s
C
M
M
M
M
M
M
M
M
M
M
M
"}
(182,1,1) = {"
q
q
q
M
O
d
a
a
R
a
a
a
a
a
R
a
a
m
B
M
M
M
M
M
M
M
M
M
M
M
"}
(183,1,1) = {"
q
q
q
M
O
x
T
T
K
T
T
T
T
T
K
T
T
s
C
M
M
M
M
M
M
M
M
M
M
M
"}
(184,1,1) = {"
q
q
q
M
O
d
a
a
R
a
a
a
a
a
R
a
a
m
B
M
M
M
M
M
M
M
M
M
M
M
"}
(185,1,1) = {"
q
q
q
M
O
x
T
T
K
T
T
T
T
T
K
T
T
s
C
M
M
M
M
M
M
M
M
M
M
M
"}
(186,1,1) = {"
q
q
q
M
O
d
a
a
R
a
a
a
a
a
R
a
a
m
B
M
M
M
M
M
M
M
M
M
M
M
"}
(187,1,1) = {"
q
q
q
M
O
x
T
T
K
T
T
T
T
T
K
T
T
s
C
M
M
M
M
M
M
M
M
M
M
M
"}
(188,1,1) = {"
q
q
M
M
O
d
a
a
R
a
a
a
a
a
R
a
a
m
B
M
M
M
M
M
M
M
M
M
M
M
"}
(189,1,1) = {"
q
q
M
M
O
x
T
T
K
T
T
T
T
T
K
T
T
s
C
M
M
M
M
M
M
M
M
M
M
M
"}
(190,1,1) = {"
q
q
M
M
O
d
a
a
R
a
a
a
a
a
R
a
a
m
B
M
M
M
M
M
M
M
M
M
M
M
"}
(191,1,1) = {"
q
M
M
M
O
x
T
T
K
T
T
T
T
T
K
T
T
s
C
M
M
M
M
M
M
M
M
M
M
M
"}
(192,1,1) = {"
q
M
M
M
O
d
a
a
R
a
a
a
a
a
R
a
a
m
B
M
M
M
M
M
M
M
M
M
M
M
"}
(193,1,1) = {"
q
M
M
M
O
x
T
T
K
T
T
T
T
T
K
T
T
s
C
M
M
M
M
M
M
M
M
M
M
M
"}
(194,1,1) = {"
q
M
M
M
O
d
a
a
R
a
a
a
a
a
R
a
a
m
B
M
M
M
M
M
M
M
M
M
M
M
"}
(195,1,1) = {"
q
M
M
M
O
x
T
T
K
T
T
T
T
T
K
T
T
s
C
M
M
M
M
M
M
M
M
M
M
M
"}
(196,1,1) = {"
q
M
M
M
O
d
a
a
R
a
a
a
a
a
R
a
a
m
B
M
M
M
M
M
M
M
M
M
M
M
"}
(197,1,1) = {"
q
M
M
M
O
x
T
T
K
T
T
T
T
T
K
T
T
s
C
M
M
M
M
M
M
M
M
M
M
M
"}
(198,1,1) = {"
q
M
M
M
O
d
a
a
R
a
a
a
a
a
R
a
a
m
B
M
M
M
M
M
M
M
M
M
M
M
"}
(199,1,1) = {"
q
M
M
M
O
x
T
T
K
T
T
T
T
T
K
T
T
s
C
M
M
M
M
M
M
M
M
M
M
M
"}
(200,1,1) = {"
q
M
M
M
O
d
a
a
R
a
a
a
a
a
R
a
a
m
B
M
M
M
M
M
M
M
M
M
M
M
"}
(201,1,1) = {"
q
M
M
M
O
x
T
T
K
T
T
T
T
T
K
T
T
s
C
M
M
M
M
M
M
M
M
M
M
M
"}
(202,1,1) = {"
q
M
M
M
O
d
a
a
R
a
a
a
a
a
R
a
a
m
B
M
M
M
M
M
M
M
M
M
M
M
"}
(203,1,1) = {"
q
M
M
M
O
x
T
T
K
T
T
T
T
T
K
T
T
s
C
M
M
M
M
M
M
M
M
M
M
M
"}
(204,1,1) = {"
q
M
M
M
O
d
a
a
R
a
a
a
a
a
R
a
a
m
B
M
M
M
M
M
M
M
M
M
M
M
"}
(205,1,1) = {"
q
M
M
M
O
x
T
T
K
T
T
T
T
T
K
T
T
s
C
M
M
M
M
M
M
M
M
M
M
M
"}
(206,1,1) = {"
q
M
M
M
O
d
a
a
R
a
a
a
a
a
R
a
a
m
B
M
M
M
M
M
M
M
M
M
M
M
"}
(207,1,1) = {"
q
M
M
M
O
x
T
T
K
T
T
T
T
T
K
T
T
s
C
M
M
M
M
M
M
M
M
M
M
M
"}
(208,1,1) = {"
q
M
M
M
O
d
a
a
R
a
a
a
a
a
R
a
a
m
B
M
M
M
M
M
M
M
M
M
M
M
"}
(209,1,1) = {"
q
q
M
M
O
x
T
T
K
T
T
T
T
T
K
T
T
s
C
M
M
M
M
M
M
M
M
M
M
M
"}
(210,1,1) = {"
q
q
M
M
O
d
a
a
R
a
a
a
a
a
R
a
a
m
B
M
M
M
M
M
M
M
M
M
M
M
"}
(211,1,1) = {"
q
q
M
M
O
x
T
T
K
T
T
T
T
T
K
T
T
s
C
M
M
M
M
M
M
M
M
M
M
M
"}
(212,1,1) = {"
q
q
M
M
O
d
a
a
R
a
a
a
a
a
R
a
a
m
B
M
M
M
M
M
M
M
M
M
M
M
"}
(213,1,1) = {"
q
q
M
M
O
x
T
T
K
T
T
T
T
T
K
T
T
s
C
M
M
M
M
M
M
M
M
M
M
M
"}
(214,1,1) = {"
q
q
M
M
O
d
a
a
R
a
a
a
a
a
R
a
a
m
B
M
M
M
M
M
M
M
M
M
M
M
"}
(215,1,1) = {"
q
q
M
M
O
x
T
T
K
T
T
T
T
T
K
T
T
s
C
M
M
M
M
M
M
M
M
M
M
M
"}
(216,1,1) = {"
q
q
q
M
O
d
a
a
R
a
a
a
a
a
R
a
a
m
B
M
M
M
M
M
M
M
M
M
M
M
"}
(217,1,1) = {"
q
q
q
M
O
x
T
T
K
T
T
T
T
T
K
T
T
s
C
M
M
M
M
M
M
M
M
M
M
M
"}
(218,1,1) = {"
q
q
q
M
O
d
a
a
R
a
a
a
a
a
R
a
a
m
B
M
M
M
M
M
M
M
M
M
M
M
"}
(219,1,1) = {"
q
q
q
M
O
x
T
T
K
T
T
T
T
T
K
T
T
s
C
M
M
M
M
M
M
M
M
M
M
M
"}
(220,1,1) = {"
q
q
q
M
O
d
a
a
R
a
a
a
a
a
R
a
a
m
B
M
M
M
M
M
M
M
M
M
M
M
"}
(221,1,1) = {"
q
q
q
M
O
x
T
T
K
T
T
T
T
T
K
T
T
s
C
M
M
M
M
M
M
M
M
M
M
M
"}
(222,1,1) = {"
q
q
q
M
O
d
a
a
R
a
a
a
a
a
R
a
a
m
B
M
M
M
M
M
M
M
M
M
M
M
"}
(223,1,1) = {"
q
q
q
q
O
x
T
T
K
T
T
T
T
T
K
T
T
s
C
M
M
M
M
M
M
M
M
M
M
M
"}
(224,1,1) = {"
q
q
q
q
O
d
a
a
R
a
a
a
a
a
R
a
a
m
B
M
M
M
M
M
M
M
M
M
M
M
"}
(225,1,1) = {"
q
q
q
q
O
x
T
T
K
T
T
T
T
T
K
T
T
s
C
M
M
M
M
M
M
M
M
M
M
M
"}
(226,1,1) = {"
q
q
q
q
O
d
a
a
R
a
a
a
a
a
R
a
a
m
B
M
M
M
M
M
M
M
M
M
M
M
"}
(227,1,1) = {"
q
q
q
q
O
x
T
T
K
T
T
T
T
T
K
T
T
s
C
M
M
M
M
M
M
M
M
M
M
M
"}
(228,1,1) = {"
q
q
q
q
O
d
a
a
R
a
a
a
a
a
R
a
a
m
B
M
M
M
M
M
M
M
M
M
M
M
"}
(229,1,1) = {"
q
q
q
q
O
x
T
T
K
T
T
T
T
T
K
T
T
s
C
M
M
M
M
M
M
M
M
M
M
M
"}
(230,1,1) = {"
q
q
q
q
O
d
a
a
R
a
a
a
a
a
R
a
a
m
B
M
M
M
M
M
M
M
M
M
M
M
"}
(231,1,1) = {"
q
q
q
M
O
x
T
T
K
T
T
T
T
T
K
T
T
s
C
M
M
M
M
M
M
M
M
M
M
M
"}
(232,1,1) = {"
q
q
q
M
O
d
a
a
R
a
a
a
a
a
R
a
a
m
B
M
M
M
M
M
M
M
M
M
M
M
"}
(233,1,1) = {"
q
q
q
M
O
x
T
T
K
T
T
T
T
T
K
T
T
s
C
M
M
M
M
M
M
M
M
M
M
M
"}
(234,1,1) = {"
q
q
q
M
O
d
a
a
R
a
a
a
a
a
R
a
a
m
B
M
M
M
M
M
M
M
M
M
M
M
"}
(235,1,1) = {"
q
q
q
M
O
x
T
T
K
T
T
T
T
T
K
T
T
s
C
M
M
M
M
M
M
M
M
M
M
M
"}
(236,1,1) = {"
q
q
q
M
O
d
a
a
R
a
a
a
a
a
R
a
a
m
B
M
M
M
M
M
M
M
M
M
M
M
"}
(237,1,1) = {"
q
q
q
M
O
x
T
T
K
T
T
T
T
T
K
T
T
s
C
M
M
M
M
M
M
M
M
M
M
M
"}
(238,1,1) = {"
q
q
q
M
O
d
a
a
R
a
a
a
a
a
R
a
a
m
B
M
M
M
M
M
M
M
M
M
M
M
"}
(239,1,1) = {"
q
q
q
M
O
x
T
T
K
T
T
T
T
T
K
T
T
s
C
M
M
M
M
M
M
M
M
M
M
M
"}
(240,1,1) = {"
q
q
q
M
O
d
a
a
R
a
a
a
a
a
R
a
a
m
B
M
M
M
M
M
M
M
M
M
M
M
"}
(241,1,1) = {"
q
q
q
M
O
x
T
T
K
T
T
T
T
T
K
T
T
s
C
M
M
M
M
M
M
M
M
M
M
M
"}
(242,1,1) = {"
q
q
q
M
O
d
a
a
R
a
a
a
a
a
R
a
a
m
B
M
M
M
M
M
M
M
M
M
M
M
"}
(243,1,1) = {"
q
q
M
M
O
x
T
T
K
T
T
T
T
T
K
T
T
s
C
M
M
M
M
M
M
M
M
M
M
M
"}
(244,1,1) = {"
q
q
M
M
O
d
a
a
R
a
a
a
a
a
R
a
a
m
B
M
M
M
M
M
M
M
M
M
M
M
"}
(245,1,1) = {"
q
q
M
M
O
x
T
T
K
T
T
T
T
T
K
T
T
s
C
M
M
M
M
M
M
M
M
M
M
M
"}
(246,1,1) = {"
q
q
M
M
O
d
a
a
R
a
a
a
a
a
R
a
a
m
B
M
M
M
M
M
M
M
M
M
M
M
"}
(247,1,1) = {"
q
q
M
M
O
x
T
T
K
T
T
T
T
T
K
T
T
s
C
M
M
M
M
M
M
M
M
M
M
M
"}
(248,1,1) = {"
q
q
M
M
O
d
a
a
R
a
a
a
a
a
R
a
a
m
B
M
M
M
M
M
M
M
M
M
M
M
"}
(249,1,1) = {"
q
q
M
M
O
x
T
T
K
T
T
T
T
T
K
T
T
s
C
M
M
M
M
M
M
M
M
M
M
M
"}
(250,1,1) = {"
q
q
M
M
O
d
a
a
R
a
a
a
a
a
R
a
a
m
B
M
M
M
M
M
M
M
M
M
M
M
"}
(251,1,1) = {"
q
q
M
M
O
x
T
T
K
T
T
T
T
T
K
T
T
s
C
M
M
M
M
M
M
M
M
M
M
M
"}
(252,1,1) = {"
q
q
M
M
O
d
a
a
R
a
a
a
a
a
R
a
a
m
B
M
M
M
M
M
M
M
M
M
M
M
"}
(253,1,1) = {"
q
q
M
M
O
x
T
T
K
T
T
T
T
T
K
T
T
s
C
M
M
M
M
M
M
M
M
M
M
M
"}
(254,1,1) = {"
q
q
q
M
O
d
a
a
R
a
a
a
a
a
R
a
a
m
B
M
M
M
M
M
M
M
M
M
M
M
"}
(255,1,1) = {"
q
q
q
M
O
x
T
T
K
T
T
T
T
T
K
T
T
s
C
M
M
M
M
M
M
M
M
M
M
M
"}
