//MAP CONVERTED BY dmm2tgm.py THIS HEADER COMMENT PREVENTS RECONVERSION, DO NOT REMOVE
"a" = (
/obj/structure/closet/emcloset/anchored,
/obj/effect/turf_decal/bot_blue,
/turf/open/floor/pod/dark,
/area/shuttle/arrival)
"c" = (
/obj/machinery/light/cold/directional/north,
/obj/structure/chair/sofa/bench/left,
/obj/effect/turf_decal/siding/wideplating_new{
	dir = 4
	},
/obj/effect/turf_decal/siding/wideplating_new{
	dir = 8
	},
/turf/open/floor/mineral/plastitanium/red,
/area/shuttle/arrival)
"e" = (
/obj/structure/chair/sofa/bench/left{
	dir = 1
	},
/obj/effect/turf_decal/siding/wideplating_new{
	dir = 8
	},
/obj/effect/turf_decal/siding/wideplating_new{
	dir = 4
	},
/turf/open/floor/mineral/titanium/tiled/blue,
/area/shuttle/arrival)
"f" = (
/obj/structure/chair/sofa/bench/right,
/turf/open/floor/pod,
/area/shuttle/arrival)
"g" = (
/obj/effect/turf_decal/siding/wideplating_new{
	dir = 4
	},
/obj/effect/turf_decal/siding/wideplating_new{
	dir = 8
	},
/turf/open/floor/mineral/plastitanium/red,
/area/shuttle/arrival)
"i" = (
/obj/structure/chair/sofa/bench,
/turf/open/floor/pod,
/area/shuttle/arrival)
"j" = (
/obj/effect/turf_decal/arrows/red,
/turf/open/floor/pod/light,
/area/shuttle/arrival)
"l" = (
/turf/closed/wall/mineral/titanium/survival,
/area/shuttle/arrival)
"n" = (
/turf/open/floor/pod,
/area/shuttle/arrival)
"o" = (
/obj/structure/chair/sofa/bench/right{
	dir = 1
	},
/obj/effect/turf_decal/siding/wideplating_new{
	dir = 4
	},
/obj/effect/turf_decal/siding/wideplating_new{
	dir = 8
	},
/turf/open/floor/mineral/plastitanium/red,
/area/shuttle/arrival)
"r" = (
/turf/template_noop,
/area/template_noop)
"s" = (
/turf/open/floor/pod/dark,
/area/shuttle/arrival)
"t" = (
/obj/machinery/light/cold/directional/north,
/obj/structure/chair/sofa/bench/right,
/obj/effect/turf_decal/siding/wideplating_new{
	dir = 8
	},
/obj/effect/turf_decal/siding/wideplating_new{
	dir = 4
	},
/turf/open/floor/mineral/titanium/tiled/blue,
/area/shuttle/arrival)
"u" = (
/obj/effect/turf_decal/siding/wideplating_new,
/turf/open/floor/mineral/plastitanium,
/area/shuttle/arrival)
"v" = (
/obj/structure/chair/sofa/bench{
	dir = 1
	},
/turf/open/floor/pod,
/area/shuttle/arrival)
"w" = (
/obj/effect/turf_decal/siding/wideplating_new{
	dir = 8
	},
/obj/effect/turf_decal/siding/wideplating_new{
	dir = 4
	},
/turf/open/floor/mineral/titanium/tiled/blue,
/area/shuttle/arrival)
"z" = (
/obj/structure/window/reinforced/survival_pod/spawner/directional/east,
/obj/machinery/power/shuttle_engine/heater{
	dir = 8
	},
/turf/open/floor/plating,
/area/shuttle/arrival)
"B" = (
/obj/effect/turf_decal/box/white,
/turf/open/floor/pod,
/area/shuttle/arrival)
"C" = (
/obj/effect/turf_decal/siding/wideplating_new,
/obj/effect/turf_decal/siding/wideplating_new{
	dir = 1
	},
/obj/machinery/door/airlock/survival_pod,
/turf/open/floor/iron/smooth_large,
/area/shuttle/arrival)
"E" = (
/obj/effect/spawner/structure/window/survival_pod,
/turf/open/floor/plating,
/area/shuttle/arrival)
"F" = (
/obj/machinery/power/shuttle_engine/propulsion{
	dir = 4
	},
/obj/docking_port/mobile/arrivals{
	name = "sigma octantis arrivals shuttle"
	},
/obj/effect/turf_decal/stripes/line{
	dir = 4
	},
/obj/effect/turf_decal/stripes/red/line{
	dir = 4
	},
/turf/open/floor/plating,
/area/shuttle/arrival)
"G" = (
/turf/closed/wall/mineral/titanium/survival/nodiagonal,
/area/shuttle/arrival)
"H" = (
/obj/effect/turf_decal/arrows/blue,
/turf/open/floor/pod/light,
/area/shuttle/arrival)
"I" = (
/obj/structure/railing/corner/end,
/obj/effect/turf_decal/siding/wideplating_new,
/turf/open/floor/mineral/plastitanium,
/area/shuttle/arrival)
"L" = (
/obj/structure/chair/sofa/bench/left{
	dir = 1
	},
/obj/structure/railing{
	dir = 8
	},
/turf/open/floor/pod,
/area/shuttle/arrival)
"M" = (
/obj/structure/closet/firecloset,
/obj/effect/turf_decal/bot_red,
/turf/open/floor/pod/dark,
/area/shuttle/arrival)
"O" = (
/obj/structure/chair/sofa/bench/left,
/obj/structure/railing{
	dir = 4
	},
/turf/open/floor/pod,
/area/shuttle/arrival)
"S" = (
/obj/machinery/power/shuttle_engine/propulsion{
	dir = 4
	},
/obj/effect/turf_decal/stripes/line{
	dir = 4
	},
/obj/effect/turf_decal/stripes/red/line{
	dir = 4
	},
/turf/open/floor/plating,
/area/shuttle/arrival)
"T" = (
/obj/structure/railing/corner/end{
	dir = 1
	},
/obj/effect/turf_decal/siding/wideplating_new{
	dir = 1
	},
/turf/open/floor/mineral/plastitanium,
/area/shuttle/arrival)
"W" = (
/obj/structure/window/reinforced/survival_pod/spawner/directional/west,
/obj/machinery/power/shuttle_engine/heater{
	dir = 4
	},
/turf/open/floor/plating,
/area/shuttle/arrival)
"X" = (
/obj/effect/turf_decal/siding/wideplating_new{
	dir = 1
	},
/turf/open/floor/mineral/plastitanium,
/area/shuttle/arrival)
"Y" = (
/obj/structure/chair/sofa/bench/right{
	dir = 1
	},
/turf/open/floor/pod,
/area/shuttle/arrival)
"Z" = (
/obj/machinery/power/shuttle_engine/propulsion{
	dir = 8
	},
/obj/effect/turf_decal/stripes/line{
	dir = 8
	},
/obj/effect/turf_decal/stripes/red/line{
	dir = 8
	},
/turf/open/floor/plating,
/area/shuttle/arrival)

(1,1,1) = {"
r
l
Z
Z
l
r
"}
(2,1,1) = {"
l
G
z
z
G
l
"}
(3,1,1) = {"
G
a
s
n
H
C
"}
(4,1,1) = {"
G
t
w
w
e
G
"}
(5,1,1) = {"
E
i
X
u
Y
E
"}
(6,1,1) = {"
E
O
T
u
B
E
"}
(7,1,1) = {"
E
B
X
I
L
E
"}
(8,1,1) = {"
E
f
X
u
v
E
"}
(9,1,1) = {"
G
c
g
g
o
G
"}
(10,1,1) = {"
G
M
s
n
j
C
"}
(11,1,1) = {"
l
G
W
W
G
l
"}
(12,1,1) = {"
r
l
S
F
l
r
"}
