//MAP CONVERTED BY dmm2tgm.py THIS HEADER COMMENT PREVENTS RECONVERSION, DO NOT REMOVE
"a" = (
/turf/open/floor/wood/large,
/area/shuttle/arrival)
"b" = (
/obj/structure/table,
/obj/effect/spawner/random/food_or_drink/island_booze{
	pixel_x = 7;
	pixel_y = 7
	},
/obj/effect/spawner/random/food_or_drink/island_booze{
	pixel_y = 2;
	pixel_x = -6
	},
/obj/effect/spawner/random/clothing/island_time{
	pixel_y = 3
	},
/turf/open/floor/iron/terracotta/small,
/area/shuttle/arrival)
"c" = (
/obj/structure/window/reinforced/spawner/directional/east{
	layer = 2.9
	},
/obj/structure/table,
/obj/effect/spawner/random/food_or_drink/island_booze{
	pixel_x = 2;
	pixel_y = 5
	},
/obj/item/book/granter/magazine/biodome{
	pixel_x = -7
	},
/obj/docking_port/mobile/arrivals,
/turf/open/floor/glass/reinforced,
/area/shuttle/arrival)
"e" = (
/obj/machinery/power/shuttle_engine/heater{
	dir = 4
	},
/obj/structure/window/reinforced/spawner/directional/west,
/turf/open/floor/plating/airless,
/area/shuttle/arrival)
"f" = (
/obj/structure/table,
/obj/effect/spawner/random/food_or_drink/island_booze,
/obj/effect/spawner/random/food_or_drink/island_booze{
	pixel_x = 6;
	pixel_y = 4
	},
/obj/effect/spawner/random/clothing/island_time{
	pixel_x = -6;
	pixel_y = 7
	},
/turf/open/floor/iron/terracotta/small,
/area/shuttle/arrival)
"g" = (
/obj/structure/chair/comfy/shuttle{
	dir = 8
	},
/obj/machinery/light/directional/north,
/turf/open/floor/wood/large,
/area/shuttle/arrival)
"h" = (
/obj/item/radio/intercom/directional/south,
/obj/effect/turf_decal/siding/wood{
	dir = 4
	},
/obj/machinery/light/directional/south,
/turf/open/floor/iron/terracotta/small,
/area/shuttle/arrival)
"i" = (
/obj/structure/window/reinforced/spawner/directional/north{
	pixel_y = 2
	},
/obj/structure/fluff/beach_umbrella/science,
/obj/machinery/light/directional/west,
/turf/open/floor/glass/reinforced,
/area/shuttle/arrival)
"j" = (
/obj/item/book/granter/magazine/biodome{
	pixel_y = 8;
	pixel_x = 4
	},
/turf/open/floor/iron/terracotta/small,
/area/shuttle/arrival)
"k" = (
/obj/structure/window/reinforced/spawner/directional/east{
	layer = 2.9
	},
/obj/structure/window/reinforced/spawner/directional/south{
	pixel_y = 2
	},
/obj/structure/chair/comfy/shuttle{
	dir = 4
	},
/turf/open/floor/glass/reinforced,
/area/shuttle/arrival)
"l" = (
/obj/structure/table,
/obj/effect/spawner/random/food_or_drink/island_booze{
	pixel_x = 5;
	pixel_y = 5
	},
/obj/item/book/granter/magazine/biodome{
	pixel_x = -6
	},
/turf/open/floor/wood/large,
/area/shuttle/arrival)
"m" = (
/obj/machinery/requests_console/directional/north{
	department = "Arrival shuttle"
	},
/obj/effect/turf_decal/siding/wood{
	dir = 4
	},
/obj/machinery/light/directional/north,
/turf/open/floor/iron/terracotta/small,
/area/shuttle/arrival)
"n" = (
/obj/effect/spawner/structure/window/reinforced/shuttle,
/turf/open/floor/wood/large,
/area/shuttle/arrival)
"o" = (
/obj/structure/fluff/beach_umbrella,
/obj/effect/turf_decal/siding/wood{
	dir = 8
	},
/turf/open/floor/iron/terracotta/small,
/area/shuttle/arrival)
"p" = (
/obj/effect/turf_decal/siding/wood,
/turf/open/water/beach,
/area/shuttle/arrival)
"q" = (
/turf/template_noop,
/area/template_noop)
"r" = (
/turf/open/floor/iron/terracotta/small,
/area/shuttle/arrival)
"s" = (
/obj/effect/spawner/random/clothing/island_time{
	pixel_y = -4;
	pixel_x = -3
	},
/turf/open/floor/iron/terracotta/small,
/area/shuttle/arrival)
"t" = (
/obj/structure/fluff/beach_umbrella/cap,
/turf/open/floor/iron/terracotta/small,
/area/shuttle/arrival)
"v" = (
/obj/effect/turf_decal/siding/wood{
	dir = 4
	},
/turf/open/floor/iron/terracotta/small,
/area/shuttle/arrival)
"w" = (
/obj/machinery/door/airlock/titanium{
	name = "Arrivals Shuttle Airlock"
	},
/turf/open/floor/plating,
/area/shuttle/arrival)
"x" = (
/obj/effect/turf_decal/siding/wood{
	dir = 9
	},
/turf/open/water/beach,
/area/shuttle/arrival)
"y" = (
/obj/structure/chair/comfy/shuttle{
	dir = 8
	},
/obj/effect/turf_decal/siding/wood{
	dir = 4
	},
/turf/open/floor/wood/large,
/area/shuttle/arrival)
"z" = (
/obj/effect/turf_decal/siding/wood{
	dir = 4
	},
/turf/open/floor/wood/large,
/area/shuttle/arrival)
"A" = (
/obj/structure/chair/comfy/shuttle{
	dir = 8
	},
/turf/open/floor/wood/large,
/area/shuttle/arrival)
"B" = (
/obj/effect/spawner/random/food_or_drink/island_booze{
	pixel_x = 7
	},
/turf/open/floor/iron/terracotta/small,
/area/shuttle/arrival)
"C" = (
/obj/effect/turf_decal/siding/wood{
	dir = 8
	},
/obj/machinery/light/directional/north,
/turf/open/floor/iron/terracotta/small,
/area/shuttle/arrival)
"D" = (
/obj/structure/closet/wardrobe/mixed,
/turf/open/floor/wood/large,
/area/shuttle/arrival)
"E" = (
/obj/effect/turf_decal/siding/wood{
	dir = 6
	},
/turf/open/water/beach,
/area/shuttle/arrival)
"F" = (
/obj/effect/turf_decal/siding/wood{
	dir = 8
	},
/obj/machinery/light/directional/south,
/turf/open/floor/iron/terracotta/small,
/area/shuttle/arrival)
"G" = (
/obj/structure/window/reinforced/spawner/directional/south{
	pixel_y = 2
	},
/obj/structure/fluff/beach_umbrella/engine,
/obj/machinery/light/directional/west,
/turf/open/floor/glass/reinforced,
/area/shuttle/arrival)
"H" = (
/obj/structure/window/reinforced/spawner/directional/east{
	layer = 2.9
	},
/obj/structure/window/reinforced/spawner/directional/north{
	pixel_y = 2
	},
/obj/structure/chair/comfy/shuttle{
	dir = 4
	},
/turf/open/floor/glass/reinforced,
/area/shuttle/arrival)
"I" = (
/obj/effect/turf_decal/siding/wood{
	dir = 10
	},
/turf/open/water/beach,
/area/shuttle/arrival)
"J" = (
/obj/machinery/door/airlock/titanium{
	name = "Arrivals Shuttle Back Deck"
	},
/turf/open/floor/wood/large,
/area/shuttle/arrival)
"K" = (
/obj/effect/turf_decal/siding/wood{
	dir = 8
	},
/turf/open/floor/iron/terracotta/small,
/area/shuttle/arrival)
"L" = (
/turf/open/floor/wood/stairs/left,
/area/shuttle/arrival)
"M" = (
/obj/effect/turf_decal/siding/wood,
/obj/item/toy/beach_ball,
/turf/open/water/beach,
/area/shuttle/arrival)
"N" = (
/obj/structure/closet/emcloset,
/obj/effect/turf_decal/siding/wood,
/turf/open/floor/wood/large,
/area/shuttle/arrival)
"O" = (
/obj/machinery/power/shuttle_engine/propulsion{
	dir = 4
	},
/turf/open/floor/plating/airless,
/area/shuttle/arrival)
"P" = (
/turf/closed/wall/mineral/titanium,
/area/shuttle/arrival)
"Q" = (
/obj/effect/turf_decal/siding/wood{
	dir = 5
	},
/turf/open/water/beach,
/area/shuttle/arrival)
"R" = (
/obj/structure/table,
/obj/item/storage/medkit/regular,
/obj/effect/turf_decal/siding/wood{
	dir = 1
	},
/turf/open/floor/wood/large,
/area/shuttle/arrival)
"S" = (
/obj/effect/spawner/structure/window/reinforced/shuttle,
/turf/open/floor/plating,
/area/shuttle/arrival)
"T" = (
/obj/structure/chair/comfy/shuttle{
	dir = 8
	},
/obj/machinery/light/directional/south,
/turf/open/floor/wood/large,
/area/shuttle/arrival)
"U" = (
/obj/machinery/vending/vendcation,
/turf/open/floor/iron/terracotta/small,
/area/shuttle/arrival)
"V" = (
/obj/structure/table,
/obj/effect/spawner/random/food_or_drink/island_booze{
	pixel_y = 4
	},
/obj/effect/spawner/random/food_or_drink/island_booze{
	pixel_x = 9;
	pixel_y = 9
	},
/obj/effect/spawner/random/food_or_drink/island_booze{
	pixel_x = -4;
	pixel_y = 7
	},
/turf/open/floor/iron/terracotta/small,
/area/shuttle/arrival)
"W" = (
/obj/structure/table,
/obj/effect/spawner/random/food_or_drink/island_booze{
	pixel_x = -6;
	pixel_y = 5
	},
/obj/item/book/granter/magazine/biodome{
	pixel_x = 5
	},
/turf/open/floor/wood/large,
/area/shuttle/arrival)
"X" = (
/turf/open/floor/glass/reinforced,
/area/shuttle/arrival)
"Y" = (
/obj/effect/turf_decal/siding/wood{
	dir = 1
	},
/turf/open/water/beach,
/area/shuttle/arrival)

(1,1,1) = {"
q
q
P
S
P
q
q
"}
(2,1,1) = {"
q
P
P
A
P
P
q
"}
(3,1,1) = {"
q
S
g
a
T
S
q
"}
(4,1,1) = {"
P
P
y
z
y
P
P
"}
(5,1,1) = {"
S
N
L
L
L
R
S
"}
(6,1,1) = {"
S
a
a
a
a
a
S
"}
(7,1,1) = {"
w
a
A
l
A
a
w
"}
(8,1,1) = {"
P
C
K
o
K
F
P
"}
(9,1,1) = {"
S
U
r
x
I
B
S
"}
(10,1,1) = {"
S
b
r
Y
p
j
S
"}
(11,1,1) = {"
S
V
t
Y
M
r
S
"}
(12,1,1) = {"
S
f
r
Q
E
s
S
"}
(13,1,1) = {"
P
m
v
v
v
h
P
"}
(14,1,1) = {"
w
a
A
W
A
a
w
"}
(15,1,1) = {"
P
D
a
a
a
a
P
"}
(16,1,1) = {"
e
P
n
J
n
P
e
"}
(17,1,1) = {"
O
e
i
X
G
e
O
"}
(18,1,1) = {"
q
O
H
c
k
O
q
"}
