//MAP CONVERTED BY dmm2tgm.py THIS HEADER COMMENT PREVENTS RECONVERSION, DO NOT REMOVE
"a" = (
/turf/closed/wall/mineral/titanium/nodiagonal,
/area/shuttle/arrival)
"d" = (
/obj/structure/chair/sofa/bench/left,
/turf/open/floor/mineral/titanium/tiled/blue,
/area/shuttle/arrival)
"h" = (
/obj/machinery/power/shuttle_engine/propulsion{
	dir = 4
	},
/obj/docking_port/mobile/arrivals{
	name = "rimpoint arrivals shuttle"
	},
/obj/effect/turf_decal/stripes/line{
	dir = 4
	},
/obj/effect/turf_decal/stripes/red/line{
	dir = 4
	},
/obj/structure/window/reinforced/titanium/directional/west,
/turf/open/floor/plating,
/area/shuttle/arrival)
"q" = (
/turf/closed/wall/mineral/titanium,
/area/shuttle/arrival)
"s" = (
/turf/template_noop,
/area/template_noop)
"t" = (
/obj/structure/chair/sofa/bench/left{
	dir = 1
	},
/turf/open/floor/mineral/titanium/tiled/blue,
/area/shuttle/arrival)
"u" = (
/obj/effect/turf_decal/siding/wideplating_new{
	dir = 8
	},
/obj/structure/rack,
/obj/item/storage/toolbox/emergency,
/turf/open/floor/mineral/titanium/tiled,
/area/shuttle/arrival)
"x" = (
/obj/effect/turf_decal/siding/wideplating_new{
	dir = 4
	},
/obj/structure/rack,
/turf/open/floor/mineral/titanium/tiled,
/area/shuttle/arrival)
"A" = (
/obj/structure/chair/sofa/bench{
	dir = 1
	},
/turf/open/floor/mineral/titanium/tiled/blue,
/area/shuttle/arrival)
"D" = (
/obj/structure/closet/emcloset/anchored,
/obj/effect/turf_decal/bot_blue,
/obj/effect/turf_decal/siding/wideplating_new{
	dir = 4
	},
/turf/open/floor/mineral/titanium/tiled,
/area/shuttle/arrival)
"E" = (
/obj/effect/spawner/structure/window/reinforced/shuttle,
/turf/open/floor/plating,
/area/shuttle/arrival)
"G" = (
/obj/structure/chair/sofa/bench,
/turf/open/floor/mineral/titanium/tiled/blue,
/area/shuttle/arrival)
"M" = (
/obj/structure/chair/sofa/bench/right{
	dir = 1
	},
/turf/open/floor/mineral/titanium/tiled/blue,
/area/shuttle/arrival)
"R" = (
/obj/structure/closet/firecloset,
/obj/effect/turf_decal/bot_red,
/obj/effect/turf_decal/siding/wideplating_new{
	dir = 4
	},
/turf/open/floor/mineral/titanium/tiled,
/area/shuttle/arrival)
"T" = (
/turf/open/floor/mineral/titanium/blue,
/area/shuttle/arrival)
"V" = (
/obj/structure/chair/sofa/bench/right,
/obj/machinery/light/directional/north,
/turf/open/floor/mineral/titanium/tiled/blue,
/area/shuttle/arrival)
"W" = (
/obj/effect/turf_decal/siding/wideplating_new{
	dir = 1
	},
/obj/effect/turf_decal/siding/wideplating_new,
/obj/machinery/door/airlock/titanium,
/turf/open/floor/mineral/titanium/blue,
/area/shuttle/arrival)
"X" = (
/obj/effect/turf_decal/siding/wideplating_new{
	dir = 4
	},
/turf/open/floor/mineral/titanium,
/area/shuttle/arrival)
"Z" = (
/obj/effect/turf_decal/siding/wideplating_new{
	dir = 8
	},
/turf/open/floor/mineral/titanium,
/area/shuttle/arrival)

(1,1,1) = {"
q
a
E
a
q
"}
(2,1,1) = {"
a
D
x
R
a
"}
(3,1,1) = {"
E
X
X
X
W
"}
(4,1,1) = {"
a
V
T
t
a
"}
(5,1,1) = {"
E
G
T
A
E
"}
(6,1,1) = {"
a
d
T
M
a
"}
(7,1,1) = {"
E
Z
Z
Z
W
"}
(8,1,1) = {"
q
a
u
a
q
"}
(9,1,1) = {"
s
a
h
a
s
"}
