//MAP CONVERTED BY dmm2tgm.py THIS HEADER COMMENT PREVENTS RECONVERSION, DO NOT REMOVE
"a" = (
/obj/effect/turf_decal/tile/brown{
	dir = 8
	},
/obj/effect/turf_decal/tile/brown{
	dir = 4
	},
/obj/effect/turf_decal/tile/brown,
/obj/effect/turf_decal/tile/brown{
	dir = 1
	},
/turf/open/floor/mineral/titanium/white,
/area/shuttle/supply)
"b" = (
/obj/machinery/door/poddoor{
	id = "QMLoaddoor";
	name = "Supply Dock Loading Door"
	},
/obj/machinery/conveyor{
	dir = 8;
	id = "cargodelivery"
	},
/turf/open/floor/plating,
/area/shuttle/supply)
"c" = (
/obj/machinery/door/poddoor{
	id = "QMLoaddoor2";
	name = "Supply Dock Loading Door"
	},
/obj/machinery/conveyor{
	dir = 4;
	id = "cargodelivery2";
	name = "Cargo Belt"
	},
/turf/open/floor/plating,
/area/shuttle/supply)
"d" = (
/obj/machinery/power/shuttle_engine/heater,
/obj/structure/window/reinforced/spawner/directional/north,
/turf/open/floor/plating/airless,
/area/shuttle/supply)
"e" = (
/obj/machinery/light/directional/east,
/obj/machinery/button/door{
	id = "QMLoaddoor2";
	name = "Loading Doors South";
	pixel_x = 24;
	pixel_y = -8
	},
/obj/machinery/button/door{
	id = "QMLoaddoor";
	layer = 4;
	name = "Loading Doors North";
	pixel_x = 24;
	pixel_y = 8;
	req_access = list("cargo")
	},
/turf/open/floor/mineral/titanium/blue,
/area/shuttle/supply)
"y" = (
/obj/machinery/door/airlock/titanium{
	name = "Supply Shuttle Airlock"
	},
/obj/effect/mapping_helpers/airlock/access/all/supply/general,
/turf/open/floor/plating,
/area/shuttle/supply)
"A" = (
/obj/machinery/light/directional/west,
/turf/open/floor/mineral/titanium/blue,
/area/shuttle/supply)
"G" = (
/obj/machinery/door/airlock/titanium{
	name = "Supply Shuttle Airlock"
	},
/obj/docking_port/mobile/supply,
/obj/effect/mapping_helpers/airlock/access/all/supply/general,
/turf/open/floor/plating,
/area/shuttle/supply)
"I" = (
/obj/structure/window/reinforced/spawner/directional/north,
/obj/machinery/power/shuttle_engine/heater,
/turf/open/floor/plating/airless,
/area/shuttle/supply)
"K" = (
/obj/machinery/power/shuttle_engine/propulsion,
/turf/open/floor/plating/airless,
/area/shuttle/supply)
"M" = (
/turf/closed/wall/mineral/titanium,
/area/shuttle/supply)
"O" = (
/turf/template_noop,
/area/template_noop)
"T" = (
/turf/open/floor/mineral/titanium/blue,
/area/shuttle/supply)
"W" = (
/obj/effect/turf_decal/tile/brown{
	dir = 4
	},
/obj/effect/turf_decal/tile/brown,
/obj/effect/turf_decal/tile/brown{
	dir = 1
	},
/obj/effect/turf_decal/tile/brown{
	dir = 8
	},
/turf/open/floor/mineral/titanium/white,
/area/shuttle/supply)

(1,1,1) = {"
M
M
M
M
M
M
M
M
M
O
"}
(2,1,1) = {"
M
a
a
a
A
a
a
a
M
K
"}
(3,1,1) = {"
M
W
W
T
T
T
W
W
d
K
"}
(4,1,1) = {"
M
W
W
T
T
T
W
W
I
K
"}
(5,1,1) = {"
M
W
W
T
T
T
W
W
I
K
"}
(6,1,1) = {"
M
W
W
W
e
W
W
W
M
K
"}
(7,1,1) = {"
M
M
b
y
M
G
c
M
M
O
"}
