//MAP CONVERTED BY dmm2tgm.py THIS HEADER COMMENT PREVENTS RECONVERSION, DO NOT REMOVE
"br" = (
/obj/structure/closet,
/turf/open/floor/mineral/titanium/yellow,
/area/shuttle/escape)
"ds" = (
/obj/structure/table,
/obj/machinery/light/directional/north,
/obj/item/storage/medkit/toxin,
/turf/open/floor/mineral/titanium/white,
/area/shuttle/escape)
"dt" = (
/obj/structure/chair/comfy/shuttle{
	dir = 8
	},
/obj/machinery/light/directional/east,
/turf/open/floor/mineral/plastitanium/red,
/area/shuttle/escape/brig)
"em" = (
/obj/machinery/computer/crew,
/turf/open/floor/mineral/titanium/blue,
/area/shuttle/escape)
"ev" = (
/obj/structure/table,
/obj/structure/extinguisher_cabinet{
	pixel_x = 27
	},
/obj/item/storage/medkit/brute{
	pixel_x = 9;
	pixel_y = 9
	},
/obj/item/storage/medkit/fire,
/obj/item/storage/medkit/o2{
	pixel_x = -7;
	pixel_y = -7
	},
/turf/open/floor/mineral/titanium/yellow,
/area/shuttle/escape)
"ez" = (
/obj/machinery/door/airlock/external{
	name = "Emergency Recovery Airlock"
	},
/turf/open/floor/mineral/titanium/white,
/area/shuttle/escape)
"eC" = (
/obj/structure/closet/crate/internals,
/turf/open/floor/plating,
/area/shuttle/escape)
"eO" = (
/obj/structure/chair/comfy/shuttle{
	dir = 4
	},
/turf/open/floor/mineral/plastitanium/red,
/area/shuttle/escape/brig)
"fc" = (
/turf/closed/wall/mineral/titanium,
/area/shuttle/escape/brig)
"gv" = (
/obj/structure/closet,
/turf/open/floor/mineral/titanium,
/area/shuttle/escape)
"gJ" = (
/obj/machinery/door/airlock/external/glass,
/obj/docking_port/mobile/emergency{
	dir = 2;
	port_direction = 2
	},
/turf/open/floor/mineral/titanium/white,
/area/shuttle/escape)
"gN" = (
/obj/structure/bed/medical/emergency,
/obj/structure/extinguisher_cabinet{
	pixel_y = -30
	},
/turf/open/floor/mineral/titanium/white,
/area/shuttle/escape)
"hf" = (
/obj/machinery/button/flasher{
	id = "cockpit_flasher";
	pixel_x = -28
	},
/turf/open/floor/mineral/titanium/blue,
/area/shuttle/escape)
"hQ" = (
/obj/structure/window/reinforced/plasma/spawner/directional/east,
/obj/machinery/power/shuttle_engine/heater{
	dir = 8
	},
/turf/open/floor/plating/airless,
/area/shuttle/escape)
"jr" = (
/obj/effect/turf_decal/tile/brown{
	dir = 1
	},
/obj/effect/turf_decal/tile/brown,
/obj/effect/turf_decal/tile/yellow{
	dir = 4
	},
/turf/open/floor/mineral/titanium,
/area/shuttle/escape)
"jE" = (
/turf/open/floor/mineral/titanium,
/area/shuttle/escape)
"jK" = (
/obj/machinery/computer/emergency_shuttle{
	dir = 8
	},
/turf/open/floor/mineral/titanium,
/area/shuttle/escape)
"jL" = (
/obj/structure/closet/crate/medical,
/obj/effect/turf_decal/tile/brown,
/obj/effect/turf_decal/tile/brown{
	dir = 1
	},
/obj/effect/turf_decal/tile/yellow{
	dir = 8
	},
/turf/open/floor/mineral/titanium,
/area/shuttle/escape)
"mq" = (
/obj/structure/chair/office{
	dir = 1
	},
/turf/open/floor/mineral/titanium/white,
/area/shuttle/escape)
"mr" = (
/obj/effect/spawner/structure/window/reinforced/shuttle,
/turf/open/floor/plating,
/area/shuttle/escape/brig)
"nA" = (
/obj/structure/window/spawner/directional/north,
/obj/structure/window/spawner/directional/west,
/obj/structure/window/spawner/directional/east,
/obj/structure/flora/grass/jungle,
/turf/open/floor/grass,
/area/shuttle/escape)
"nN" = (
/obj/structure/window/spawner/directional/west,
/obj/structure/window/spawner/directional/east,
/obj/machinery/light/directional/south,
/turf/open/floor/grass,
/area/shuttle/escape)
"oa" = (
/turf/open/floor/mineral/titanium/blue,
/area/shuttle/escape)
"of" = (
/obj/machinery/shower/directional/north,
/obj/effect/turf_decal/delivery,
/turf/open/floor/mineral/titanium,
/area/shuttle/escape)
"pB" = (
/turf/closed/wall/mineral/titanium/nodiagonal,
/area/shuttle/escape/brig)
"qD" = (
/obj/structure/extinguisher_cabinet{
	pixel_x = 26
	},
/turf/open/floor/mineral/titanium,
/area/shuttle/escape)
"rh" = (
/obj/effect/turf_decal/tile/brown{
	dir = 1
	},
/obj/effect/turf_decal/tile/yellow{
	dir = 4
	},
/turf/open/floor/mineral/titanium,
/area/shuttle/escape)
"rQ" = (
/obj/machinery/flasher{
	id = "cockpit_flasher";
	pixel_x = 25;
	pixel_y = -5
	},
/turf/open/floor/mineral/titanium,
/area/shuttle/escape)
"sb" = (
/obj/machinery/door/airlock/external/glass,
/turf/open/floor/mineral/titanium/white,
/area/shuttle/escape)
"sB" = (
/obj/structure/window/spawner/directional/west,
/obj/structure/window/spawner/directional/east,
/turf/open/floor/grass,
/area/shuttle/escape)
"sT" = (
/obj/structure/window/spawner/directional/east,
/obj/structure/window/spawner/directional/west,
/obj/machinery/light/directional/north,
/turf/open/floor/grass,
/area/shuttle/escape)
"ts" = (
/turf/open/floor/plating,
/area/shuttle/escape)
"tw" = (
/obj/structure/extinguisher_cabinet{
	pixel_x = -5;
	pixel_y = 30
	},
/obj/machinery/light/directional/north,
/turf/open/floor/mineral/titanium,
/area/shuttle/escape)
"ua" = (
/obj/machinery/light/directional/east,
/turf/open/floor/plating,
/area/shuttle/escape)
"um" = (
/obj/structure/table,
/turf/open/floor/mineral/titanium/white,
/area/shuttle/escape)
"uq" = (
/obj/structure/table/reinforced,
/obj/item/hemostat{
	pixel_x = -4
	},
/obj/item/retractor{
	pixel_x = 4
	},
/obj/item/scalpel{
	pixel_y = 12
	},
/turf/open/floor/mineral/titanium/blue,
/area/shuttle/escape)
"uz" = (
/turf/open/floor/mineral/titanium/yellow,
/area/shuttle/escape)
"uN" = (
/obj/structure/table,
/obj/item/lazarus_injector,
/obj/machinery/light/directional/south,
/obj/effect/turf_decal/tile/brown,
/obj/effect/turf_decal/tile/yellow{
	dir = 8
	},
/turf/open/floor/mineral/titanium,
/area/shuttle/escape)
"uP" = (
/obj/machinery/door/airlock/engineering/glass,
/turf/open/floor/mineral/titanium/white,
/area/shuttle/escape)
"vo" = (
/obj/structure/chair/comfy/shuttle,
/turf/open/floor/plating,
/area/shuttle/escape)
"vp" = (
/obj/structure/chair/comfy/shuttle{
	dir = 8
	},
/turf/open/floor/mineral/plastitanium/red,
/area/shuttle/escape/brig)
"wK" = (
/obj/structure/table/reinforced,
/turf/open/floor/mineral/plastitanium/red,
/area/shuttle/escape/brig)
"wN" = (
/obj/structure/table,
/obj/machinery/smartfridge/disks{
	name = "Research Disk Storage";
	pixel_y = 2
	},
/turf/open/floor/mineral/titanium/purple,
/area/shuttle/escape)
"wS" = (
/obj/structure/table,
/obj/effect/turf_decal/tile/brown,
/obj/effect/turf_decal/tile/yellow{
	dir = 4
	},
/turf/open/floor/mineral/titanium,
/area/shuttle/escape)
"wW" = (
/obj/effect/turf_decal/tile/yellow{
	dir = 8
	},
/turf/open/floor/mineral/titanium,
/area/shuttle/escape)
"xp" = (
/obj/structure/table/reinforced,
/obj/item/surgicaldrill,
/turf/open/floor/mineral/titanium/blue,
/area/shuttle/escape)
"xq" = (
/obj/machinery/door/airlock/medical/glass{
	name = "Shuttle Medbay"
	},
/turf/open/floor/mineral/titanium/white,
/area/shuttle/escape)
"xQ" = (
/turf/open/floor/mineral/plastitanium/red,
/area/shuttle/escape/brig)
"yP" = (
/obj/effect/turf_decal/tile/brown{
	dir = 1
	},
/turf/open/floor/mineral/titanium,
/area/shuttle/escape)
"yY" = (
/obj/effect/turf_decal/tile/brown,
/turf/open/floor/mineral/titanium,
/area/shuttle/escape)
"Ad" = (
/obj/structure/extinguisher_cabinet{
	pixel_x = 26
	},
/obj/effect/turf_decal/tile/brown,
/obj/effect/turf_decal/tile/yellow{
	dir = 4
	},
/turf/open/floor/mineral/titanium,
/area/shuttle/escape)
"AI" = (
/obj/structure/chair/comfy/shuttle{
	dir = 4
	},
/obj/effect/turf_decal/bot,
/turf/open/floor/mineral/titanium,
/area/shuttle/escape)
"Bf" = (
/obj/structure/chair/comfy/shuttle{
	dir = 8
	},
/obj/effect/turf_decal/bot,
/turf/open/floor/mineral/titanium,
/area/shuttle/escape)
"Bx" = (
/obj/structure/window/spawner/directional/west,
/obj/structure/window/spawner/directional/east,
/obj/structure/flora/rock/pile,
/turf/open/floor/grass,
/area/shuttle/escape)
"BF" = (
/obj/structure/chair/comfy/shuttle{
	dir = 4
	},
/obj/effect/turf_decal/bot,
/obj/effect/turf_decal/tile/brown{
	dir = 1
	},
/obj/effect/turf_decal/tile/yellow{
	dir = 8
	},
/turf/open/floor/mineral/titanium,
/area/shuttle/escape)
"BK" = (
/obj/structure/window/spawner/directional/west,
/obj/structure/window/spawner/directional/east,
/obj/machinery/light/directional/north,
/turf/open/floor/grass,
/area/shuttle/escape)
"BU" = (
/obj/structure/window/reinforced/spawner/directional/east,
/obj/structure/window/reinforced/spawner/directional/north,
/obj/structure/window/reinforced/spawner/directional/west,
/obj/structure/window/reinforced/spawner/directional/south,
/turf/open/floor/grass,
/area/shuttle/escape)
"Cd" = (
/obj/machinery/power/shuttle_engine/heater{
	dir = 8
	},
/obj/structure/window/reinforced/plasma/spawner/directional/east,
/turf/open/floor/plating/airless,
/area/shuttle/escape)
"Df" = (
/turf/open/floor/iron/recharge_floor,
/area/shuttle/escape)
"Dr" = (
/obj/structure/chair/comfy/shuttle{
	dir = 4
	},
/obj/effect/turf_decal/bot,
/obj/machinery/status_display/evac{
	pixel_x = -32
	},
/turf/open/floor/mineral/titanium,
/area/shuttle/escape)
"Ds" = (
/obj/structure/window/spawner/directional/west,
/obj/structure/window/spawner/directional/south,
/obj/structure/window/spawner/directional/east,
/obj/structure/flora/grass/jungle,
/turf/open/floor/grass,
/area/shuttle/escape)
"Dw" = (
/obj/structure/table/reinforced,
/obj/item/storage/medkit/advanced,
/turf/open/floor/mineral/titanium/blue,
/area/shuttle/escape)
"DC" = (
/obj/machinery/light/directional/north,
/turf/open/floor/mineral/titanium,
/area/shuttle/escape)
"DZ" = (
/turf/open/floor/circuit,
/area/shuttle/escape)
"Ed" = (
/obj/structure/table/reinforced,
/obj/machinery/light/directional/east,
/turf/open/floor/mineral/plastitanium/red,
/area/shuttle/escape/brig)
"Ev" = (
/obj/machinery/door/airlock/research/glass,
/turf/open/floor/mineral/titanium/white,
/area/shuttle/escape)
"EK" = (
/obj/structure/chair/comfy/shuttle{
	dir = 8
	},
/turf/open/floor/mineral/titanium/blue,
/area/shuttle/escape)
"EQ" = (
/obj/structure/extinguisher_cabinet{
	pixel_x = 26
	},
/obj/machinery/light/directional/east,
/turf/open/floor/mineral/titanium/purple,
/area/shuttle/escape)
"FR" = (
/obj/structure/extinguisher_cabinet{
	pixel_x = -27
	},
/turf/open/floor/mineral/titanium,
/area/shuttle/escape)
"Gk" = (
/obj/structure/sign/departments/medbay/alt,
/turf/closed/wall/mineral/titanium,
/area/shuttle/escape)
"Go" = (
/obj/item/kirbyplants/random,
/turf/open/floor/mineral/titanium/blue,
/area/shuttle/escape)
"Gu" = (
/turf/template_noop,
/area/template_noop)
"Hn" = (
/obj/machinery/computer/communications{
	dir = 8
	},
/turf/open/floor/mineral/titanium,
/area/shuttle/escape)
"Hw" = (
/obj/machinery/door/airlock/mining/glass,
/turf/open/floor/mineral/titanium/white,
/area/shuttle/escape)
"HI" = (
/obj/structure/chair/comfy/shuttle{
	dir = 1
	},
/obj/effect/turf_decal/bot,
/turf/open/floor/mineral/titanium,
/area/shuttle/escape)
"HK" = (
/obj/structure/reagent_dispensers/fueltank,
/obj/effect/turf_decal/tile/brown{
	dir = 1
	},
/obj/effect/turf_decal/tile/yellow{
	dir = 8
	},
/obj/effect/turf_decal/tile/yellow{
	dir = 4
	},
/turf/open/floor/mineral/titanium,
/area/shuttle/escape)
"Iw" = (
/obj/structure/table,
/obj/effect/turf_decal/tile/brown,
/obj/effect/turf_decal/tile/yellow{
	dir = 8
	},
/obj/effect/turf_decal/tile/yellow{
	dir = 4
	},
/turf/open/floor/mineral/titanium,
/area/shuttle/escape)
"II" = (
/obj/structure/table/reinforced,
/obj/item/storage/fancy/donut_box,
/turf/open/floor/mineral/titanium/blue,
/area/shuttle/escape)
"IK" = (
/turf/open/floor/mineral/titanium/purple,
/area/shuttle/escape)
"Ja" = (
/obj/machinery/stasis,
/turf/open/floor/mineral/titanium/white,
/area/shuttle/escape)
"Jb" = (
/obj/structure/rack,
/obj/item/storage/toolbox/electrical{
	pixel_x = -3;
	pixel_y = 1
	},
/obj/item/storage/toolbox/mechanical{
	pixel_y = -1
	},
/obj/item/storage/toolbox/emergency{
	pixel_x = 3;
	pixel_y = -5
	},
/turf/open/floor/mineral/titanium/white,
/area/shuttle/escape)
"Jc" = (
/obj/machinery/holopad/secure,
/obj/effect/turf_decal/bot,
/turf/open/floor/mineral/titanium/blue,
/area/shuttle/escape)
"Jw" = (
/obj/structure/chair/office/light{
	dir = 8
	},
/turf/open/floor/mineral/titanium/purple,
/area/shuttle/escape)
"JB" = (
/obj/structure/table,
/obj/item/clipboard,
/obj/item/paper,
/turf/open/floor/mineral/titanium/white,
/area/shuttle/escape)
"JJ" = (
/obj/structure/chair/comfy/shuttle{
	dir = 1
	},
/turf/open/floor/mineral/plastitanium/red,
/area/shuttle/escape/brig)
"JS" = (
/obj/structure/table/reinforced,
/obj/machinery/recharger,
/turf/open/floor/mineral/titanium/blue,
/area/shuttle/escape)
"JU" = (
/obj/machinery/status_display/evac,
/turf/closed/wall/mineral/titanium,
/area/shuttle/escape)
"Kw" = (
/obj/structure/table,
/turf/open/floor/plating,
/area/shuttle/escape)
"KZ" = (
/obj/effect/turf_decal/tile/yellow{
	dir = 4
	},
/turf/open/floor/mineral/titanium,
/area/shuttle/escape)
"Ld" = (
/obj/machinery/recharge_station,
/turf/open/floor/circuit,
/area/shuttle/escape)
"Lk" = (
/obj/structure/table/reinforced,
/turf/open/floor/mineral/titanium/blue,
/area/shuttle/escape)
"LX" = (
/obj/machinery/door/airlock/command/glass{
	name = "Cockpit"
	},
/obj/effect/mapping_helpers/airlock/access/all/command/general,
/turf/open/floor/mineral/titanium/white,
/area/shuttle/escape)
"Mk" = (
/obj/machinery/door/airlock/external{
	name = "Emergency Recovery Airlock"
	},
/turf/open/floor/plating,
/area/shuttle/escape)
"Mq" = (
/obj/machinery/door/airlock/external/glass,
/obj/effect/mapping_helpers/airlock/access/all/security/brig,
/turf/open/floor/mineral/plastitanium/red,
/area/shuttle/escape/brig)
"ND" = (
/obj/machinery/power/shuttle_engine/propulsion{
	dir = 8
	},
/turf/open/floor/plating/airless,
/area/shuttle/escape)
"Ob" = (
/obj/structure/chair/comfy/shuttle{
	dir = 4
	},
/obj/machinery/flasher{
	id = "shuttle_flasher";
	pixel_x = -24;
	pixel_y = 6
	},
/obj/machinery/button/flasher{
	id = "shuttle_flasher";
	pixel_x = -24;
	pixel_y = -6
	},
/turf/open/floor/mineral/plastitanium/red,
/area/shuttle/escape/brig)
"Os" = (
/obj/structure/closet/emcloset,
/turf/open/floor/mineral/titanium,
/area/shuttle/escape)
"OQ" = (
/obj/structure/window/spawner/directional/north,
/obj/structure/window/spawner/directional/west,
/obj/structure/window/spawner/directional/east,
/obj/structure/flora/rock/pile,
/turf/open/floor/grass,
/area/shuttle/escape)
"Pw" = (
/obj/item/surgical_drapes,
/obj/structure/table/optable,
/turf/open/floor/mineral/titanium/white,
/area/shuttle/escape)
"PD" = (
/obj/machinery/mech_bay_recharge_port{
	dir = 8
	},
/turf/open/floor/circuit,
/area/shuttle/escape)
"Qg" = (
/obj/structure/window/spawner/directional/north,
/obj/structure/window/spawner/directional/west,
/obj/structure/window/spawner/directional/east,
/obj/structure/flora/grass/both,
/turf/open/floor/grass,
/area/shuttle/escape)
"Qs" = (
/obj/structure/window/spawner/directional/west,
/obj/structure/window/spawner/directional/south,
/obj/structure/window/spawner/directional/east,
/turf/open/floor/grass,
/area/shuttle/escape)
"RC" = (
/obj/effect/spawner/structure/window/reinforced/shuttle,
/turf/open/floor/plating,
/area/shuttle/escape)
"RZ" = (
/obj/machinery/light/directional/east,
/turf/open/floor/mineral/titanium,
/area/shuttle/escape)
"Sn" = (
/obj/structure/table/reinforced,
/obj/machinery/cell_charger,
/turf/open/floor/mineral/titanium/blue,
/area/shuttle/escape)
"Tn" = (
/turf/closed/wall/mineral/titanium/nodiagonal,
/area/shuttle/escape)
"Tr" = (
/obj/structure/table/reinforced,
/obj/item/cautery,
/obj/item/circular_saw,
/turf/open/floor/mineral/titanium/white,
/area/shuttle/escape)
"Uj" = (
/obj/structure/table,
/obj/item/paper_bin,
/obj/item/folder/white,
/obj/item/pen,
/obj/machinery/light/directional/west,
/turf/open/floor/mineral/titanium/white,
/area/shuttle/escape)
"Uk" = (
/obj/machinery/light/directional/south,
/turf/open/floor/mineral/titanium,
/area/shuttle/escape)
"Uq" = (
/turf/open/floor/mineral/titanium/white,
/area/shuttle/escape)
"UK" = (
/obj/machinery/computer/mech_bay_power_console{
	dir = 1
	},
/turf/open/floor/circuit,
/area/shuttle/escape)
"Vl" = (
/obj/structure/rack,
/obj/effect/turf_decal/tile/brown,
/obj/effect/turf_decal/tile/yellow{
	dir = 8
	},
/turf/open/floor/mineral/titanium,
/area/shuttle/escape)
"Vw" = (
/mob/living/basic/bot/medbot{
	name = "\improper emergency medibot";
	pixel_x = -3;
	pixel_y = 2
	},
/turf/open/floor/mineral/titanium/blue,
/area/shuttle/escape)
"VK" = (
/obj/structure/chair/comfy/shuttle{
	dir = 4
	},
/turf/open/floor/mineral/titanium/blue,
/area/shuttle/escape)
"VZ" = (
/obj/structure/table/reinforced,
/obj/item/clothing/gloves/latex,
/obj/item/clothing/mask/surgical,
/obj/item/healthanalyzer,
/turf/open/floor/mineral/titanium/white,
/area/shuttle/escape)
"Wb" = (
/obj/structure/extinguisher_cabinet{
	pixel_x = -27
	},
/obj/machinery/shower/directional/east,
/turf/open/floor/mineral/titanium/white,
/area/shuttle/escape)
"Wh" = (
/obj/machinery/door/airlock/security/old/glass{
	name = "Shuttle Brig"
	},
/obj/effect/mapping_helpers/airlock/access/all/security/brig,
/turf/open/floor/mineral/titanium/white,
/area/shuttle/escape/brig)
"Xx" = (
/obj/machinery/iv_drip,
/turf/open/floor/mineral/titanium/white,
/area/shuttle/escape)
"XJ" = (
/obj/machinery/computer/operating{
	dir = 1
	},
/turf/open/floor/mineral/titanium/blue,
/area/shuttle/escape)
"XR" = (
/obj/structure/reagent_dispensers/watertank,
/obj/effect/turf_decal/tile/brown{
	dir = 1
	},
/obj/effect/turf_decal/tile/yellow{
	dir = 4
	},
/turf/open/floor/mineral/titanium,
/area/shuttle/escape)
"YA" = (
/turf/closed/wall/mineral/titanium,
/area/shuttle/escape)

(1,1,1) = {"
Gu
Gu
Gu
ND
ND
ND
YA
ND
ND
ND
YA
ND
ND
ND
Gu
Gu
Gu
"}
(2,1,1) = {"
Gu
Gu
Gu
Tn
hQ
hQ
YA
hQ
hQ
hQ
YA
Cd
Cd
Tn
Gu
Gu
Gu
"}
(3,1,1) = {"
Gu
Gu
Gu
YA
Jb
br
AI
AI
RC
HK
BF
BF
jL
YA
Gu
Gu
Gu
"}
(4,1,1) = {"
Gu
Gu
Gu
RC
uz
Uq
uz
Uq
RC
XR
yY
KZ
Vl
RC
Gu
Gu
Gu
"}
(5,1,1) = {"
Gu
Gu
YA
YA
ds
uz
Uq
uz
RC
rh
wW
yP
uN
YA
YA
Gu
Gu
"}
(6,1,1) = {"
YA
YA
YA
YA
ev
um
uz
Uq
RC
jr
Ad
wS
Iw
YA
YA
YA
YA
"}
(7,1,1) = {"
YA
gv
gv
Tn
YA
RC
RC
uP
RC
Hw
YA
YA
YA
Tn
Ld
Ld
YA
"}
(8,1,1) = {"
YA
DC
jE
FR
jE
jE
jE
Uq
jE
Uq
Uk
YA
wN
Uj
IK
DZ
YA
"}
(9,1,1) = {"
RC
jE
Uq
Uq
Uq
Uq
Uq
Uq
Uq
Uq
Uq
Ev
Uq
Jw
Uq
HI
RC
"}
(10,1,1) = {"
RC
jE
Uq
Bf
Bf
Bf
Bf
Bf
Bf
Uq
jE
YA
IK
Uq
IK
HI
RC
"}
(11,1,1) = {"
YA
jE
Uq
OQ
nN
YA
BK
sB
Ds
Uq
jE
RC
JB
IK
Uq
UK
RC
"}
(12,1,1) = {"
YA
jE
Uq
AI
AI
AI
AI
AI
AI
Uq
jE
YA
IK
Uq
IK
Df
RC
"}
(13,1,1) = {"
sb
Uq
Uq
Uq
Uq
Uq
Uq
Uq
Uq
Uq
Uq
Ev
Uq
EQ
Uq
PD
YA
"}
(14,1,1) = {"
YA
DC
Uq
Bf
Bf
Bf
Bf
Bf
Bf
Uq
Uk
Tn
YA
YA
YA
YA
YA
"}
(15,1,1) = {"
YA
jE
Uq
Qg
nN
YA
sT
sB
Qs
Uq
jE
Os
YA
eC
Kw
Kw
YA
"}
(16,1,1) = {"
RC
jE
Uq
AI
AI
Dr
AI
AI
AI
Uq
jE
jE
RC
ts
ts
ts
Mk
"}
(17,1,1) = {"
RC
jE
Uq
Uq
Uq
Uq
Uq
Uq
Uq
Uq
Uq
Uq
ez
ts
ts
ts
RC
"}
(18,1,1) = {"
RC
jE
Uq
Bf
Bf
Bf
Bf
Bf
Bf
Uq
jE
jE
RC
vo
ts
ts
Mk
"}
(19,1,1) = {"
YA
jE
Uq
nA
nN
YA
BK
Bx
Ds
Uq
jE
Os
YA
vo
ua
ts
YA
"}
(20,1,1) = {"
YA
DC
Uq
AI
AI
AI
AI
AI
AI
Uq
Uk
Tn
YA
YA
YA
YA
YA
"}
(21,1,1) = {"
gJ
Uq
Uq
Uq
Uq
Uq
Uq
Uq
Uq
Uq
jE
YA
Wb
xp
Tr
uq
YA
"}
(22,1,1) = {"
YA
RZ
jE
jE
qD
RZ
jE
Uq
Uq
Uq
Uq
xq
oa
Uq
oa
Pw
YA
"}
(23,1,1) = {"
fc
fc
mr
mr
fc
pB
jE
Uq
Uq
Uq
jE
RC
Xx
oa
Uq
XJ
RC
"}
(24,1,1) = {"
fc
Ob
eO
eO
eO
mr
DC
Uq
Uq
Uq
Uk
Gk
em
mq
oa
VZ
RC
"}
(25,1,1) = {"
mr
xQ
xQ
xQ
xQ
Wh
Uq
Uq
Uq
Uq
jE
RC
Xx
oa
Uq
of
YA
"}
(26,1,1) = {"
Mq
xQ
xQ
xQ
JJ
mr
jE
Uq
Uq
Uq
Uq
xq
oa
Uq
oa
gN
YA
"}
(27,1,1) = {"
fc
Ed
vp
dt
wK
pB
rQ
Uq
jE
Uq
Uk
YA
Lk
Ja
Vw
Ja
YA
"}
(28,1,1) = {"
fc
fc
mr
fc
pB
pB
YA
LX
RC
LX
JU
Tn
Tn
RC
RC
RC
YA
"}
(29,1,1) = {"
Gu
Gu
Gu
Gu
YA
BU
hf
Uq
oa
Uq
oa
BU
YA
Gu
Gu
Gu
Gu
"}
(30,1,1) = {"
Gu
Gu
Gu
Gu
YA
DC
oa
VK
VK
VK
oa
Uk
YA
Gu
Gu
Gu
Gu
"}
(31,1,1) = {"
Gu
Gu
Gu
Gu
RC
Go
oa
JS
II
Dw
oa
Go
RC
Gu
Gu
Gu
Gu
"}
(32,1,1) = {"
Gu
Gu
Gu
Gu
YA
tw
oa
EK
EK
EK
oa
Uk
YA
Gu
Gu
Gu
Gu
"}
(33,1,1) = {"
Gu
Gu
Gu
Gu
YA
BU
oa
jE
Jc
jE
oa
BU
YA
Gu
Gu
Gu
Gu
"}
(34,1,1) = {"
Gu
Gu
Gu
Gu
YA
Tn
BU
Hn
Sn
jK
BU
Tn
YA
Gu
Gu
Gu
Gu
"}
(35,1,1) = {"
Gu
Gu
Gu
Gu
Gu
YA
YA
RC
RC
RC
YA
YA
Gu
Gu
Gu
Gu
Gu
"}
