//MAP CONVERTED BY dmm2tgm.py THIS HEADER COMMENT PREVENTS RECONVERSION, DO NOT REMOVE
"aC" = (
/obj/effect/turf_decal/siding/wideplating_new{
	dir = 9
	},
/turf/open/floor/iron/diagonal,
/area/shuttle/escape)
"aS" = (
/obj/structure/chair/comfy/shuttle{
	dir = 8
	},
/turf/open/floor/iron/dark/small,
/area/shuttle/escape)
"br" = (
/turf/open/floor/catwalk_floor/iron_white,
/area/shuttle/escape)
"co" = (
/obj/effect/turf_decal/siding/thinplating_new{
	dir = 10
	},
/turf/open/floor/iron/herringbone,
/area/shuttle/escape)
"cw" = (
/obj/effect/turf_decal/siding/dark{
	dir = 4
	},
/obj/machinery/light/directional/west,
/obj/structure/chair/comfy/shuttle{
	dir = 4
	},
/turf/open/floor/iron,
/area/shuttle/escape)
"cU" = (
/obj/machinery/light/broken/directional/east,
/obj/effect/decal/cleanable/dirt/dust,
/turf/open/floor/iron,
/area/shuttle/escape)
"do" = (
/obj/structure/table/optable,
/obj/effect/turf_decal/tile/blue/opposingcorners,
/obj/effect/turf_decal/stripes/line,
/obj/machinery/defibrillator_mount/loaded{
	pixel_y = 24
	},
/turf/open/floor/iron,
/area/shuttle/escape)
"ds" = (
/obj/effect/turf_decal/stripes/line{
	dir = 8
	},
/obj/effect/turf_decal/stripes/line{
	dir = 4
	},
/obj/structure/fans/tiny/shield,
/obj/machinery/door/poddoor/shutters/window{
	dir = 4;
	name = "Cargo Shutters";
	id = "emergency_cargoshutters"
	},
/turf/open/floor/plating,
/area/shuttle/escape)
"dN" = (
/turf/open/floor/iron/dark/small,
/area/shuttle/escape)
"dV" = (
/obj/structure/table/wood,
/obj/item/storage/photo_album{
	pixel_y = 1;
	pixel_x = 3
	},
/obj/item/book/manual/wiki/security_space_law{
	pixel_y = -1;
	pixel_x = -4
	},
/turf/open/floor/carpet/royalblue,
/area/shuttle/escape)
"eb" = (
/obj/effect/turf_decal/siding/wood{
	dir = 9
	},
/obj/structure/bed/double{
	dir = 1
	},
/obj/effect/spawner/random/bedsheet/double{
	dir = 1
	},
/turf/open/floor/wood,
/area/shuttle/escape)
"ek" = (
/obj/effect/turf_decal/siding/dark{
	dir = 4
	},
/obj/effect/turf_decal/trimline/dark_blue/line{
	dir = 4
	},
/obj/structure/railing{
	dir = 4
	},
/obj/structure/extinguisher_cabinet/directional/south,
/turf/open/floor/iron/dark/small,
/area/shuttle/escape)
"ew" = (
/obj/effect/turf_decal/siding/wideplating_new{
	dir = 4
	},
/obj/effect/turf_decal/siding/wideplating_new{
	dir = 8
	},
/obj/machinery/door/airlock/security,
/obj/effect/mapping_helpers/airlock/access/any/security/general,
/obj/effect/mapping_helpers/airlock/autoname,
/obj/effect/mapping_helpers/airlock/cyclelink_helper{
	dir = 4
	},
/turf/open/floor/iron/smooth_large,
/area/shuttle/escape/brig)
"eO" = (
/obj/effect/spawner/structure/window/reinforced/plasma/plastitanium,
/turf/open/floor/plating,
/area/shuttle/escape)
"fC" = (
/obj/effect/turf_decal/siding/wood{
	dir = 5
	},
/obj/machinery/light/directional/north,
/turf/open/floor/wood,
/area/shuttle/escape)
"fU" = (
/obj/effect/turf_decal/siding/wideplating_new{
	dir = 4
	},
/obj/effect/turf_decal/siding/wideplating_new{
	dir = 8
	},
/obj/machinery/door/airlock/external,
/obj/effect/mapping_helpers/airlock/autoname,
/obj/effect/mapping_helpers/airlock/cyclelink_helper{
	dir = 4
	},
/obj/docking_port/mobile/emergency{
	name = "Sigma Octantis emergency shuttle"
	},
/turf/open/floor/iron/smooth_large,
/area/shuttle/escape)
"gk" = (
/obj/effect/turf_decal/siding/wideplating_new,
/obj/effect/turf_decal/siding/wideplating_new{
	dir = 1
	},
/obj/machinery/door/airlock/medical/glass,
/obj/effect/mapping_helpers/airlock/autoname,
/turf/open/floor/iron/smooth_large,
/area/shuttle/escape)
"hj" = (
/obj/structure/railing/corner/end,
/obj/structure/railing/corner/end/flip{
	dir = 1
	},
/obj/effect/turf_decal/siding/wood{
	dir = 8
	},
/obj/structure/chair/comfy/shuttle{
	dir = 4
	},
/turf/open/floor/carpet/royalblue,
/area/shuttle/escape)
"hy" = (
/obj/structure/table/reinforced/plastitaniumglass,
/obj/machinery/fax{
	fax_name = "Captain's Office";
	name = "Captain's Fax Machine"
	},
/turf/open/floor/iron/dark/small,
/area/shuttle/escape)
"ie" = (
/obj/machinery/vending/cigarette,
/obj/effect/turf_decal/siding/wideplating_new{
	dir = 1
	},
/turf/open/floor/iron/smooth_large,
/area/shuttle/escape)
"ip" = (
/turf/template_noop,
/area/template_noop)
"iu" = (
/obj/effect/turf_decal/trimline/dark_blue/filled/line{
	dir = 8
	},
/turf/open/floor/iron/dark,
/area/shuttle/escape)
"iX" = (
/obj/structure/rack,
/obj/item/storage/medkit{
	pixel_y = 10
	},
/obj/item/storage/medkit/brute{
	pixel_y = 5
	},
/obj/item/storage/medkit/fire,
/obj/item/storage/medkit/toxin{
	pixel_y = -6
	},
/turf/open/floor/catwalk_floor/iron_white,
/area/shuttle/escape)
"kj" = (
/obj/effect/turf_decal/stripes/line{
	dir = 8
	},
/obj/effect/turf_decal/stripes/line{
	dir = 4
	},
/obj/structure/fans/tiny/shield,
/obj/machinery/door/poddoor/shutters/window{
	dir = 4;
	name = "Cargo Shutters";
	id = "emergency_cargoshutters"
	},
/obj/machinery/button/door/directional/north{
	id = "emergency_cargoshutters";
	name = "Cargo Shutters"
	},
/turf/open/floor/plating,
/area/shuttle/escape)
"kB" = (
/obj/effect/turf_decal/siding/thinplating_new/dark{
	dir = 8
	},
/turf/open/floor/iron/dark,
/area/shuttle/escape)
"kC" = (
/obj/effect/turf_decal/siding/thinplating_new{
	dir = 6
	},
/turf/open/floor/iron/herringbone,
/area/shuttle/escape)
"lf" = (
/obj/machinery/light/directional/south,
/turf/open/floor/catwalk_floor/iron,
/area/shuttle/escape)
"mY" = (
/obj/effect/turf_decal/siding/thinplating_new{
	dir = 8
	},
/turf/open/floor/iron/herringbone,
/area/shuttle/escape)
"ne" = (
/obj/structure/reagent_dispensers/foamtank,
/obj/effect/turf_decal/bot_white,
/obj/effect/turf_decal/siding/wideplating_new,
/turf/open/floor/iron/diagonal,
/area/shuttle/escape)
"nm" = (
/obj/machinery/light/directional/south,
/turf/open/floor/catwalk_floor,
/area/shuttle/escape)
"ns" = (
/obj/effect/turf_decal/siding/wideplating_new{
	dir = 1
	},
/turf/open/floor/iron/diagonal,
/area/shuttle/escape)
"nM" = (
/obj/machinery/stasis,
/obj/effect/turf_decal/tile/blue/fourcorners,
/turf/open/floor/iron/white/small,
/area/shuttle/escape)
"oi" = (
/turf/open/floor/catwalk_floor,
/area/shuttle/escape)
"ok" = (
/obj/effect/turf_decal/bot,
/obj/structure/closet/crate,
/obj/item/storage/fancy/candle_box,
/turf/open/floor/iron/smooth,
/area/shuttle/escape)
"ol" = (
/obj/machinery/light/directional/south,
/turf/open/floor/catwalk_floor/iron_white,
/area/shuttle/escape)
"oF" = (
/turf/open/floor/plating,
/area/shuttle/escape)
"pr" = (
/obj/effect/turf_decal/tile/dark_red/opposingcorners,
/obj/effect/turf_decal/siding/dark_red{
	dir = 6
	},
/obj/structure/chair/comfy/shuttle{
	dir = 8
	},
/turf/open/floor/iron/dark/textured,
/area/shuttle/escape/brig)
"pI" = (
/obj/structure/chair/office{
	dir = 1;
	name = "tactical swivel chair"
	},
/obj/effect/turf_decal/siding/dark{
	dir = 4
	},
/obj/effect/turf_decal/trimline/dark_blue/line{
	dir = 4
	},
/obj/structure/railing{
	dir = 4
	},
/turf/open/floor/iron/dark/small,
/area/shuttle/escape)
"pW" = (
/obj/machinery/light/directional/north,
/turf/open/floor/catwalk_floor,
/area/shuttle/escape)
"qj" = (
/obj/effect/turf_decal/bot,
/turf/open/floor/iron/smooth,
/area/shuttle/escape)
"qM" = (
/obj/effect/turf_decal/siding/dark{
	dir = 4
	},
/obj/structure/chair/comfy/shuttle{
	dir = 4
	},
/turf/open/floor/iron,
/area/shuttle/escape)
"qV" = (
/obj/machinery/suit_storage_unit/open,
/obj/effect/decal/cleanable/dirt/dust,
/turf/open/floor/iron,
/area/shuttle/escape)
"rt" = (
/obj/item/stack/tile/iron/base,
/turf/open/floor/plating,
/area/shuttle/escape)
"rA" = (
/obj/effect/turf_decal/siding/wideplating_new{
	dir = 4
	},
/obj/effect/turf_decal/siding/wideplating_new{
	dir = 8
	},
/obj/machinery/door/airlock/medical/glass,
/obj/effect/mapping_helpers/airlock/autoname,
/turf/open/floor/iron/smooth_large,
/area/shuttle/escape)
"rL" = (
/obj/effect/turf_decal/siding/wideplating_new,
/obj/effect/turf_decal/siding/wideplating_new{
	dir = 1
	},
/obj/machinery/door/airlock/security,
/obj/effect/mapping_helpers/airlock/access/any/security/general,
/obj/effect/mapping_helpers/airlock/autoname,
/turf/open/floor/iron/smooth_large,
/area/shuttle/escape/brig)
"sW" = (
/obj/effect/turf_decal/siding/thinplating_new{
	dir = 9
	},
/turf/open/floor/iron/herringbone,
/area/shuttle/escape)
"sX" = (
/obj/effect/turf_decal/bot,
/obj/structure/closet/crate,
/turf/open/floor/iron/smooth,
/area/shuttle/escape)
"tg" = (
/obj/machinery/light/directional/north,
/turf/open/floor/catwalk_floor/iron,
/area/shuttle/escape)
"tk" = (
/turf/open/floor/carpet/royalblue,
/area/shuttle/escape)
"tR" = (
/obj/effect/turf_decal/tile/dark_red/opposingcorners,
/obj/effect/turf_decal/siding/dark_red{
	dir = 10
	},
/obj/structure/chair/comfy/shuttle{
	name = "tactical chair";
	dir = 4
	},
/turf/open/floor/iron/dark/textured,
/area/shuttle/escape/brig)
"uo" = (
/obj/structure/chair/comfy/shuttle{
	dir = 1
	},
/obj/machinery/light/directional/south,
/turf/open/floor/carpet/royalblue,
/area/shuttle/escape)
"uO" = (
/obj/effect/turf_decal/siding/wideplating_new{
	dir = 4
	},
/obj/effect/turf_decal/siding/wideplating_new{
	dir = 8
	},
/obj/machinery/door/airlock/security,
/obj/effect/mapping_helpers/airlock/access/any/security/general,
/obj/effect/mapping_helpers/airlock/autoname,
/turf/open/floor/iron/smooth_large,
/area/shuttle/escape/brig)
"uU" = (
/obj/machinery/smartfridge/organ,
/obj/effect/turf_decal/tile/blue/opposingcorners,
/obj/effect/turf_decal/stripes/corner{
	dir = 8
	},
/turf/open/floor/iron,
/area/shuttle/escape)
"vk" = (
/obj/effect/turf_decal/stripes/corner{
	dir = 1
	},
/obj/structure/railing/corner{
	dir = 1
	},
/obj/effect/turf_decal/siding/dark{
	dir = 6
	},
/turf/open/floor/iron,
/area/shuttle/escape)
"vU" = (
/obj/machinery/light/directional/west,
/obj/effect/turf_decal/bot,
/obj/structure/closet/crate,
/turf/open/floor/iron/smooth,
/area/shuttle/escape)
"wK" = (
/obj/effect/turf_decal/bot,
/obj/structure/closet/crate,
/obj/item/storage/toolbox/mechanical,
/turf/open/floor/iron/smooth,
/area/shuttle/escape)
"xj" = (
/obj/structure/tank_dispenser/oxygen,
/obj/effect/turf_decal/bot_blue,
/obj/effect/turf_decal/siding/wideplating_new{
	dir = 6
	},
/turf/open/floor/iron/diagonal,
/area/shuttle/escape)
"xm" = (
/turf/closed/wall/mineral/plastitanium/nodiagonal,
/area/shuttle/escape)
"xn" = (
/obj/effect/turf_decal/tile/blue/fourcorners,
/obj/effect/turf_decal/siding/blue{
	dir = 8
	},
/turf/open/floor/iron/white/small,
/area/shuttle/escape)
"xq" = (
/obj/effect/turf_decal/siding/dark{
	dir = 4
	},
/obj/effect/turf_decal/trimline/dark_blue/line{
	dir = 4
	},
/obj/structure/railing/corner/end{
	dir = 1
	},
/obj/structure/railing/corner/end/flip,
/turf/open/floor/iron/dark/small,
/area/shuttle/escape)
"xy" = (
/obj/structure/sign/departments/med_alt/directional/east,
/turf/open/floor/catwalk_floor/iron,
/area/shuttle/escape)
"xA" = (
/obj/effect/turf_decal/stripes/line,
/obj/structure/railing,
/obj/structure/chair/comfy/shuttle{
	dir = 1
	},
/obj/effect/turf_decal/siding/dark{
	dir = 1
	},
/turf/open/floor/iron,
/area/shuttle/escape)
"yO" = (
/obj/effect/turf_decal/stripes/line{
	dir = 8
	},
/obj/structure/railing{
	dir = 8
	},
/obj/structure/chair/comfy/shuttle{
	dir = 4
	},
/obj/effect/turf_decal/siding/dark{
	dir = 4
	},
/turf/open/floor/iron,
/area/shuttle/escape)
"zw" = (
/obj/item/surgery_tray/full/deployed,
/obj/effect/turf_decal/tile/blue/opposingcorners,
/obj/effect/turf_decal/stripes/line{
	dir = 10
	},
/turf/open/floor/iron,
/area/shuttle/escape)
"zH" = (
/obj/effect/turf_decal/siding/wideplating_new,
/obj/effect/turf_decal/siding/wideplating_new{
	dir = 1
	},
/obj/machinery/door/airlock/command/glass,
/obj/effect/mapping_helpers/airlock/access/all/command/general,
/obj/effect/mapping_helpers/airlock/autoname,
/turf/open/floor/iron/smooth_large,
/area/shuttle/escape)
"zU" = (
/obj/effect/decal/cleanable/dirt/dust,
/turf/open/floor/iron,
/area/shuttle/escape)
"Ad" = (
/obj/machinery/computer/communications{
	dir = 4
	},
/turf/open/floor/iron/dark/small,
/area/shuttle/escape)
"As" = (
/obj/effect/turf_decal/siding/wood{
	dir = 8
	},
/obj/structure/chair/comfy/black,
/turf/open/floor/wood,
/area/shuttle/escape)
"AA" = (
/obj/effect/turf_decal/tile/dark_red/opposingcorners,
/obj/effect/turf_decal/siding/dark_red,
/turf/open/floor/iron/dark/textured,
/area/shuttle/escape/brig)
"AD" = (
/obj/effect/turf_decal/siding/wideplating_new,
/obj/effect/turf_decal/siding/wideplating_new{
	dir = 1
	},
/obj/machinery/door/airlock/hatch,
/obj/effect/mapping_helpers/airlock/autoname,
/turf/open/floor/iron/smooth_large,
/area/shuttle/escape)
"Bc" = (
/obj/effect/turf_decal/siding/wideplating_new/corner{
	dir = 4
	},
/turf/open/floor/iron/diagonal,
/area/shuttle/escape)
"Bn" = (
/obj/structure/railing{
	dir = 8
	},
/obj/effect/turf_decal/siding/wood{
	dir = 8
	},
/obj/structure/chair/comfy/shuttle{
	dir = 4
	},
/turf/open/floor/carpet/royalblue,
/area/shuttle/escape)
"Br" = (
/obj/effect/turf_decal/siding/wideplating_new{
	dir = 4
	},
/obj/effect/turf_decal/siding/wideplating_new{
	dir = 8
	},
/obj/machinery/door/airlock/external,
/obj/effect/mapping_helpers/airlock/autoname,
/obj/effect/mapping_helpers/airlock/cyclelink_helper{
	dir = 8
	},
/turf/open/floor/iron/smooth_large,
/area/shuttle/escape)
"BG" = (
/obj/effect/turf_decal/siding/thinplating_new,
/turf/open/floor/iron/herringbone,
/area/shuttle/escape)
"Ec" = (
/obj/effect/turf_decal/trimline/dark_blue/filled/line{
	dir = 10
	},
/turf/open/floor/iron/dark,
/area/shuttle/escape)
"Ed" = (
/obj/effect/turf_decal/siding/wideplating_new,
/obj/effect/turf_decal/siding/wideplating_new{
	dir = 1
	},
/obj/machinery/door/airlock/engineering,
/obj/effect/mapping_helpers/airlock/autoname,
/turf/open/floor/iron/smooth_large,
/area/shuttle/escape)
"Ee" = (
/obj/effect/turf_decal/siding/wideplating_new,
/turf/open/floor/iron/diagonal,
/area/shuttle/escape)
"Ex" = (
/obj/machinery/computer/atmos_alert,
/obj/effect/turf_decal/siding/thinplating_new/dark,
/turf/open/floor/iron/dark,
/area/shuttle/escape)
"EM" = (
/obj/effect/turf_decal/tile/dark_red/opposingcorners,
/obj/effect/turf_decal/siding/dark_red{
	dir = 1
	},
/obj/machinery/light/directional/north,
/turf/open/floor/iron/dark/textured,
/area/shuttle/escape/brig)
"FA" = (
/obj/effect/turf_decal/siding/wood{
	dir = 10
	},
/obj/structure/table/reinforced/plastitaniumglass,
/turf/open/floor/wood,
/area/shuttle/escape)
"FE" = (
/obj/structure/chair/comfy/shuttle,
/turf/open/floor/carpet/royalblue,
/area/shuttle/escape)
"FY" = (
/obj/structure/railing{
	dir = 8
	},
/obj/effect/turf_decal/bot,
/obj/effect/turf_decal/stripes/line{
	dir = 8
	},
/obj/effect/turf_decal/siding/dark{
	dir = 4
	},
/turf/open/floor/iron,
/area/shuttle/escape)
"Ga" = (
/obj/structure/extinguisher_cabinet/directional/south,
/turf/open/floor/catwalk_floor/iron,
/area/shuttle/escape)
"GC" = (
/obj/effect/turf_decal/siding/wideplating_new{
	dir = 4
	},
/obj/effect/turf_decal/siding/wideplating_new{
	dir = 8
	},
/obj/machinery/door/airlock/mining,
/obj/effect/mapping_helpers/airlock/autoname,
/turf/open/floor/iron/smooth_large,
/area/shuttle/escape)
"GH" = (
/obj/structure/table/reinforced/plastitaniumglass,
/obj/machinery/recharger,
/obj/effect/turf_decal/siding/thinplating_new/dark{
	dir = 8
	},
/turf/open/floor/iron/dark,
/area/shuttle/escape)
"Ho" = (
/obj/machinery/light/directional/east,
/turf/open/floor/catwalk_floor/iron,
/area/shuttle/escape)
"Hw" = (
/obj/effect/turf_decal/siding/thinplating_new{
	dir = 5
	},
/turf/open/floor/iron/herringbone,
/area/shuttle/escape)
"HO" = (
/obj/effect/turf_decal/stripes/line{
	dir = 1
	},
/obj/structure/railing{
	dir = 1
	},
/obj/structure/chair/comfy/shuttle,
/obj/effect/turf_decal/siding/dark,
/turf/open/floor/iron,
/area/shuttle/escape)
"HP" = (
/obj/effect/decal/cleanable/dirt/dust,
/obj/effect/spawner/random/structure/chair_flipped,
/turf/open/floor/plating,
/area/shuttle/escape)
"HR" = (
/turf/open/floor/iron/lowered,
/area/shuttle/escape)
"Ir" = (
/turf/open/floor/catwalk_floor/iron,
/area/shuttle/escape)
"II" = (
/turf/open/floor/iron/smooth,
/area/shuttle/escape)
"Jr" = (
/obj/machinery/recharge_station,
/obj/effect/turf_decal/siding/wideplating_new{
	dir = 10
	},
/turf/open/floor/iron/diagonal,
/area/shuttle/escape)
"JF" = (
/obj/effect/turf_decal/siding/wideplating_new{
	dir = 4
	},
/obj/effect/turf_decal/siding/wideplating_new{
	dir = 8
	},
/obj/machinery/door/airlock/external,
/obj/effect/mapping_helpers/airlock/autoname,
/obj/effect/mapping_helpers/airlock/cyclelink_helper{
	dir = 4
	},
/turf/open/floor/iron/smooth_large,
/area/shuttle/escape)
"JT" = (
/obj/effect/turf_decal/stripes/corner{
	dir = 4
	},
/obj/structure/railing/corner{
	dir = 4
	},
/obj/effect/turf_decal/siding/dark{
	dir = 10
	},
/turf/open/floor/iron,
/area/shuttle/escape)
"Lb" = (
/obj/structure/sign/departments/security/directional/north,
/turf/open/floor/catwalk_floor/iron,
/area/shuttle/escape)
"Lh" = (
/obj/machinery/power/shuttle_engine/propulsion,
/obj/effect/turf_decal/stripes/line,
/turf/open/floor/plating/airless,
/area/shuttle/escape)
"MO" = (
/obj/effect/turf_decal/tile/dark_red/opposingcorners,
/obj/effect/turf_decal/siding/dark_red{
	dir = 5
	},
/obj/structure/chair/comfy/shuttle{
	dir = 8
	},
/turf/open/floor/iron/dark/textured,
/area/shuttle/escape/brig)
"Ng" = (
/obj/effect/turf_decal/stripes/line{
	dir = 4
	},
/obj/structure/railing{
	dir = 4
	},
/obj/structure/chair/comfy/shuttle{
	dir = 8
	},
/obj/effect/turf_decal/siding/dark{
	dir = 8
	},
/turf/open/floor/iron,
/area/shuttle/escape)
"NP" = (
/obj/effect/decal/cleanable/dirt/dust,
/turf/open/floor/plating,
/area/shuttle/escape)
"Og" = (
/obj/effect/turf_decal/tile/blue/fourcorners,
/obj/structure/table,
/obj/item/storage/medkit/regular{
	pixel_x = 2;
	pixel_y = 3
	},
/obj/item/storage/medkit/fire,
/obj/item/crowbar,
/turf/open/floor/iron/white/small,
/area/shuttle/escape)
"Oj" = (
/obj/structure/table/reinforced/plastitaniumglass,
/obj/item/newspaper{
	pixel_x = -6;
	pixel_y = 5
	},
/obj/item/megaphone/command{
	pixel_y = 5;
	pixel_x = 2
	},
/obj/item/gps{
	pixel_x = -6
	},
/obj/machinery/light/directional/south,
/turf/open/floor/iron/dark/small,
/area/shuttle/escape)
"Os" = (
/obj/effect/turf_decal/bot,
/obj/structure/closet/crate,
/obj/item/storage/medkit/fire,
/turf/open/floor/iron/smooth,
/area/shuttle/escape)
"OV" = (
/obj/structure/closet/firecloset,
/obj/effect/turf_decal/bot_red,
/obj/effect/turf_decal/siding/wideplating_new{
	dir = 5
	},
/turf/open/floor/iron/diagonal,
/area/shuttle/escape)
"Po" = (
/obj/item/stack/tile/iron/base,
/obj/effect/decal/cleanable/dirt/dust,
/turf/open/floor/plating,
/area/shuttle/escape)
"PU" = (
/obj/effect/turf_decal/siding/wideplating_new{
	dir = 5
	},
/turf/open/floor/iron/diagonal,
/area/shuttle/escape)
"QT" = (
/obj/effect/turf_decal/trimline/dark_blue/filled/line{
	dir = 9
	},
/turf/open/floor/iron/dark,
/area/shuttle/escape)
"QY" = (
/obj/effect/turf_decal/siding/wideplating_new{
	dir = 4
	},
/obj/effect/turf_decal/siding/wideplating_new{
	dir = 8
	},
/obj/machinery/door/airlock/hatch,
/obj/effect/mapping_helpers/airlock/autoname,
/turf/open/floor/iron/smooth_large,
/area/shuttle/escape)
"Ry" = (
/obj/effect/turf_decal/trimline/dark_blue/filled/line{
	dir = 6
	},
/turf/open/floor/iron/dark,
/area/shuttle/escape)
"Rz" = (
/obj/structure/table/wood,
/obj/item/gun/energy/e_gun/mini{
	pixel_y = 5
	},
/turf/open/floor/carpet/royalblue,
/area/shuttle/escape)
"Sq" = (
/obj/machinery/computer/station_alert,
/obj/effect/turf_decal/siding/thinplating_new/dark,
/turf/open/floor/iron/dark,
/area/shuttle/escape)
"SL" = (
/obj/machinery/light/directional/west,
/obj/machinery/recharge_station,
/obj/effect/turf_decal/siding/wideplating_new{
	dir = 8
	},
/turf/open/floor/iron/diagonal,
/area/shuttle/escape)
"SM" = (
/obj/effect/turf_decal/stripes/corner,
/obj/structure/railing/corner,
/obj/effect/turf_decal/siding/dark{
	dir = 9
	},
/obj/item/kirbyplants/random,
/turf/open/floor/iron,
/area/shuttle/escape)
"ST" = (
/obj/effect/turf_decal/siding/dark{
	dir = 6
	},
/turf/open/floor/iron,
/area/shuttle/escape)
"Th" = (
/obj/effect/turf_decal/tile/dark_red/opposingcorners,
/obj/effect/turf_decal/siding/dark_red{
	dir = 9
	},
/obj/structure/table,
/obj/machinery/recharger,
/obj/item/storage/box/handcuffs{
	pixel_y = 13;
	pixel_x = -6
	},
/turf/open/floor/iron/dark/textured,
/area/shuttle/escape/brig)
"Tz" = (
/obj/machinery/power/shuttle_engine/heater,
/obj/effect/turf_decal/stripes/line{
	dir = 1
	},
/obj/structure/window/reinforced/survival_pod/spawner/directional/north,
/turf/open/floor/plating/airless,
/area/shuttle/escape)
"TD" = (
/obj/machinery/vending/coffee,
/obj/effect/turf_decal/siding/thinplating_new/dark{
	dir = 8
	},
/turf/open/floor/iron/dark,
/area/shuttle/escape)
"TI" = (
/obj/structure/chair/office/light{
	dir = 1
	},
/obj/effect/turf_decal/trimline/dark_blue/filled/line{
	dir = 5
	},
/turf/open/floor/iron/dark,
/area/shuttle/escape)
"TJ" = (
/obj/structure/chair/comfy/shuttle{
	dir = 8
	},
/turf/open/floor/carpet/royalblue,
/area/shuttle/escape)
"TP" = (
/obj/effect/turf_decal/trimline/dark_blue/filled/line{
	dir = 4
	},
/turf/open/floor/iron/dark,
/area/shuttle/escape)
"Ui" = (
/obj/effect/turf_decal/stripes/line{
	dir = 1
	},
/obj/structure/railing{
	dir = 1
	},
/obj/structure/chair/sofa/bench/right,
/obj/effect/turf_decal/siding/dark,
/turf/open/floor/iron,
/area/shuttle/escape)
"Ul" = (
/mob/living/basic/bot/medbot,
/obj/effect/turf_decal/siding/thinplating_new/corner{
	dir = 4
	},
/turf/open/floor/iron/herringbone,
/area/shuttle/escape)
"UA" = (
/obj/structure/table/reinforced/plastitaniumglass,
/obj/item/clipboard,
/obj/item/trash/chips,
/obj/effect/turf_decal/siding/thinplating_new/dark{
	dir = 8
	},
/turf/open/floor/iron/dark,
/area/shuttle/escape)
"Va" = (
/turf/open/floor/catwalk_floor/iron,
/area/shuttle/escape/brig)
"Vl" = (
/obj/machinery/computer/operating,
/obj/effect/turf_decal/tile/blue/opposingcorners,
/obj/effect/turf_decal/stripes/line{
	dir = 10
	},
/obj/machinery/light/directional/north,
/turf/open/floor/iron,
/area/shuttle/escape)
"Vo" = (
/obj/machinery/computer/security,
/turf/open/floor/iron/dark/small,
/area/shuttle/escape)
"VE" = (
/obj/effect/turf_decal/siding/wood{
	dir = 4
	},
/turf/open/floor/wood,
/area/shuttle/escape)
"VP" = (
/obj/structure/table/reinforced/plastitaniumglass,
/obj/item/storage/medkit/regular,
/obj/effect/turf_decal/siding/thinplating_new/dark/corner{
	dir = 8
	},
/turf/open/floor/iron/dark,
/area/shuttle/escape)
"VU" = (
/obj/machinery/computer/crew,
/obj/effect/turf_decal/siding/dark{
	dir = 4
	},
/obj/effect/turf_decal/trimline/dark_blue/line{
	dir = 4
	},
/obj/structure/railing{
	dir = 4
	},
/turf/open/floor/iron/dark/small,
/area/shuttle/escape)
"VX" = (
/obj/effect/turf_decal/siding/dark{
	dir = 4
	},
/turf/open/floor/iron,
/area/shuttle/escape)
"VY" = (
/turf/closed/wall/mineral/plastitanium,
/area/shuttle/escape)
"Wd" = (
/obj/structure/railing{
	dir = 8
	},
/obj/effect/turf_decal/siding/wood{
	dir = 8
	},
/turf/open/floor/carpet/royalblue,
/area/shuttle/escape)
"WT" = (
/obj/effect/turf_decal/stripes/line{
	dir = 1
	},
/obj/structure/railing{
	dir = 1
	},
/obj/structure/chair/sofa/bench/left,
/obj/effect/turf_decal/siding/dark,
/turf/open/floor/iron,
/area/shuttle/escape)
"Xv" = (
/obj/effect/turf_decal/siding/wood{
	dir = 6
	},
/obj/structure/chair/comfy/black{
	dir = 8
	},
/turf/open/floor/wood,
/area/shuttle/escape)
"XE" = (
/obj/effect/turf_decal/siding/wideplating_new{
	dir = 4
	},
/obj/effect/turf_decal/siding/wideplating_new{
	dir = 8
	},
/obj/machinery/door/airlock/security,
/obj/effect/mapping_helpers/airlock/access/any/security/general,
/obj/effect/mapping_helpers/airlock/autoname,
/obj/effect/mapping_helpers/airlock/cyclelink_helper{
	dir = 8
	},
/turf/open/floor/iron/smooth_large,
/area/shuttle/escape/brig)
"XK" = (
/obj/machinery/computer/emergency_shuttle{
	dir = 4
	},
/turf/open/floor/iron/dark/small,
/area/shuttle/escape)
"Ya" = (
/turf/open/floor/catwalk_floor,
/area/shuttle/escape/brig)
"YI" = (
/obj/structure/drain,
/turf/open/floor/iron/lowered,
/area/shuttle/escape)
"YW" = (
/turf/open/floor/iron/diagonal,
/area/shuttle/escape)
"Zx" = (
/obj/structure/reagent_dispensers/fueltank,
/obj/effect/turf_decal/bot_red,
/obj/effect/turf_decal/siding/wideplating_new,
/turf/open/floor/iron/diagonal,
/area/shuttle/escape)
"ZV" = (
/obj/machinery/stasis,
/obj/effect/turf_decal/tile/blue/fourcorners,
/obj/structure/extinguisher_cabinet/directional/east,
/turf/open/floor/iron/white/small,
/area/shuttle/escape)

(1,1,1) = {"
ip
ip
ip
ip
ip
ip
ip
ip
xm
ew
xm
fU
xm
xm
eO
xm
xm
JF
xm
JF
xm
ip
ip
ip
"}
(2,1,1) = {"
ip
ip
ip
ip
ip
ip
ip
ip
eO
Ya
eO
nm
xm
eb
As
FA
xm
pW
eO
oi
eO
ip
ip
ip
"}
(3,1,1) = {"
ip
ip
ip
ip
ip
ip
VY
xm
xm
XE
xm
Br
xm
fC
VE
Xv
xm
Br
xm
Br
xm
xm
xm
ip
"}
(4,1,1) = {"
ip
ip
VY
eO
eO
xm
xm
Th
tR
Va
xm
Lb
xm
xm
QY
xm
xm
Ir
xm
aC
SL
Jr
xm
xm
"}
(5,1,1) = {"
ip
VY
xm
Ad
XK
hy
xm
EM
AA
Va
rL
Ir
Ir
Ir
Ir
Ir
Ir
Ga
xm
ns
YW
Ee
Tz
Lh
"}
(6,1,1) = {"
ip
xm
Vo
dN
aS
Oj
xm
MO
pr
Va
xm
tg
SM
Ng
Ng
Ng
JT
Ir
Ed
ns
YW
Zx
Tz
Lh
"}
(7,1,1) = {"
eO
eO
VU
pI
xq
ek
xm
xm
xm
uO
xm
Ir
xA
YI
HR
YI
HO
lf
xm
OV
Bc
ne
Tz
Lh
"}
(8,1,1) = {"
eO
Sq
QT
iu
iu
Ec
xm
qM
cw
VX
ST
Ir
xA
HR
HR
HR
HO
Ir
xm
xm
PU
xj
Tz
Lh
"}
(9,1,1) = {"
eO
Ex
TI
TP
TP
Ry
zH
Ir
Ir
xy
Ir
Ir
xA
HR
HR
HR
Ui
Ir
ie
xm
xm
xm
xm
xm
"}
(10,1,1) = {"
eO
VP
UA
GH
kB
TD
xm
xm
eO
xm
rA
xm
xm
YI
HR
YI
WT
Ir
xm
xm
HP
oF
Tz
Lh
"}
(11,1,1) = {"
eO
eO
Wd
Bn
hj
Wd
xm
iX
br
br
br
br
xm
yO
yO
FY
vk
Ir
xm
zU
rt
NP
Tz
Lh
"}
(12,1,1) = {"
ip
xm
FE
Rz
dV
uo
xm
Vl
sW
mY
co
br
gk
Ir
Ir
Ir
Ho
Ir
AD
NP
NP
NP
Tz
Lh
"}
(13,1,1) = {"
ip
VY
xm
TJ
TJ
tk
xm
do
Hw
Ul
BG
br
xm
xm
GC
xm
xm
xm
xm
oF
NP
qV
Tz
Lh
"}
(14,1,1) = {"
ip
ip
VY
eO
eO
xm
xm
uU
zw
Hw
kC
ol
xm
wK
II
vU
II
Os
xm
Po
cU
qV
xm
xm
"}
(15,1,1) = {"
ip
ip
ip
ip
ip
ip
VY
xm
xm
xn
xn
xn
xm
qj
II
ok
II
sX
xm
JF
xm
xm
xm
ip
"}
(16,1,1) = {"
ip
ip
ip
ip
ip
ip
ip
ip
eO
ZV
Og
nM
xm
II
II
II
II
II
xm
oi
eO
ip
ip
ip
"}
(17,1,1) = {"
ip
ip
ip
ip
ip
ip
ip
ip
xm
xm
eO
xm
xm
xm
kj
ds
ds
xm
xm
Br
xm
ip
ip
ip
"}
