//MAP CONVERTED BY dmm2tgm.py THIS HEADER COMMENT PREVENTS RECONVERSION, DO NOT REMOVE
"d" = (
/obj/machinery/power/shuttle_engine/heater,
/obj/structure/window/reinforced/spawner/directional/west{
	layer = 2.9
	},
/obj/structure/window/reinforced/spawner/directional/north{
	layer = 2.9
	},
/obj/structure/window/reinforced/spawner/directional/east{
	layer = 2.9
	},
/turf/open/floor/plating,
/area/shuttle/mining)
"h" = (
/obj/effect/spawner/structure/window/reinforced/shuttle,
/turf/open/floor/plating,
/area/shuttle/mining)
"i" = (
/turf/closed/wall/mineral/titanium,
/area/shuttle/mining)
"y" = (
/obj/structure/table,
/turf/open/floor/mineral/titanium/white,
/area/shuttle/mining)
"B" = (
/obj/machinery/power/shuttle_engine/propulsion,
/turf/open/floor/plating/airless,
/area/shuttle/mining)
"G" = (
/turf/open/floor/mineral/titanium/white,
/area/shuttle/mining)
"I" = (
/obj/structure/chair/comfy/shuttle,
/turf/open/floor/mineral/titanium/white,
/area/shuttle/mining)
"N" = (
/obj/effect/turf_decal/tile/brown{
	dir = 1
	},
/obj/effect/turf_decal/tile/brown,
/obj/effect/turf_decal/tile/brown{
	dir = 8
	},
/obj/effect/turf_decal/tile/brown{
	dir = 4
	},
/turf/open/floor/mineral/titanium/yellow,
/area/shuttle/mining)
"O" = (
/obj/machinery/door/airlock/titanium{
	name = "Mining Shuttle Airlock"
	},
/obj/docking_port/mobile{
	dir = 4;
	shuttle_id = "mining";
	name = "mining shuttle"
	},
/turf/open/floor/plating,
/area/shuttle/mining)
"R" = (
/obj/structure/chair/comfy/shuttle{
	dir = 1
	},
/turf/open/floor/mineral/titanium/white,
/area/shuttle/mining)
"T" = (
/obj/machinery/light/directional/east,
/obj/effect/turf_decal/tile/brown{
	dir = 1
	},
/obj/effect/turf_decal/tile/brown,
/obj/effect/turf_decal/tile/brown{
	dir = 8
	},
/obj/effect/turf_decal/tile/brown{
	dir = 4
	},
/turf/open/floor/mineral/titanium/yellow,
/area/shuttle/mining)
"W" = (
/obj/machinery/computer/shuttle/mining,
/turf/open/floor/mineral/titanium/white,
/area/shuttle/mining)

(1,1,1) = {"
i
i
h
O
h
i
i
"}
(2,1,1) = {"
h
I
N
N
N
y
i
"}
(3,1,1) = {"
h
W
R
N
G
d
B
"}
(4,1,1) = {"
h
I
N
T
N
G
i
"}
(5,1,1) = {"
i
i
h
i
h
i
i
"}
