//MAP CONVERTED BY dmm2tgm.py THIS HEADER COMMENT PREVENTS RECONVERSION, DO NOT REMOVE
"a" = (
/obj/effect/light_emitter/daylight,
/turf/open/moving/snow,
/area/trainstation/outdoor/rails)
"s" = (
/obj/effect/landmark/trainstation/object_spawner/trees,
/obj/effect/light_emitter/daylight,
/turf/open/moving/snow,
/area/trainstation/outdoor/rails)
"B" = (
/obj/effect/landmark/trainstation/object_spawner/grass,
/obj/effect/light_emitter/daylight,
/turf/open/moving/snow,
/area/trainstation/outdoor/rails)
"J" = (
/obj/effect/landmark/trainstation/object_spawner/bushes,
/obj/effect/light_emitter/daylight,
/turf/open/moving/snow,
/area/trainstation/outdoor/rails)
"Q" = (
/obj/effect/light_emitter/daylight,
/turf/closed/indestructible/train_border,
/area/trainstation/outdoor/rails)

(1,1,1) = {"
a
a
a
a
a
a
a
a
a
a
a
a
a
Q
"}
(2,1,1) = {"
a
a
a
a
a
a
a
a
a
a
a
a
a
Q
"}
(3,1,1) = {"
a
a
a
a
a
a
a
a
a
a
a
a
a
Q
"}
(4,1,1) = {"
a
a
a
a
a
a
a
a
a
a
a
a
a
Q
"}
(5,1,1) = {"
a
a
a
a
a
a
a
a
a
a
a
a
a
Q
"}
(6,1,1) = {"
a
a
a
a
a
a
a
a
a
a
a
a
a
Q
"}
(7,1,1) = {"
a
a
a
a
a
a
a
a
a
a
a
a
a
Q
"}
(8,1,1) = {"
a
a
a
a
a
a
a
a
a
a
a
a
a
Q
"}
(9,1,1) = {"
a
a
a
a
a
a
a
a
a
a
a
a
a
Q
"}
(10,1,1) = {"
a
a
a
a
a
a
a
a
a
a
a
a
a
Q
"}
(11,1,1) = {"
a
a
a
a
a
a
a
a
a
a
a
a
a
Q
"}
(12,1,1) = {"
a
a
a
a
a
a
a
a
a
a
a
a
a
Q
"}
(13,1,1) = {"
a
a
a
a
a
a
a
a
a
a
a
a
a
Q
"}
(14,1,1) = {"
a
a
a
a
a
a
a
a
a
a
a
a
a
Q
"}
(15,1,1) = {"
a
a
a
a
a
a
a
a
a
a
a
a
a
Q
"}
(16,1,1) = {"
a
a
a
a
a
a
a
a
a
a
a
a
a
Q
"}
(17,1,1) = {"
a
a
a
a
a
a
a
a
a
a
a
a
a
Q
"}
(18,1,1) = {"
a
a
a
a
a
a
a
a
a
a
a
a
a
Q
"}
(19,1,1) = {"
a
a
a
a
a
a
a
a
a
a
a
a
a
Q
"}
(20,1,1) = {"
a
a
a
a
a
a
a
a
a
a
a
a
a
Q
"}
(21,1,1) = {"
a
a
a
a
a
a
a
a
a
a
a
a
a
Q
"}
(22,1,1) = {"
a
a
a
a
a
a
a
a
a
a
a
a
a
Q
"}
(23,1,1) = {"
a
a
a
a
a
a
a
a
a
a
a
a
a
Q
"}
(24,1,1) = {"
a
a
a
a
a
a
a
a
a
a
a
a
a
Q
"}
(25,1,1) = {"
a
a
a
a
a
a
a
a
a
a
a
a
a
Q
"}
(26,1,1) = {"
a
a
a
a
a
a
a
a
a
a
a
a
a
Q
"}
(27,1,1) = {"
a
a
a
a
a
a
a
a
a
a
a
a
a
Q
"}
(28,1,1) = {"
a
a
a
a
a
a
a
a
a
a
a
a
a
Q
"}
(29,1,1) = {"
a
a
a
a
a
a
a
a
a
a
a
a
a
Q
"}
(30,1,1) = {"
a
a
a
a
a
a
a
a
a
a
a
a
a
Q
"}
(31,1,1) = {"
a
a
a
a
a
a
a
a
a
a
a
a
a
Q
"}
(32,1,1) = {"
a
a
a
a
a
a
a
a
a
a
a
a
a
Q
"}
(33,1,1) = {"
a
a
a
a
a
a
a
a
a
a
a
a
a
Q
"}
(34,1,1) = {"
a
a
a
a
a
a
a
a
a
a
a
a
a
Q
"}
(35,1,1) = {"
a
a
a
a
a
a
a
a
a
a
a
a
a
Q
"}
(36,1,1) = {"
a
a
a
a
a
a
a
a
a
a
a
a
a
Q
"}
(37,1,1) = {"
a
a
a
a
a
a
a
a
a
a
a
a
a
Q
"}
(38,1,1) = {"
a
a
a
a
a
a
a
a
a
a
a
a
a
Q
"}
(39,1,1) = {"
a
a
a
a
a
a
a
a
a
a
a
a
a
Q
"}
(40,1,1) = {"
a
a
a
a
a
a
a
a
a
a
a
a
a
Q
"}
(41,1,1) = {"
a
a
a
a
a
a
a
a
a
a
a
a
a
Q
"}
(42,1,1) = {"
a
a
a
a
a
a
a
a
a
a
a
a
a
Q
"}
(43,1,1) = {"
a
a
a
a
a
a
a
a
a
a
a
a
a
Q
"}
(44,1,1) = {"
a
a
a
a
a
a
a
a
a
a
a
a
a
Q
"}
(45,1,1) = {"
a
a
a
a
a
a
a
a
a
a
a
a
a
Q
"}
(46,1,1) = {"
a
a
a
a
a
a
a
a
a
a
a
a
a
Q
"}
(47,1,1) = {"
a
a
a
a
a
a
a
a
a
a
a
a
a
Q
"}
(48,1,1) = {"
a
a
a
a
a
a
a
a
a
a
a
a
a
Q
"}
(49,1,1) = {"
a
a
a
a
a
a
a
a
a
a
a
a
a
Q
"}
(50,1,1) = {"
a
a
a
a
a
a
a
a
a
a
a
a
a
Q
"}
(51,1,1) = {"
a
a
a
a
a
a
a
a
a
a
a
a
a
Q
"}
(52,1,1) = {"
a
a
a
a
a
a
a
a
a
a
a
a
a
Q
"}
(53,1,1) = {"
a
a
a
a
a
a
a
a
a
a
a
a
a
Q
"}
(54,1,1) = {"
a
a
a
a
a
a
a
a
a
a
a
a
a
Q
"}
(55,1,1) = {"
a
a
a
a
a
a
a
a
a
a
a
a
a
Q
"}
(56,1,1) = {"
a
a
a
a
a
a
a
a
a
a
a
a
a
Q
"}
(57,1,1) = {"
a
a
a
a
a
a
a
a
a
a
a
a
a
Q
"}
(58,1,1) = {"
a
a
a
a
a
a
a
a
a
a
a
a
a
Q
"}
(59,1,1) = {"
a
a
a
a
a
a
a
a
a
a
a
a
a
Q
"}
(60,1,1) = {"
a
a
a
a
a
a
a
a
a
a
a
a
a
Q
"}
(61,1,1) = {"
a
a
a
a
a
a
a
a
a
a
a
a
a
Q
"}
(62,1,1) = {"
a
a
a
a
a
a
a
a
a
a
a
a
a
Q
"}
(63,1,1) = {"
a
a
a
a
a
a
a
a
a
a
a
a
a
Q
"}
(64,1,1) = {"
a
a
a
a
a
a
a
a
a
a
a
a
a
Q
"}
(65,1,1) = {"
a
a
a
a
a
a
a
a
a
a
a
a
a
Q
"}
(66,1,1) = {"
a
a
a
a
a
a
a
a
a
a
a
a
a
Q
"}
(67,1,1) = {"
a
a
a
a
a
a
a
a
a
a
a
a
a
Q
"}
(68,1,1) = {"
a
a
a
a
a
a
a
a
a
a
a
a
a
Q
"}
(69,1,1) = {"
a
a
a
a
a
a
a
a
a
a
a
a
a
Q
"}
(70,1,1) = {"
a
a
a
a
a
a
a
a
a
a
a
a
a
Q
"}
(71,1,1) = {"
a
a
a
a
a
a
a
a
a
a
a
a
a
Q
"}
(72,1,1) = {"
a
a
a
a
a
a
a
a
a
a
a
a
a
Q
"}
(73,1,1) = {"
a
a
a
a
a
a
a
a
a
a
a
a
a
Q
"}
(74,1,1) = {"
a
a
a
a
a
a
a
a
a
a
a
a
a
Q
"}
(75,1,1) = {"
a
a
a
a
a
a
a
a
a
a
a
a
a
Q
"}
(76,1,1) = {"
a
a
a
a
a
a
a
a
a
a
a
a
a
Q
"}
(77,1,1) = {"
a
a
a
a
a
a
a
a
a
a
a
a
a
Q
"}
(78,1,1) = {"
a
a
a
a
a
a
a
a
a
a
a
a
a
Q
"}
(79,1,1) = {"
a
a
a
a
a
a
a
a
a
a
a
a
a
Q
"}
(80,1,1) = {"
a
a
a
a
a
a
a
a
a
a
a
a
a
Q
"}
(81,1,1) = {"
a
a
a
a
a
a
a
a
a
a
a
a
a
Q
"}
(82,1,1) = {"
a
a
a
a
a
a
a
a
a
a
a
a
a
Q
"}
(83,1,1) = {"
a
a
a
a
a
a
a
a
a
a
a
a
a
Q
"}
(84,1,1) = {"
a
a
a
a
a
a
a
a
a
a
a
a
a
Q
"}
(85,1,1) = {"
a
a
a
a
a
a
a
a
a
a
a
a
a
Q
"}
(86,1,1) = {"
a
a
a
a
a
a
a
a
a
a
a
a
a
Q
"}
(87,1,1) = {"
a
a
a
a
a
a
a
a
a
a
a
a
a
Q
"}
(88,1,1) = {"
a
a
a
a
a
a
a
a
a
a
a
a
a
Q
"}
(89,1,1) = {"
a
a
a
a
a
a
a
a
a
a
a
a
a
Q
"}
(90,1,1) = {"
a
a
a
a
a
a
a
a
a
a
a
a
a
Q
"}
(91,1,1) = {"
a
a
a
a
a
a
a
a
a
a
a
a
a
Q
"}
(92,1,1) = {"
a
a
a
a
a
a
a
a
a
a
a
a
a
Q
"}
(93,1,1) = {"
a
a
a
a
a
a
a
a
a
a
a
a
a
Q
"}
(94,1,1) = {"
a
a
a
a
a
a
a
a
a
a
a
a
a
Q
"}
(95,1,1) = {"
a
a
a
a
a
a
a
a
a
a
a
a
a
Q
"}
(96,1,1) = {"
a
a
a
a
a
a
a
a
a
a
a
a
a
Q
"}
(97,1,1) = {"
a
a
a
a
a
a
a
a
a
a
a
a
a
Q
"}
(98,1,1) = {"
a
a
a
a
a
a
a
a
a
a
a
a
a
Q
"}
(99,1,1) = {"
a
a
a
a
a
a
a
a
a
a
a
a
a
Q
"}
(100,1,1) = {"
a
a
a
a
a
a
a
a
a
a
a
a
a
Q
"}
(101,1,1) = {"
a
a
a
a
a
a
a
a
a
a
a
a
a
Q
"}
(102,1,1) = {"
a
a
a
a
a
a
a
a
a
a
a
a
a
Q
"}
(103,1,1) = {"
a
a
a
a
a
a
a
a
a
a
a
a
a
Q
"}
(104,1,1) = {"
a
a
a
a
a
a
a
a
a
a
a
a
a
Q
"}
(105,1,1) = {"
a
a
a
a
a
a
a
a
a
a
a
a
a
Q
"}
(106,1,1) = {"
a
a
a
a
a
a
a
a
a
a
a
a
a
Q
"}
(107,1,1) = {"
a
a
a
a
a
a
a
a
a
a
a
a
a
Q
"}
(108,1,1) = {"
a
a
a
a
a
a
a
a
a
a
a
a
a
Q
"}
(109,1,1) = {"
a
a
a
a
a
a
a
a
a
a
a
a
a
Q
"}
(110,1,1) = {"
a
a
a
a
a
a
a
a
a
a
a
a
a
Q
"}
(111,1,1) = {"
a
a
a
a
a
a
a
a
a
a
a
a
a
Q
"}
(112,1,1) = {"
a
a
a
a
a
a
a
a
a
a
a
a
a
Q
"}
(113,1,1) = {"
a
a
a
a
a
a
a
a
a
a
a
a
a
Q
"}
(114,1,1) = {"
a
a
a
a
a
a
a
a
a
a
a
a
a
Q
"}
(115,1,1) = {"
a
a
a
a
a
a
a
a
a
a
a
a
a
Q
"}
(116,1,1) = {"
a
a
a
a
a
a
a
a
a
a
a
a
a
Q
"}
(117,1,1) = {"
a
a
a
a
a
a
a
a
a
a
a
a
a
Q
"}
(118,1,1) = {"
a
a
a
a
a
a
a
a
a
a
a
a
a
Q
"}
(119,1,1) = {"
a
a
a
a
a
a
a
a
a
a
a
a
a
Q
"}
(120,1,1) = {"
a
a
a
a
a
a
a
a
a
a
a
a
a
Q
"}
(121,1,1) = {"
a
a
a
a
a
a
a
a
a
a
a
a
a
Q
"}
(122,1,1) = {"
a
a
a
a
a
a
a
a
a
a
a
a
a
Q
"}
(123,1,1) = {"
a
a
a
a
a
a
a
a
a
a
a
a
a
Q
"}
(124,1,1) = {"
a
a
a
a
a
a
a
a
a
a
a
a
a
Q
"}
(125,1,1) = {"
a
a
a
a
a
a
a
a
a
a
a
a
a
Q
"}
(126,1,1) = {"
a
a
a
a
a
a
a
a
a
a
a
a
a
Q
"}
(127,1,1) = {"
a
a
a
a
a
a
a
a
a
a
a
a
a
Q
"}
(128,1,1) = {"
a
a
a
a
a
a
a
a
a
a
a
a
a
Q
"}
(129,1,1) = {"
a
a
a
a
a
a
a
a
a
a
a
a
a
Q
"}
(130,1,1) = {"
a
a
a
a
a
a
a
a
a
a
a
a
a
Q
"}
(131,1,1) = {"
a
a
a
a
a
a
a
a
a
a
a
a
a
Q
"}
(132,1,1) = {"
a
a
a
a
a
a
a
a
a
a
a
a
a
Q
"}
(133,1,1) = {"
a
a
a
a
a
a
a
a
a
a
a
a
a
Q
"}
(134,1,1) = {"
a
a
a
a
a
a
a
a
a
a
a
a
a
Q
"}
(135,1,1) = {"
a
a
a
a
a
a
a
a
a
a
a
a
a
Q
"}
(136,1,1) = {"
a
a
a
a
a
a
a
a
a
a
a
a
a
Q
"}
(137,1,1) = {"
a
a
a
a
a
a
a
a
a
a
a
a
a
Q
"}
(138,1,1) = {"
a
a
a
a
a
a
a
a
a
a
a
a
a
Q
"}
(139,1,1) = {"
a
a
a
a
a
a
a
a
a
a
a
a
a
Q
"}
(140,1,1) = {"
a
a
a
a
a
a
a
a
a
a
a
a
a
Q
"}
(141,1,1) = {"
a
a
a
a
a
a
a
a
a
a
a
a
a
Q
"}
(142,1,1) = {"
a
a
a
a
a
a
a
a
a
a
a
a
a
Q
"}
(143,1,1) = {"
a
a
a
a
a
a
a
a
a
a
a
a
a
Q
"}
(144,1,1) = {"
a
a
a
a
a
a
a
a
a
a
a
a
a
Q
"}
(145,1,1) = {"
a
a
a
a
a
a
a
a
a
a
a
a
a
Q
"}
(146,1,1) = {"
a
a
a
a
a
a
a
a
a
a
a
a
a
Q
"}
(147,1,1) = {"
a
a
a
a
a
a
a
a
a
a
a
a
a
Q
"}
(148,1,1) = {"
a
a
a
a
a
a
a
a
a
a
a
a
a
Q
"}
(149,1,1) = {"
a
a
a
a
a
a
a
a
a
a
a
a
a
Q
"}
(150,1,1) = {"
a
a
a
a
a
a
a
a
a
a
a
a
a
Q
"}
(151,1,1) = {"
a
a
a
a
a
a
a
a
a
a
a
a
a
Q
"}
(152,1,1) = {"
a
a
a
a
a
a
a
a
a
a
a
a
a
Q
"}
(153,1,1) = {"
a
a
a
a
a
a
a
a
a
a
a
a
a
Q
"}
(154,1,1) = {"
a
a
a
a
a
a
a
a
a
a
a
a
a
Q
"}
(155,1,1) = {"
a
a
a
a
a
a
a
a
a
a
a
a
a
Q
"}
(156,1,1) = {"
a
a
a
a
a
a
a
a
a
a
a
a
a
Q
"}
(157,1,1) = {"
a
a
a
a
a
a
a
a
a
a
a
a
a
Q
"}
(158,1,1) = {"
a
a
a
a
a
a
a
a
a
a
a
a
a
Q
"}
(159,1,1) = {"
a
a
a
a
a
a
a
a
a
a
a
a
a
Q
"}
(160,1,1) = {"
a
a
a
a
a
a
a
a
a
a
a
a
a
Q
"}
(161,1,1) = {"
a
a
a
a
a
a
a
a
a
a
a
a
a
Q
"}
(162,1,1) = {"
a
a
a
a
a
a
a
a
a
a
a
a
a
Q
"}
(163,1,1) = {"
a
a
a
a
a
a
a
a
a
a
a
a
a
Q
"}
(164,1,1) = {"
a
a
a
a
a
a
a
a
a
a
a
a
a
Q
"}
(165,1,1) = {"
a
a
a
a
a
a
a
a
a
a
a
a
a
Q
"}
(166,1,1) = {"
a
a
a
a
a
a
a
a
a
a
a
a
a
Q
"}
(167,1,1) = {"
a
a
a
a
a
a
a
a
a
a
a
a
a
Q
"}
(168,1,1) = {"
a
a
a
a
a
a
a
a
a
a
a
a
a
Q
"}
(169,1,1) = {"
a
a
a
a
a
a
a
a
a
a
a
a
a
Q
"}
(170,1,1) = {"
a
a
a
a
a
a
a
a
a
a
a
a
a
Q
"}
(171,1,1) = {"
a
a
a
a
a
a
a
a
a
a
a
a
a
Q
"}
(172,1,1) = {"
a
a
a
a
a
a
a
a
a
a
a
a
a
Q
"}
(173,1,1) = {"
a
a
a
a
a
a
a
a
a
a
a
a
a
Q
"}
(174,1,1) = {"
a
a
a
a
a
a
a
a
a
a
a
a
a
Q
"}
(175,1,1) = {"
a
a
a
a
a
a
a
a
a
a
a
a
a
Q
"}
(176,1,1) = {"
a
a
a
a
a
a
a
a
a
a
a
a
a
Q
"}
(177,1,1) = {"
a
a
a
a
a
a
a
a
a
a
a
a
a
Q
"}
(178,1,1) = {"
a
a
a
a
a
a
a
a
a
a
a
a
a
Q
"}
(179,1,1) = {"
a
a
a
a
a
a
a
a
a
a
a
a
a
Q
"}
(180,1,1) = {"
a
a
a
a
a
a
a
a
a
a
a
a
a
Q
"}
(181,1,1) = {"
a
a
a
a
a
a
a
a
a
a
a
a
a
Q
"}
(182,1,1) = {"
a
a
a
a
a
a
a
a
a
a
a
a
a
Q
"}
(183,1,1) = {"
a
a
a
a
a
a
a
a
a
a
a
a
a
Q
"}
(184,1,1) = {"
a
a
a
a
a
a
a
a
a
a
a
a
a
Q
"}
(185,1,1) = {"
a
a
a
a
a
a
a
a
a
a
a
a
a
Q
"}
(186,1,1) = {"
a
a
a
a
a
a
a
a
a
a
a
a
a
Q
"}
(187,1,1) = {"
a
a
a
a
a
a
a
a
a
a
a
a
a
Q
"}
(188,1,1) = {"
a
a
a
a
a
a
a
a
a
a
a
a
a
Q
"}
(189,1,1) = {"
a
a
a
a
a
a
a
a
a
a
a
a
a
Q
"}
(190,1,1) = {"
a
a
a
a
a
a
a
a
a
a
a
a
a
Q
"}
(191,1,1) = {"
a
a
a
a
a
a
a
a
a
a
a
a
a
Q
"}
(192,1,1) = {"
a
a
a
a
a
a
a
a
a
a
a
a
a
Q
"}
(193,1,1) = {"
a
a
a
a
a
a
a
a
a
a
a
a
a
Q
"}
(194,1,1) = {"
a
a
a
a
a
a
a
a
a
a
a
a
a
Q
"}
(195,1,1) = {"
a
a
a
a
a
a
a
a
a
a
a
a
a
Q
"}
(196,1,1) = {"
a
a
a
a
a
a
a
a
a
a
a
a
a
Q
"}
(197,1,1) = {"
a
a
a
a
a
a
a
a
a
a
a
a
a
Q
"}
(198,1,1) = {"
a
a
a
a
a
a
a
a
a
a
a
a
a
Q
"}
(199,1,1) = {"
a
a
a
a
a
a
a
a
a
a
a
a
a
Q
"}
(200,1,1) = {"
a
a
a
a
a
a
a
a
a
a
a
a
a
Q
"}
(201,1,1) = {"
a
a
a
a
a
a
a
a
a
a
a
a
a
Q
"}
(202,1,1) = {"
a
a
a
a
a
a
a
a
a
a
a
a
a
Q
"}
(203,1,1) = {"
a
a
a
a
a
a
a
a
a
a
a
a
a
Q
"}
(204,1,1) = {"
a
a
a
a
a
a
a
a
a
a
a
a
a
Q
"}
(205,1,1) = {"
a
a
a
a
a
a
a
a
a
a
a
a
a
Q
"}
(206,1,1) = {"
a
a
a
a
a
a
a
a
a
a
a
a
a
Q
"}
(207,1,1) = {"
a
a
a
a
a
a
a
a
a
a
a
a
a
Q
"}
(208,1,1) = {"
a
a
a
a
a
a
a
a
a
a
a
a
a
Q
"}
(209,1,1) = {"
a
a
a
a
a
a
a
a
a
a
a
a
a
Q
"}
(210,1,1) = {"
a
a
a
a
a
a
a
a
a
a
a
a
a
Q
"}
(211,1,1) = {"
a
a
a
a
a
a
a
a
a
a
a
a
a
Q
"}
(212,1,1) = {"
a
a
a
a
a
a
a
a
a
a
a
a
a
Q
"}
(213,1,1) = {"
a
a
a
a
a
a
a
a
a
a
a
a
a
Q
"}
(214,1,1) = {"
a
a
a
a
a
a
a
a
a
a
a
a
a
Q
"}
(215,1,1) = {"
a
a
a
a
a
a
a
a
a
a
a
a
a
Q
"}
(216,1,1) = {"
a
a
a
a
a
a
a
a
a
a
a
a
a
Q
"}
(217,1,1) = {"
a
a
a
a
a
a
a
a
a
a
a
a
a
Q
"}
(218,1,1) = {"
a
a
a
a
a
a
a
a
a
a
a
a
a
Q
"}
(219,1,1) = {"
a
a
a
a
a
a
a
a
a
a
a
a
a
Q
"}
(220,1,1) = {"
a
a
a
a
a
a
a
a
a
a
a
a
a
Q
"}
(221,1,1) = {"
a
a
a
a
a
a
a
a
a
a
a
a
a
Q
"}
(222,1,1) = {"
a
a
a
a
a
a
a
a
a
a
a
a
a
Q
"}
(223,1,1) = {"
a
a
a
a
a
a
a
a
a
a
a
a
a
Q
"}
(224,1,1) = {"
a
a
a
a
a
a
a
a
a
a
a
a
a
Q
"}
(225,1,1) = {"
a
a
a
a
a
a
a
a
a
a
a
a
a
Q
"}
(226,1,1) = {"
a
a
a
a
a
a
a
a
a
a
a
a
a
Q
"}
(227,1,1) = {"
a
a
a
a
a
a
a
a
a
a
a
a
a
Q
"}
(228,1,1) = {"
a
a
a
a
a
a
a
a
a
a
a
a
a
Q
"}
(229,1,1) = {"
a
a
a
a
a
a
a
a
a
a
a
a
a
Q
"}
(230,1,1) = {"
a
a
a
a
a
a
a
a
a
a
a
a
a
Q
"}
(231,1,1) = {"
a
a
a
a
a
a
a
a
a
a
a
a
a
Q
"}
(232,1,1) = {"
a
a
a
a
a
a
a
a
a
a
a
a
a
Q
"}
(233,1,1) = {"
a
a
a
a
a
a
a
a
a
a
a
a
a
Q
"}
(234,1,1) = {"
a
a
a
a
a
a
a
a
a
a
a
a
a
Q
"}
(235,1,1) = {"
a
a
a
a
a
a
a
a
a
a
a
a
a
Q
"}
(236,1,1) = {"
a
a
a
a
a
a
a
a
a
a
a
a
a
Q
"}
(237,1,1) = {"
a
a
a
a
a
a
a
a
a
a
a
a
a
Q
"}
(238,1,1) = {"
a
a
a
a
a
a
a
a
a
a
a
a
a
Q
"}
(239,1,1) = {"
a
a
a
a
a
a
a
a
a
a
a
a
a
Q
"}
(240,1,1) = {"
a
a
a
a
a
a
a
a
a
a
a
a
a
Q
"}
(241,1,1) = {"
a
a
a
a
a
a
a
a
a
a
a
a
a
Q
"}
(242,1,1) = {"
a
a
a
a
a
a
a
a
a
a
a
a
a
Q
"}
(243,1,1) = {"
a
a
a
a
a
a
a
a
a
a
a
a
a
Q
"}
(244,1,1) = {"
a
a
a
a
a
a
a
a
a
a
a
a
a
Q
"}
(245,1,1) = {"
a
a
a
a
a
a
a
a
a
a
a
a
a
Q
"}
(246,1,1) = {"
a
a
a
a
a
a
a
a
a
a
a
a
a
Q
"}
(247,1,1) = {"
a
a
a
a
a
a
a
a
a
a
a
a
a
Q
"}
(248,1,1) = {"
a
a
a
a
a
a
a
a
a
a
a
a
a
Q
"}
(249,1,1) = {"
a
a
a
a
a
a
a
a
a
a
a
a
a
Q
"}
(250,1,1) = {"
a
a
a
a
a
a
a
a
a
a
a
a
a
Q
"}
(251,1,1) = {"
a
a
a
a
a
a
a
a
a
a
a
a
a
Q
"}
(252,1,1) = {"
a
a
s
a
a
a
a
a
a
a
a
a
a
Q
"}
(253,1,1) = {"
a
a
a
a
B
a
a
a
a
B
a
a
a
Q
"}
(254,1,1) = {"
a
a
a
J
a
a
a
J
a
a
a
a
a
Q
"}
(255,1,1) = {"
a
a
a
a
a
a
a
a
a
a
a
a
a
Q
"}
