//MAP CONVERTED BY dmm2tgm.py THIS HEADER COMMENT PREVENTS RECONVERSION, DO NOT REMOVE
"a" = (
/turf/open/moving/snow,
/area/trainstation/outdoor/rails)
"p" = (
/obj/effect/landmark/trainstation/object_spawner/low_chance,
/turf/open/moving/snow,
/area/trainstation/outdoor/rails)
"t" = (
/obj/effect/landmark/trainstation/object_spawner/very_low_chance,
/turf/open/moving/snow,
/area/trainstation/outdoor/rails)
"A" = (
/obj/effect/landmark/trainstation/object_spawner,
/turf/open/moving/snow,
/area/trainstation/outdoor/rails)
"B" = (
/turf/closed/indestructible/train_border,
/area/trainstation/outdoor/rails)
"J" = (
/turf/open/moving/snow/fake/dense,
/area/trainstation/outdoor/rails)

(1,1,1) = {"
a
a
a
a
a
a
a
a
a
a
a
a
a
a
a
J
J
J
J
J
J
J
J
J
B
"}
(2,1,1) = {"
a
a
a
a
a
a
a
a
a
a
a
a
a
a
a
J
J
J
J
J
J
J
J
J
B
"}
(3,1,1) = {"
a
a
a
a
a
a
a
a
a
a
a
a
a
a
a
J
J
J
J
J
J
J
J
J
B
"}
(4,1,1) = {"
a
a
a
a
a
a
a
a
a
a
a
a
a
a
a
J
J
J
J
J
J
J
J
J
B
"}
(5,1,1) = {"
a
a
a
a
a
a
a
a
a
a
a
a
a
a
a
J
J
J
J
J
J
J
J
J
B
"}
(6,1,1) = {"
a
a
a
a
a
a
a
a
a
a
a
a
a
a
a
J
J
J
J
J
J
J
J
J
B
"}
(7,1,1) = {"
a
a
a
a
a
a
a
a
a
a
a
a
a
a
a
J
J
J
J
J
J
J
J
J
B
"}
(8,1,1) = {"
a
a
a
a
a
a
a
a
a
a
a
a
a
a
a
J
J
J
J
J
J
J
J
J
B
"}
(9,1,1) = {"
a
a
a
a
a
a
a
a
a
a
a
a
a
a
a
J
J
J
J
J
J
J
J
J
B
"}
(10,1,1) = {"
a
a
a
a
a
a
a
a
a
a
a
a
a
a
a
J
J
J
J
J
J
J
J
J
B
"}
(11,1,1) = {"
a
a
a
a
a
a
a
a
a
a
a
a
a
a
a
J
J
J
J
J
J
J
J
J
B
"}
(12,1,1) = {"
a
a
a
a
a
a
a
a
a
a
a
a
a
a
a
J
J
J
J
J
J
J
J
J
B
"}
(13,1,1) = {"
a
a
a
a
a
a
a
a
a
a
a
a
a
a
a
J
J
J
J
J
J
J
J
J
B
"}
(14,1,1) = {"
a
a
a
a
a
a
a
a
a
a
a
a
a
a
a
J
J
J
J
J
J
J
J
J
B
"}
(15,1,1) = {"
a
a
a
a
a
a
a
a
a
a
a
a
a
a
a
J
J
J
J
J
J
J
J
J
B
"}
(16,1,1) = {"
a
a
a
a
a
a
a
a
a
a
a
a
a
a
a
J
J
J
J
J
J
J
J
J
B
"}
(17,1,1) = {"
a
a
a
a
a
a
a
a
a
a
a
a
a
a
a
J
J
J
J
J
J
J
J
J
B
"}
(18,1,1) = {"
a
a
a
a
a
a
a
a
a
a
a
a
a
a
a
J
J
J
J
J
J
J
J
J
B
"}
(19,1,1) = {"
a
a
a
a
a
a
a
a
a
a
a
a
a
a
a
J
J
J
J
J
J
J
J
J
B
"}
(20,1,1) = {"
a
a
a
a
a
a
a
a
a
a
a
a
a
a
a
J
J
J
J
J
J
J
J
J
B
"}
(21,1,1) = {"
a
a
a
a
a
a
a
a
a
a
a
a
a
a
a
J
J
J
J
J
J
J
J
J
B
"}
(22,1,1) = {"
a
a
a
a
a
a
a
a
a
a
a
a
a
a
a
J
J
J
J
J
J
J
J
J
B
"}
(23,1,1) = {"
a
a
a
a
a
a
a
a
a
a
a
a
a
a
a
J
J
J
J
J
J
J
J
J
B
"}
(24,1,1) = {"
a
a
a
a
a
a
a
a
a
a
a
a
a
a
a
J
J
J
J
J
J
J
J
J
B
"}
(25,1,1) = {"
a
a
a
a
a
a
a
a
a
a
a
a
a
a
a
J
J
J
J
J
J
J
J
J
B
"}
(26,1,1) = {"
a
a
a
a
a
a
a
a
a
a
a
a
a
a
a
J
J
J
J
J
J
J
J
J
B
"}
(27,1,1) = {"
a
a
a
a
a
a
a
a
a
a
a
a
a
a
a
J
J
J
J
J
J
J
J
J
B
"}
(28,1,1) = {"
a
a
a
a
a
a
a
a
a
a
a
a
a
a
a
J
J
J
J
J
J
J
J
J
B
"}
(29,1,1) = {"
a
a
a
a
a
a
a
a
a
a
a
a
a
a
a
J
J
J
J
J
J
J
J
J
B
"}
(30,1,1) = {"
a
a
a
a
a
a
a
a
a
a
a
a
a
a
a
J
J
J
J
J
J
J
J
J
B
"}
(31,1,1) = {"
a
a
a
a
a
a
a
a
a
a
a
a
a
a
a
J
J
J
J
J
J
J
J
J
B
"}
(32,1,1) = {"
a
a
a
a
a
a
a
a
a
a
a
a
a
a
a
J
J
J
J
J
J
J
J
J
B
"}
(33,1,1) = {"
a
a
a
a
a
a
a
a
a
a
a
a
a
a
a
J
J
J
J
J
J
J
J
J
B
"}
(34,1,1) = {"
a
a
a
a
a
a
a
a
a
a
a
a
a
a
a
J
J
J
J
J
J
J
J
J
B
"}
(35,1,1) = {"
a
a
a
a
a
a
a
a
a
a
a
a
a
a
a
J
J
J
J
J
J
J
J
J
B
"}
(36,1,1) = {"
a
a
a
a
a
a
a
a
a
a
a
a
a
a
a
J
J
J
J
J
J
J
J
J
B
"}
(37,1,1) = {"
a
a
a
a
a
a
a
a
a
a
a
a
a
a
a
J
J
J
J
J
J
J
J
J
B
"}
(38,1,1) = {"
a
a
a
a
a
a
a
a
a
a
a
a
a
a
a
J
J
J
J
J
J
J
J
J
B
"}
(39,1,1) = {"
a
a
a
a
a
a
a
a
a
a
a
a
a
a
a
J
J
J
J
J
J
J
J
J
B
"}
(40,1,1) = {"
a
a
a
a
a
a
a
a
a
a
a
a
a
a
a
J
J
J
J
J
J
J
J
J
B
"}
(41,1,1) = {"
a
a
a
a
a
a
a
a
a
a
a
a
a
a
a
J
J
J
J
J
J
J
J
J
B
"}
(42,1,1) = {"
a
a
a
a
a
a
a
a
a
a
a
a
a
a
a
J
J
J
J
J
J
J
J
J
B
"}
(43,1,1) = {"
a
a
a
a
a
a
a
a
a
a
a
a
a
a
a
J
J
J
J
J
J
J
J
J
B
"}
(44,1,1) = {"
a
a
a
a
a
a
a
a
a
a
a
a
a
a
a
J
J
J
J
J
J
J
J
J
B
"}
(45,1,1) = {"
a
a
a
a
a
a
a
a
a
a
a
a
a
a
a
J
J
J
J
J
J
J
J
J
B
"}
(46,1,1) = {"
a
a
a
a
a
a
a
a
a
a
a
a
a
a
a
J
J
J
J
J
J
J
J
J
B
"}
(47,1,1) = {"
a
a
a
a
a
a
a
a
a
a
a
a
a
a
a
J
J
J
J
J
J
J
J
J
B
"}
(48,1,1) = {"
a
a
a
a
a
a
a
a
a
a
a
a
a
a
a
J
J
J
J
J
J
J
J
J
B
"}
(49,1,1) = {"
a
a
a
a
a
a
a
a
a
a
a
a
a
a
a
J
J
J
J
J
J
J
J
J
B
"}
(50,1,1) = {"
a
a
a
a
a
a
a
a
a
a
a
a
a
a
a
J
J
J
J
J
J
J
J
J
B
"}
(51,1,1) = {"
a
a
a
a
a
a
a
a
a
a
a
a
a
a
a
J
J
J
J
J
J
J
J
J
B
"}
(52,1,1) = {"
a
a
a
a
a
a
a
a
a
a
a
a
a
a
a
J
J
J
J
J
J
J
J
J
B
"}
(53,1,1) = {"
a
a
a
a
a
a
a
a
a
a
a
a
a
a
a
J
J
J
J
J
J
J
J
J
B
"}
(54,1,1) = {"
a
a
a
a
a
a
a
a
a
a
a
a
a
a
a
J
J
J
J
J
J
J
J
J
B
"}
(55,1,1) = {"
a
a
a
a
a
a
a
a
a
a
a
a
a
a
a
J
J
J
J
J
J
J
J
J
B
"}
(56,1,1) = {"
a
a
a
a
a
a
a
a
a
a
a
a
a
a
a
J
J
J
J
J
J
J
J
J
B
"}
(57,1,1) = {"
a
a
a
a
a
a
a
a
a
a
a
a
a
a
a
J
J
J
J
J
J
J
J
J
B
"}
(58,1,1) = {"
a
a
a
a
a
a
a
a
a
a
a
a
a
a
a
J
J
J
J
J
J
J
J
J
B
"}
(59,1,1) = {"
a
a
a
a
a
a
a
a
a
a
a
a
a
a
a
J
J
J
J
J
J
J
J
J
B
"}
(60,1,1) = {"
a
a
a
a
a
a
a
a
a
a
a
a
a
a
a
J
J
J
J
J
J
J
J
J
B
"}
(61,1,1) = {"
a
a
a
a
a
a
a
a
a
a
a
a
a
a
a
J
J
J
J
J
J
J
J
J
B
"}
(62,1,1) = {"
a
a
a
a
a
a
a
a
a
a
a
a
a
a
a
J
J
J
J
J
J
J
J
J
B
"}
(63,1,1) = {"
a
a
a
a
a
a
a
a
a
a
a
a
a
a
a
J
J
J
J
J
J
J
J
J
B
"}
(64,1,1) = {"
a
a
a
a
a
a
a
a
a
a
a
a
a
a
a
J
J
J
J
J
J
J
J
J
B
"}
(65,1,1) = {"
a
a
a
a
a
a
a
a
a
a
a
a
a
a
a
J
J
J
J
J
J
J
J
J
B
"}
(66,1,1) = {"
a
a
a
a
a
a
a
a
a
a
a
a
a
a
a
J
J
J
J
J
J
J
J
J
B
"}
(67,1,1) = {"
a
a
a
a
a
a
a
a
a
a
a
a
a
a
a
J
J
J
J
J
J
J
J
J
B
"}
(68,1,1) = {"
a
a
a
a
a
a
a
a
a
a
a
a
a
a
a
J
J
J
J
J
J
J
J
J
B
"}
(69,1,1) = {"
a
a
a
a
a
a
a
a
a
a
a
a
a
a
a
J
J
J
J
J
J
J
J
J
B
"}
(70,1,1) = {"
a
a
a
a
a
a
a
a
a
a
a
a
a
a
a
J
J
J
J
J
J
J
J
J
B
"}
(71,1,1) = {"
a
a
a
a
a
a
a
a
a
a
a
a
a
a
a
J
J
J
J
J
J
J
J
J
B
"}
(72,1,1) = {"
a
a
a
a
a
a
a
a
a
a
a
a
a
a
a
J
J
J
J
J
J
J
J
J
B
"}
(73,1,1) = {"
a
a
a
a
a
a
a
a
a
a
a
a
a
a
a
J
J
J
J
J
J
J
J
J
B
"}
(74,1,1) = {"
a
a
a
a
a
a
a
a
a
a
a
a
a
a
a
J
J
J
J
J
J
J
J
J
B
"}
(75,1,1) = {"
a
a
a
a
a
a
a
a
a
a
a
a
a
a
a
J
J
J
J
J
J
J
J
J
B
"}
(76,1,1) = {"
a
a
a
a
a
a
a
a
a
a
a
a
a
a
a
J
J
J
J
J
J
J
J
J
B
"}
(77,1,1) = {"
a
a
a
a
a
a
a
a
a
a
a
a
a
a
a
J
J
J
J
J
J
J
J
J
B
"}
(78,1,1) = {"
a
a
a
a
a
a
a
a
a
a
a
a
a
a
a
J
J
J
J
J
J
J
J
J
B
"}
(79,1,1) = {"
a
a
a
a
a
a
a
a
a
a
a
a
a
a
a
J
J
J
J
J
J
J
J
J
B
"}
(80,1,1) = {"
a
a
a
a
a
a
a
a
a
a
a
a
a
a
a
J
J
J
J
J
J
J
J
J
B
"}
(81,1,1) = {"
a
a
a
a
a
a
a
a
a
a
a
a
a
a
a
J
J
J
J
J
J
J
J
J
B
"}
(82,1,1) = {"
a
a
a
a
a
a
a
a
a
a
a
a
a
a
a
J
J
J
J
J
J
J
J
J
B
"}
(83,1,1) = {"
a
a
a
a
a
a
a
a
a
a
a
a
a
a
a
J
J
J
J
J
J
J
J
J
B
"}
(84,1,1) = {"
a
a
a
a
a
a
a
a
a
a
a
a
a
a
a
J
J
J
J
J
J
J
J
J
B
"}
(85,1,1) = {"
a
a
a
a
a
a
a
a
a
a
a
a
a
a
a
J
J
J
J
J
J
J
J
J
B
"}
(86,1,1) = {"
a
a
a
a
a
a
a
a
a
a
a
a
a
a
a
J
J
J
J
J
J
J
J
J
B
"}
(87,1,1) = {"
a
a
a
a
a
a
a
a
a
a
a
a
a
a
a
J
J
J
J
J
J
J
J
J
B
"}
(88,1,1) = {"
a
a
a
a
a
a
a
a
a
a
a
a
a
a
a
J
J
J
J
J
J
J
J
J
B
"}
(89,1,1) = {"
a
a
a
a
a
a
a
a
a
a
a
a
a
a
a
J
J
J
J
J
J
J
J
J
B
"}
(90,1,1) = {"
a
a
a
a
a
a
a
a
a
a
a
a
a
a
a
J
J
J
J
J
J
J
J
J
B
"}
(91,1,1) = {"
a
a
a
a
a
a
a
a
a
a
a
a
a
a
a
J
J
J
J
J
J
J
J
J
B
"}
(92,1,1) = {"
a
a
a
a
a
a
a
a
a
a
a
a
a
a
a
J
J
J
J
J
J
J
J
J
B
"}
(93,1,1) = {"
a
a
a
a
a
a
a
a
a
a
a
a
a
a
a
J
J
J
J
J
J
J
J
J
B
"}
(94,1,1) = {"
a
a
a
a
a
a
a
a
a
a
a
a
a
a
a
J
J
J
J
J
J
J
J
J
B
"}
(95,1,1) = {"
a
a
a
a
a
a
a
a
a
a
a
a
a
a
a
J
J
J
J
J
J
J
J
J
B
"}
(96,1,1) = {"
a
a
a
a
a
a
a
a
a
a
a
a
a
a
a
J
J
J
J
J
J
J
J
J
B
"}
(97,1,1) = {"
a
a
a
a
a
a
a
a
a
a
a
a
a
a
a
J
J
J
J
J
J
J
J
J
B
"}
(98,1,1) = {"
a
a
a
a
a
a
a
a
a
a
a
a
a
a
a
J
J
J
J
J
J
J
J
J
B
"}
(99,1,1) = {"
a
a
a
a
a
a
a
a
a
a
a
a
a
a
a
J
J
J
J
J
J
J
J
J
B
"}
(100,1,1) = {"
a
a
a
a
a
a
a
a
a
a
a
a
a
a
a
J
J
J
J
J
J
J
J
J
B
"}
(101,1,1) = {"
a
a
a
a
a
a
a
a
a
a
a
a
a
a
a
J
J
J
J
J
J
J
J
J
B
"}
(102,1,1) = {"
a
a
a
a
a
a
a
a
a
a
a
a
a
a
a
J
J
J
J
J
J
J
J
J
B
"}
(103,1,1) = {"
a
a
a
a
a
a
a
a
a
a
a
a
a
a
a
J
J
J
J
J
J
J
J
J
B
"}
(104,1,1) = {"
a
a
a
a
a
a
a
a
a
a
a
a
a
a
a
J
J
J
J
J
J
J
J
J
B
"}
(105,1,1) = {"
a
a
a
a
a
a
a
a
a
a
a
a
a
a
a
J
J
J
J
J
J
J
J
J
B
"}
(106,1,1) = {"
a
a
a
a
a
a
a
a
a
a
a
a
a
a
a
J
J
J
J
J
J
J
J
J
B
"}
(107,1,1) = {"
a
a
a
a
a
a
a
a
a
a
a
a
a
a
a
J
J
J
J
J
J
J
J
J
B
"}
(108,1,1) = {"
a
a
a
a
a
a
a
a
a
a
a
a
a
a
a
J
J
J
J
J
J
J
J
J
B
"}
(109,1,1) = {"
a
a
a
a
a
a
a
a
a
a
a
a
a
a
a
J
J
J
J
J
J
J
J
J
B
"}
(110,1,1) = {"
a
a
a
a
a
a
a
a
a
a
a
a
a
a
a
J
J
J
J
J
J
J
J
J
B
"}
(111,1,1) = {"
a
a
a
a
a
a
a
a
a
a
a
a
a
a
a
J
J
J
J
J
J
J
J
J
B
"}
(112,1,1) = {"
a
a
a
a
a
a
a
a
a
a
a
a
a
a
a
J
J
J
J
J
J
J
J
J
B
"}
(113,1,1) = {"
a
a
a
a
a
a
a
a
a
a
a
a
a
a
a
J
J
J
J
J
J
J
J
J
B
"}
(114,1,1) = {"
a
a
a
a
a
a
a
a
a
a
a
a
a
a
a
J
J
J
J
J
J
J
J
J
B
"}
(115,1,1) = {"
a
a
a
a
a
a
a
a
a
a
a
a
a
a
a
J
J
J
J
J
J
J
J
J
B
"}
(116,1,1) = {"
a
a
a
a
a
a
a
a
a
a
a
a
a
a
a
J
J
J
J
J
J
J
J
J
B
"}
(117,1,1) = {"
a
a
a
a
a
a
a
a
a
a
a
a
a
a
a
J
J
J
J
J
J
J
J
J
B
"}
(118,1,1) = {"
a
a
a
a
a
a
a
a
a
a
a
a
a
a
a
J
J
J
J
J
J
J
J
J
B
"}
(119,1,1) = {"
a
a
a
a
a
a
a
a
a
a
a
a
a
a
a
J
J
J
J
J
J
J
J
J
B
"}
(120,1,1) = {"
a
a
a
a
a
a
a
a
a
a
a
a
a
a
a
J
J
J
J
J
J
J
J
J
B
"}
(121,1,1) = {"
a
a
a
a
a
a
a
a
a
a
a
a
a
a
a
J
J
J
J
J
J
J
J
J
B
"}
(122,1,1) = {"
a
a
a
a
a
a
a
a
a
a
a
a
a
a
a
J
J
J
J
J
J
J
J
J
B
"}
(123,1,1) = {"
a
a
a
a
a
a
a
a
a
a
a
a
a
a
a
J
J
J
J
J
J
J
J
J
B
"}
(124,1,1) = {"
a
a
a
a
a
a
a
a
a
a
a
a
a
a
a
J
J
J
J
J
J
J
J
J
B
"}
(125,1,1) = {"
a
a
a
a
a
a
a
a
a
a
a
a
a
a
a
J
J
J
J
J
J
J
J
J
B
"}
(126,1,1) = {"
a
a
a
a
a
a
a
a
a
a
a
a
a
a
a
J
J
J
J
J
J
J
J
J
B
"}
(127,1,1) = {"
a
a
a
a
a
a
a
a
a
a
a
a
a
a
a
J
J
J
J
J
J
J
J
J
B
"}
(128,1,1) = {"
a
a
a
a
a
a
a
a
a
a
a
a
a
a
a
J
J
J
J
J
J
J
J
J
B
"}
(129,1,1) = {"
a
a
a
a
a
a
a
a
a
a
a
a
a
a
a
J
J
J
J
J
J
J
J
J
B
"}
(130,1,1) = {"
a
a
a
a
a
a
a
a
a
a
a
a
a
a
a
J
J
J
J
J
J
J
J
J
B
"}
(131,1,1) = {"
a
a
a
a
a
a
a
a
a
a
a
a
a
a
a
J
J
J
J
J
J
J
J
J
B
"}
(132,1,1) = {"
a
a
a
a
a
a
a
a
a
a
a
a
a
a
a
J
J
J
J
J
J
J
J
J
B
"}
(133,1,1) = {"
a
a
a
a
a
a
a
a
a
a
a
a
a
a
a
J
J
J
J
J
J
J
J
J
B
"}
(134,1,1) = {"
a
a
a
a
a
a
a
a
a
a
a
a
a
a
a
J
J
J
J
J
J
J
J
J
B
"}
(135,1,1) = {"
a
a
a
a
a
a
a
a
a
a
a
a
a
a
a
J
J
J
J
J
J
J
J
J
B
"}
(136,1,1) = {"
a
a
a
a
a
a
a
a
a
a
a
a
a
a
a
J
J
J
J
J
J
J
J
J
B
"}
(137,1,1) = {"
a
a
a
a
a
a
a
a
a
a
a
a
a
a
a
J
J
J
J
J
J
J
J
J
B
"}
(138,1,1) = {"
a
a
a
a
a
a
a
a
a
a
a
a
a
a
a
J
J
J
J
J
J
J
J
J
B
"}
(139,1,1) = {"
a
a
a
a
a
a
a
a
a
a
a
a
a
a
a
J
J
J
J
J
J
J
J
J
B
"}
(140,1,1) = {"
a
a
a
a
a
a
a
a
a
a
a
a
a
a
a
J
J
J
J
J
J
J
J
J
B
"}
(141,1,1) = {"
a
a
a
a
a
a
a
a
a
a
a
a
a
a
a
J
J
J
J
J
J
J
J
J
B
"}
(142,1,1) = {"
a
a
a
a
a
a
a
a
a
a
a
a
a
a
a
J
J
J
J
J
J
J
J
J
B
"}
(143,1,1) = {"
a
a
a
a
a
a
a
a
a
a
a
a
a
a
a
J
J
J
J
J
J
J
J
J
B
"}
(144,1,1) = {"
a
a
a
a
a
a
a
a
a
a
a
a
a
a
a
J
J
J
J
J
J
J
J
J
B
"}
(145,1,1) = {"
a
a
a
a
a
a
a
a
a
a
a
a
a
a
a
J
J
J
J
J
J
J
J
J
B
"}
(146,1,1) = {"
a
a
a
a
a
a
a
a
a
a
a
a
a
a
a
J
J
J
J
J
J
J
J
J
B
"}
(147,1,1) = {"
a
a
a
a
a
a
a
a
a
a
a
a
a
a
a
J
J
J
J
J
J
J
J
J
B
"}
(148,1,1) = {"
a
a
a
a
a
a
a
a
a
a
a
a
a
a
a
J
J
J
J
J
J
J
J
J
B
"}
(149,1,1) = {"
a
a
a
a
a
a
a
a
a
a
a
a
a
a
a
J
J
J
J
J
J
J
J
J
B
"}
(150,1,1) = {"
a
a
a
a
a
a
a
a
a
a
a
a
a
a
a
J
J
J
J
J
J
J
J
J
B
"}
(151,1,1) = {"
a
a
a
a
a
a
a
a
a
a
a
a
a
a
a
J
J
J
J
J
J
J
J
J
B
"}
(152,1,1) = {"
a
a
a
a
a
a
a
a
a
a
a
a
a
a
a
J
J
J
J
J
J
J
J
J
B
"}
(153,1,1) = {"
a
a
a
a
a
a
a
a
a
a
a
a
a
a
a
J
J
J
J
J
J
J
J
J
B
"}
(154,1,1) = {"
a
a
a
a
a
a
a
a
a
a
a
a
a
a
a
J
J
J
J
J
J
J
J
J
B
"}
(155,1,1) = {"
a
a
a
a
a
a
a
a
a
a
a
a
a
a
a
J
J
J
J
J
J
J
J
J
B
"}
(156,1,1) = {"
a
a
a
a
a
a
a
a
a
a
a
a
a
a
a
J
J
J
J
J
J
J
J
J
B
"}
(157,1,1) = {"
a
a
a
a
a
a
a
a
a
a
a
a
a
a
a
J
J
J
J
J
J
J
J
J
B
"}
(158,1,1) = {"
a
a
a
a
a
a
a
a
a
a
a
a
a
a
a
J
J
J
J
J
J
J
J
J
B
"}
(159,1,1) = {"
a
a
a
a
a
a
a
a
a
a
a
a
a
a
a
J
J
J
J
J
J
J
J
J
B
"}
(160,1,1) = {"
a
a
a
a
a
a
a
a
a
a
a
a
a
a
a
J
J
J
J
J
J
J
J
J
B
"}
(161,1,1) = {"
a
a
a
a
a
a
a
a
a
a
a
a
a
a
a
J
J
J
J
J
J
J
J
J
B
"}
(162,1,1) = {"
a
a
a
a
a
a
a
a
a
a
a
a
a
a
a
J
J
J
J
J
J
J
J
J
B
"}
(163,1,1) = {"
a
a
a
a
a
a
a
a
a
a
a
a
a
a
a
J
J
J
J
J
J
J
J
J
B
"}
(164,1,1) = {"
a
a
a
a
a
a
a
a
a
a
a
a
a
a
a
J
J
J
J
J
J
J
J
J
B
"}
(165,1,1) = {"
a
a
a
a
a
a
a
a
a
a
a
a
a
a
a
J
J
J
J
J
J
J
J
J
B
"}
(166,1,1) = {"
a
a
a
a
a
a
a
a
a
a
a
a
a
a
a
J
J
J
J
J
J
J
J
J
B
"}
(167,1,1) = {"
a
a
a
a
a
a
a
a
a
a
a
a
a
a
a
J
J
J
J
J
J
J
J
J
B
"}
(168,1,1) = {"
a
a
a
a
a
a
a
a
a
a
a
a
a
a
a
J
J
J
J
J
J
J
J
J
B
"}
(169,1,1) = {"
a
a
a
a
a
a
a
a
a
a
a
a
a
a
a
J
J
J
J
J
J
J
J
J
B
"}
(170,1,1) = {"
a
a
a
a
a
a
a
a
a
a
a
a
a
a
a
J
J
J
J
J
J
J
J
J
B
"}
(171,1,1) = {"
a
a
a
a
a
a
a
a
a
a
a
a
a
a
a
J
J
J
J
J
J
J
J
J
B
"}
(172,1,1) = {"
a
a
a
a
a
a
a
a
a
a
a
a
a
a
a
J
J
J
J
J
J
J
J
J
B
"}
(173,1,1) = {"
a
a
a
a
a
a
a
a
a
a
a
a
a
a
a
J
J
J
J
J
J
J
J
J
B
"}
(174,1,1) = {"
a
a
a
a
a
a
a
a
a
a
a
a
a
a
a
J
J
J
J
J
J
J
J
J
B
"}
(175,1,1) = {"
a
a
a
a
a
a
a
a
a
a
a
a
a
a
a
J
J
J
J
J
J
J
J
J
B
"}
(176,1,1) = {"
a
a
a
a
a
a
a
a
a
a
a
a
a
a
a
J
J
J
J
J
J
J
J
J
B
"}
(177,1,1) = {"
a
a
a
a
a
a
a
a
a
a
a
a
a
a
a
J
J
J
J
J
J
J
J
J
B
"}
(178,1,1) = {"
a
a
a
a
a
a
a
a
a
a
a
a
a
a
a
J
J
J
J
J
J
J
J
J
B
"}
(179,1,1) = {"
a
a
a
a
a
a
a
a
a
a
a
a
a
a
a
J
J
J
J
J
J
J
J
J
B
"}
(180,1,1) = {"
a
a
a
a
a
a
a
a
a
a
a
a
a
a
a
J
J
J
J
J
J
J
J
J
B
"}
(181,1,1) = {"
a
a
a
a
a
a
a
a
a
a
a
a
a
a
a
J
J
J
J
J
J
J
J
J
B
"}
(182,1,1) = {"
a
a
a
a
a
a
a
a
a
a
a
a
a
a
a
J
J
J
J
J
J
J
J
J
B
"}
(183,1,1) = {"
a
a
a
a
a
a
a
a
a
a
a
a
a
a
a
J
J
J
J
J
J
J
J
J
B
"}
(184,1,1) = {"
a
a
a
a
a
a
a
a
a
a
a
a
a
a
a
J
J
J
J
J
J
J
J
J
B
"}
(185,1,1) = {"
a
a
a
a
a
a
a
a
a
a
a
a
a
a
a
J
J
J
J
J
J
J
J
J
B
"}
(186,1,1) = {"
a
a
a
a
a
a
a
a
a
a
a
a
a
a
a
J
J
J
J
J
J
J
J
J
B
"}
(187,1,1) = {"
a
a
a
a
a
a
a
a
a
a
a
a
a
a
a
J
J
J
J
J
J
J
J
J
B
"}
(188,1,1) = {"
a
a
a
a
a
a
a
a
a
a
a
a
a
a
a
J
J
J
J
J
J
J
J
J
B
"}
(189,1,1) = {"
a
a
a
a
a
a
a
a
a
a
a
a
a
a
a
J
J
J
J
J
J
J
J
J
B
"}
(190,1,1) = {"
a
a
a
a
a
a
a
a
a
a
a
a
a
a
a
J
J
J
J
J
J
J
J
J
B
"}
(191,1,1) = {"
a
a
a
a
a
a
a
a
a
a
a
a
a
a
a
J
J
J
J
J
J
J
J
J
B
"}
(192,1,1) = {"
a
a
a
a
a
a
a
a
a
a
a
a
a
a
a
J
J
J
J
J
J
J
J
J
B
"}
(193,1,1) = {"
a
a
a
a
a
a
a
a
a
a
a
a
a
a
a
J
J
J
J
J
J
J
J
J
B
"}
(194,1,1) = {"
a
a
a
a
a
a
a
a
a
a
a
a
a
a
a
J
J
J
J
J
J
J
J
J
B
"}
(195,1,1) = {"
a
a
a
a
a
a
a
a
a
a
a
a
a
a
a
J
J
J
J
J
J
J
J
J
B
"}
(196,1,1) = {"
a
a
a
a
a
a
a
a
a
a
a
a
a
a
a
J
J
J
J
J
J
J
J
J
B
"}
(197,1,1) = {"
a
a
a
a
a
a
a
a
a
a
a
a
a
a
a
J
J
J
J
J
J
J
J
J
B
"}
(198,1,1) = {"
a
a
a
a
a
a
a
a
a
a
a
a
a
a
a
J
J
J
J
J
J
J
J
J
B
"}
(199,1,1) = {"
a
a
a
a
a
a
a
a
a
a
a
a
a
a
a
J
J
J
J
J
J
J
J
J
B
"}
(200,1,1) = {"
a
a
a
a
a
a
a
a
a
a
a
a
a
a
a
J
J
J
J
J
J
J
J
J
B
"}
(201,1,1) = {"
a
a
a
a
a
a
a
a
a
a
a
a
a
a
a
J
J
J
J
J
J
J
J
J
B
"}
(202,1,1) = {"
a
a
a
a
a
a
a
a
a
a
a
a
a
a
a
J
J
J
J
J
J
J
J
J
B
"}
(203,1,1) = {"
a
a
a
a
a
a
a
a
a
a
a
a
a
a
a
J
J
J
J
J
J
J
J
J
B
"}
(204,1,1) = {"
a
a
a
a
a
a
a
a
a
a
a
a
a
a
a
J
J
J
J
J
J
J
J
J
B
"}
(205,1,1) = {"
a
a
a
a
a
a
a
a
a
a
a
a
a
a
a
J
J
J
J
J
J
J
J
J
B
"}
(206,1,1) = {"
a
a
a
a
a
a
a
a
a
a
a
a
a
a
a
J
J
J
J
J
J
J
J
J
B
"}
(207,1,1) = {"
a
a
a
a
a
a
a
a
a
a
a
a
a
a
a
J
J
J
J
J
J
J
J
J
B
"}
(208,1,1) = {"
a
a
a
a
a
a
a
a
a
a
a
a
a
a
a
J
J
J
J
J
J
J
J
J
B
"}
(209,1,1) = {"
a
a
a
a
a
a
a
a
a
a
a
a
a
a
a
J
J
J
J
J
J
J
J
J
B
"}
(210,1,1) = {"
a
a
a
a
a
a
a
a
a
a
a
a
a
a
a
J
J
J
J
J
J
J
J
J
B
"}
(211,1,1) = {"
a
a
a
a
a
a
a
a
a
a
a
a
a
a
a
J
J
J
J
J
J
J
J
J
B
"}
(212,1,1) = {"
a
a
a
a
a
a
a
a
a
a
a
a
a
a
a
J
J
J
J
J
J
J
J
J
B
"}
(213,1,1) = {"
a
a
a
a
a
a
a
a
a
a
a
a
a
a
a
J
J
J
J
J
J
J
J
J
B
"}
(214,1,1) = {"
a
a
a
a
a
a
a
a
a
a
a
a
a
a
a
J
J
J
J
J
J
J
J
J
B
"}
(215,1,1) = {"
a
a
a
a
a
a
a
a
a
a
a
a
a
a
a
J
J
J
J
J
J
J
J
J
B
"}
(216,1,1) = {"
a
a
a
a
a
a
a
a
a
a
a
a
a
a
a
J
J
J
J
J
J
J
J
J
B
"}
(217,1,1) = {"
a
a
a
a
a
a
a
a
a
a
a
a
a
a
a
J
J
J
J
J
J
J
J
J
B
"}
(218,1,1) = {"
a
a
a
a
a
a
a
a
a
a
a
a
a
a
a
J
J
J
J
J
J
J
J
J
B
"}
(219,1,1) = {"
a
a
a
a
a
a
a
a
a
a
a
a
a
a
a
J
J
J
J
J
J
J
J
J
B
"}
(220,1,1) = {"
a
a
a
a
a
a
a
a
a
a
a
a
a
a
a
J
J
J
J
J
J
J
J
J
B
"}
(221,1,1) = {"
a
a
a
a
a
a
a
a
a
a
a
a
a
a
a
J
J
J
J
J
J
J
J
J
B
"}
(222,1,1) = {"
a
a
a
a
a
a
a
a
a
a
a
a
a
a
a
J
J
J
J
J
J
J
J
J
B
"}
(223,1,1) = {"
a
a
a
a
a
a
a
a
a
a
a
a
a
a
a
J
J
J
J
J
J
J
J
J
B
"}
(224,1,1) = {"
a
a
a
a
a
a
a
a
a
a
a
a
a
a
a
J
J
J
J
J
J
J
J
J
B
"}
(225,1,1) = {"
a
a
a
a
a
a
a
a
a
a
a
a
a
a
a
J
J
J
J
J
J
J
J
J
B
"}
(226,1,1) = {"
a
a
a
a
a
a
a
a
a
a
a
a
a
a
a
J
J
J
J
J
J
J
J
J
B
"}
(227,1,1) = {"
a
a
a
a
a
a
a
a
a
a
a
a
a
a
a
J
J
J
J
J
J
J
J
J
B
"}
(228,1,1) = {"
a
a
a
a
a
a
a
a
a
a
a
a
a
a
a
J
J
J
J
J
J
J
J
J
B
"}
(229,1,1) = {"
a
a
a
a
a
a
a
a
a
a
a
a
a
a
a
J
J
J
J
J
J
J
J
J
B
"}
(230,1,1) = {"
a
a
a
a
a
a
a
a
a
a
a
a
a
a
a
J
J
J
J
J
J
J
J
J
B
"}
(231,1,1) = {"
a
a
a
a
a
a
a
a
a
a
a
a
a
a
a
J
J
J
J
J
J
J
J
J
B
"}
(232,1,1) = {"
a
a
a
a
a
a
a
a
a
a
a
a
a
a
a
J
J
J
J
J
J
J
J
J
B
"}
(233,1,1) = {"
a
a
a
a
a
a
a
a
a
a
a
a
a
a
a
J
J
J
J
J
J
J
J
J
B
"}
(234,1,1) = {"
a
a
a
a
a
a
a
a
a
a
a
a
a
a
a
J
J
J
J
J
J
J
J
J
B
"}
(235,1,1) = {"
a
a
a
a
a
a
a
a
a
a
a
a
a
a
a
J
J
J
J
J
J
J
J
J
B
"}
(236,1,1) = {"
a
a
a
a
a
a
a
a
a
a
a
a
a
a
a
J
J
J
J
J
J
J
J
J
B
"}
(237,1,1) = {"
a
a
a
a
a
a
a
a
a
a
a
a
a
a
a
J
J
J
J
J
J
J
J
J
B
"}
(238,1,1) = {"
a
a
a
a
a
a
a
a
a
a
a
a
a
a
a
J
J
J
J
J
J
J
J
J
B
"}
(239,1,1) = {"
a
a
a
a
a
a
a
a
a
a
a
a
a
a
a
J
J
J
J
J
J
J
J
J
B
"}
(240,1,1) = {"
a
a
a
a
a
a
a
a
a
a
a
a
a
a
a
J
J
J
J
J
J
J
J
J
B
"}
(241,1,1) = {"
a
a
a
a
a
a
a
a
a
a
a
a
a
a
a
J
J
J
J
J
J
J
J
J
B
"}
(242,1,1) = {"
a
a
a
a
a
a
a
a
a
a
a
a
a
a
a
J
J
J
J
J
J
J
J
J
B
"}
(243,1,1) = {"
a
a
a
a
a
a
a
a
a
a
a
a
a
a
a
J
J
J
J
J
J
J
J
J
B
"}
(244,1,1) = {"
a
a
a
a
a
a
a
a
a
a
a
a
a
a
a
J
J
J
J
J
J
J
J
J
B
"}
(245,1,1) = {"
a
a
a
a
a
a
a
a
a
a
a
a
a
a
a
J
J
J
J
J
J
J
J
J
B
"}
(246,1,1) = {"
a
a
a
a
a
a
a
a
a
a
a
a
a
a
a
J
J
J
J
J
J
J
J
J
B
"}
(247,1,1) = {"
a
a
a
a
a
a
a
a
a
a
a
a
a
a
a
J
J
J
J
J
J
J
J
J
B
"}
(248,1,1) = {"
a
a
a
a
a
a
a
a
a
a
a
a
a
a
a
J
J
J
J
J
J
J
J
J
B
"}
(249,1,1) = {"
a
a
a
a
a
a
a
a
a
a
a
a
a
a
a
J
J
J
J
J
J
J
J
J
B
"}
(250,1,1) = {"
a
a
a
a
a
a
a
a
a
a
a
a
a
a
a
J
J
J
J
J
J
J
J
J
B
"}
(251,1,1) = {"
a
a
a
a
a
a
a
a
a
a
a
a
a
a
a
J
J
J
J
J
J
J
J
J
B
"}
(252,1,1) = {"
a
a
a
a
a
a
a
a
a
a
a
a
a
a
a
J
J
J
J
J
J
J
J
J
B
"}
(253,1,1) = {"
a
a
a
p
t
a
t
a
t
a
p
a
a
a
a
J
J
J
J
J
J
J
J
J
B
"}
(254,1,1) = {"
a
a
a
a
a
a
a
a
a
a
a
a
a
a
a
J
J
J
J
J
J
J
J
J
B
"}
(255,1,1) = {"
a
a
A
p
a
A
a
A
a
p
a
A
a
a
a
J
J
J
J
J
J
J
J
J
B
"}
