//MAP CONVERTED BY dmm2tgm.py THIS HEADER COMMENT PREVENTS RECONVERSION, DO NOT REMOVE
"a" = (
/turf/open/water/deep_beach/lethal,
/area/trainstation/outdoor/rails)
"b" = (
/obj/effect/turf_decal/weather/snow,
/obj/effect/turf_decal/weather/snow/corner{
	dir = 10
	},
/turf/open/water/deep_beach/lethal,
/area/trainstation/outdoor/rails)
"c" = (
/obj/structure/flora/grass/green/style_3,
/turf/open/floor/fake_snow/safe,
/area/trainstation/outdoor/rails)
"d" = (
/obj/effect/turf_decal/weather/snow,
/obj/effect/turf_decal/weather/snow/corner{
	dir = 5
	},
/turf/open/water/deep_beach/lethal,
/area/trainstation/outdoor/rails)
"f" = (
/turf/open/floor/plating/snowed/smoothed,
/area/trainstation/outdoor/rails)
"i" = (
/obj/effect/turf_decal/weather/snow,
/obj/effect/turf_decal/weather/snow/corner{
	dir = 10
	},
/obj/effect/turf_decal/weather/snow/corner{
	dir = 6
	},
/turf/open/water/deep_beach/lethal,
/area/trainstation/outdoor/rails)
"j" = (
/obj/effect/turf_decal/weather/snow/corner{
	dir = 9
	},
/turf/open/water/deep_beach/lethal,
/area/trainstation/outdoor/rails)
"o" = (
/obj/effect/turf_decal/weather/snow/corner{
	dir = 1
	},
/turf/open/water/deep_beach/lethal,
/area/trainstation/outdoor/rails)
"q" = (
/obj/effect/turf_decal/weather/snow,
/obj/effect/turf_decal/weather/snow/corner{
	dir = 5
	},
/obj/effect/turf_decal/weather/snow/corner{
	dir = 6
	},
/turf/open/water/deep_beach/lethal,
/area/trainstation/outdoor/rails)
"s" = (
/obj/effect/turf_decal/weather/snow,
/obj/effect/turf_decal/weather/snow/corner{
	dir = 9
	},
/obj/effect/turf_decal/weather/snow/corner{
	dir = 10
	},
/turf/open/water/deep_beach/lethal,
/area/trainstation/outdoor/rails)
"u" = (
/obj/item/chair/plastic,
/obj/item/chair/plastic{
	pixel_x = 0;
	pixel_y = 5
	},
/obj/structure/railing/unbreakable,
/obj/effect/turf_decal/stripes/line,
/obj/item/storage/bag/fishing{
	pixel_x = -7;
	pixel_y = 14
	},
/turf/open/floor/plating/snowed/smoothed,
/area/trainstation/outdoor/rails)
"v" = (
/turf/closed/wall/ice,
/area/trainstation/outdoor/rails)
"w" = (
/obj/structure/table,
/obj/item/storage/box/fishing_lures{
	pixel_x = -14;
	pixel_y = 3
	},
/obj/structure/railing/unbreakable,
/obj/effect/turf_decal/stripes/line,
/turf/open/floor/plating/snowed/smoothed,
/area/trainstation/outdoor/rails)
"x" = (
/obj/effect/turf_decal/weather/snow,
/obj/effect/turf_decal/weather/snow/corner{
	dir = 4
	},
/turf/open/water/deep_beach/lethal,
/area/trainstation/outdoor/rails)
"z" = (
/obj/effect/turf_decal/weather/snow,
/obj/effect/turf_decal/weather/snow/corner{
	dir = 1
	},
/turf/open/water/deep_beach/lethal,
/area/trainstation/outdoor/rails)
"A" = (
/obj/structure/table,
/obj/item/storage/toolbox/fishing{
	pixel_x = -1;
	pixel_y = 6
	},
/obj/item/storage/toolbox/fishing{
	pixel_x = -1;
	pixel_y = 0
	},
/obj/structure/marker_beacon/cerulean,
/obj/structure/railing/unbreakable,
/obj/effect/turf_decal/stripes/line,
/turf/open/floor/plating/snowed/smoothed,
/area/trainstation/outdoor/rails)
"C" = (
/turf/closed/indestructible/train_border,
/area/trainstation/outdoor/rails)
"I" = (
/turf/open/floor/fake_snow/safe,
/area/trainstation/outdoor/rails)
"J" = (
/obj/effect/turf_decal/weather/snow/corner{
	dir = 8
	},
/turf/open/water/deep_beach/lethal,
/area/trainstation/outdoor/rails)
"N" = (
/obj/structure/railing/unbreakable,
/obj/effect/turf_decal/stripes/line,
/turf/open/floor/plating/snowed/smoothed,
/area/trainstation/outdoor/rails)
"O" = (
/obj/effect/turf_decal/weather/snow,
/obj/effect/turf_decal/weather/snow/corner,
/turf/open/water/deep_beach/lethal,
/area/trainstation/outdoor/rails)
"Q" = (
/obj/effect/turf_decal/tile/dark/half{
	alpha = 55;
	dir = 1
	},
/obj/structure/fans/tiny/invisible{
	density = 1
	},
/turf/open/indestructible/tram{
	name = "dam wall";
	icon = 'modular_zvents/icons/turf/city/siding.dmi';
	icon_state = "wall-0";
	base_icon_state = "wall";
	desc = "The wall of this now-frozen dam. Looks nigh-impenetrable to damage."
	},
/area/trainstation/outdoor/rails)
"S" = (
/obj/structure/fence/interlink{
	dir = 8;
	pixel_y = -1
	},
/turf/open/floor/fake_snow/safe,
/area/trainstation/outdoor/rails)
"W" = (
/obj/effect/turf_decal/weather/snow/corner{
	dir = 5
	},
/turf/open/water/deep_beach/lethal,
/area/trainstation/outdoor/rails)
"Y" = (
/obj/structure/flora/tree/pine/style_random,
/turf/open/floor/fake_snow/safe,
/area/trainstation/outdoor/rails)

(1,1,1) = {"
I
I
S
Q
a
a
a
a
a
a
a
a
a
a
C
"}
(2,1,1) = {"
I
I
S
Q
a
a
a
a
a
a
a
a
a
a
C
"}
(3,1,1) = {"
I
I
S
Q
a
a
a
a
a
a
a
a
a
a
C
"}
(4,1,1) = {"
I
I
S
Q
a
a
a
a
a
a
a
a
a
a
C
"}
(5,1,1) = {"
f
I
S
Q
a
a
a
a
a
a
a
a
a
a
C
"}
(6,1,1) = {"
f
I
S
Q
a
a
a
a
a
a
a
a
a
a
C
"}
(7,1,1) = {"
f
I
S
Q
a
a
a
a
a
a
a
a
a
a
C
"}
(8,1,1) = {"
f
I
S
Q
a
a
a
a
a
a
a
a
a
a
C
"}
(9,1,1) = {"
f
c
S
Q
a
a
a
a
a
a
a
a
a
a
C
"}
(10,1,1) = {"
f
I
S
Q
W
a
a
a
a
a
a
a
a
a
C
"}
(11,1,1) = {"
f
Y
S
Q
s
W
a
a
a
a
a
a
a
a
C
"}
(12,1,1) = {"
f
I
S
Q
z
b
o
a
a
a
a
a
a
a
C
"}
(13,1,1) = {"
f
c
S
Q
z
O
W
a
a
a
a
a
a
a
C
"}
(14,1,1) = {"
f
c
S
Q
z
x
i
o
a
a
a
a
a
a
C
"}
(15,1,1) = {"
f
I
S
Q
q
j
J
a
a
a
a
a
a
a
C
"}
(16,1,1) = {"
f
I
S
Q
j
a
a
a
a
a
a
a
a
a
C
"}
(17,1,1) = {"
f
I
S
Q
a
a
a
a
a
a
a
a
a
a
C
"}
(18,1,1) = {"
f
I
S
Q
a
a
a
a
a
a
a
a
a
a
C
"}
(19,1,1) = {"
f
I
S
Q
a
a
a
a
a
a
a
a
a
a
C
"}
(20,1,1) = {"
f
I
S
Q
a
a
a
a
a
a
a
a
a
a
C
"}
(21,1,1) = {"
f
I
S
Q
a
a
a
a
a
a
a
a
a
a
C
"}
(22,1,1) = {"
f
I
S
Q
a
a
a
a
a
a
a
a
a
a
C
"}
(23,1,1) = {"
f
I
S
Q
a
a
a
a
a
a
a
a
a
a
C
"}
(24,1,1) = {"
I
I
S
Q
a
a
a
a
a
a
a
a
a
a
C
"}
(25,1,1) = {"
I
I
S
Q
a
a
a
a
a
a
a
a
a
a
C
"}
(26,1,1) = {"
f
I
S
Q
a
a
a
a
a
a
a
a
a
a
C
"}
(27,1,1) = {"
f
I
S
Q
a
a
a
a
a
a
a
a
a
a
C
"}
(28,1,1) = {"
f
I
S
Q
a
a
a
a
a
a
a
a
a
a
C
"}
(29,1,1) = {"
I
I
S
Q
a
a
a
a
a
a
a
a
a
a
C
"}
(30,1,1) = {"
I
I
S
Q
a
a
a
a
a
a
a
a
a
a
C
"}
(31,1,1) = {"
I
I
S
Q
a
a
a
a
a
a
a
a
a
a
C
"}
(32,1,1) = {"
I
c
S
Q
a
a
a
a
a
a
a
a
a
a
C
"}
(33,1,1) = {"
f
I
S
Q
a
a
a
a
a
a
a
a
a
a
C
"}
(34,1,1) = {"
f
Y
S
Q
a
a
a
a
a
a
a
a
a
a
C
"}
(35,1,1) = {"
f
I
S
Q
a
a
a
a
a
a
a
a
a
a
C
"}
(36,1,1) = {"
f
I
S
Q
a
a
a
a
a
a
a
a
a
a
C
"}
(37,1,1) = {"
f
I
S
Q
a
a
a
a
a
a
a
a
a
a
C
"}
(38,1,1) = {"
f
I
S
Q
a
a
a
a
a
a
a
a
a
a
C
"}
(39,1,1) = {"
f
I
v
Q
a
a
a
a
a
a
a
a
a
a
C
"}
(40,1,1) = {"
f
I
N
Q
a
a
a
a
a
a
a
a
a
a
C
"}
(41,1,1) = {"
f
I
N
Q
a
a
a
a
a
a
a
a
a
a
C
"}
(42,1,1) = {"
f
I
u
Q
a
a
a
a
a
a
a
a
a
a
C
"}
(43,1,1) = {"
f
I
A
Q
a
a
a
a
a
a
a
a
a
a
C
"}
(44,1,1) = {"
f
I
w
Q
a
a
a
a
a
a
a
a
a
a
C
"}
(45,1,1) = {"
f
I
v
Q
a
a
a
a
a
a
a
a
a
a
C
"}
(46,1,1) = {"
f
I
S
Q
a
a
a
a
a
a
a
a
a
a
C
"}
(47,1,1) = {"
f
I
S
Q
a
a
a
a
a
a
a
a
a
a
C
"}
(48,1,1) = {"
f
I
S
Q
a
a
a
a
a
a
a
a
a
a
C
"}
(49,1,1) = {"
f
I
S
Q
a
a
a
a
a
a
a
a
a
a
C
"}
(50,1,1) = {"
f
I
S
Q
a
a
a
a
a
a
a
a
a
a
C
"}
(51,1,1) = {"
f
I
S
Q
a
a
a
a
a
a
a
a
a
a
C
"}
(52,1,1) = {"
f
I
S
Q
a
a
a
a
a
a
a
a
a
a
C
"}
(53,1,1) = {"
f
I
S
Q
a
a
a
a
a
a
a
a
a
a
C
"}
(54,1,1) = {"
f
I
S
Q
a
a
a
a
a
a
a
a
a
a
C
"}
(55,1,1) = {"
f
I
S
Q
a
a
a
a
a
a
a
a
a
a
C
"}
(56,1,1) = {"
f
I
S
Q
a
a
a
a
a
a
a
a
a
a
C
"}
(57,1,1) = {"
Y
c
S
Q
a
a
a
a
a
a
a
a
a
a
C
"}
(58,1,1) = {"
c
I
S
Q
a
a
a
a
a
a
a
a
a
a
C
"}
(59,1,1) = {"
f
I
S
Q
a
a
a
a
a
a
a
a
a
a
C
"}
(60,1,1) = {"
f
I
S
Q
a
a
a
a
a
a
a
a
a
a
C
"}
(61,1,1) = {"
f
I
S
Q
a
a
a
a
a
a
a
a
a
a
C
"}
(62,1,1) = {"
I
I
S
Q
a
a
a
a
a
a
a
a
a
a
C
"}
(63,1,1) = {"
I
I
S
Q
a
a
a
a
a
a
a
a
a
a
C
"}
(64,1,1) = {"
I
I
S
Q
a
a
a
a
a
a
a
a
a
a
C
"}
(65,1,1) = {"
I
I
S
Q
a
a
a
a
a
a
a
a
a
a
C
"}
(66,1,1) = {"
f
I
S
Q
a
a
a
a
a
a
a
a
a
a
C
"}
(67,1,1) = {"
f
I
S
Q
W
a
a
a
a
a
a
a
a
a
C
"}
(68,1,1) = {"
f
I
S
Q
s
W
a
a
a
a
a
a
a
a
C
"}
(69,1,1) = {"
f
I
S
Q
z
b
o
a
a
a
a
a
a
a
C
"}
(70,1,1) = {"
f
I
S
Q
z
O
W
a
a
a
a
a
a
a
C
"}
(71,1,1) = {"
f
I
S
Q
z
x
i
o
a
a
a
a
a
a
C
"}
(72,1,1) = {"
f
I
S
Q
q
j
J
a
a
a
a
a
a
a
C
"}
(73,1,1) = {"
f
I
S
Q
j
a
a
a
a
a
a
a
a
a
C
"}
(74,1,1) = {"
f
I
S
Q
a
a
a
a
a
a
a
a
a
a
C
"}
(75,1,1) = {"
f
I
S
Q
a
a
a
a
a
a
a
a
a
a
C
"}
(76,1,1) = {"
f
I
S
Q
a
a
a
a
a
a
a
a
a
a
C
"}
(77,1,1) = {"
f
I
S
Q
a
a
a
a
a
a
a
a
a
a
C
"}
(78,1,1) = {"
f
I
S
Q
a
a
a
a
a
a
a
a
a
a
C
"}
(79,1,1) = {"
f
I
S
Q
a
a
a
a
a
a
a
a
a
a
C
"}
(80,1,1) = {"
f
I
S
Q
a
a
a
a
a
a
a
a
a
a
C
"}
(81,1,1) = {"
f
I
S
Q
a
a
a
a
a
a
a
a
a
a
C
"}
(82,1,1) = {"
f
I
S
Q
a
a
a
a
a
a
a
a
a
a
C
"}
(83,1,1) = {"
f
Y
S
Q
a
a
a
a
a
a
a
a
a
a
C
"}
(84,1,1) = {"
f
I
S
Q
a
a
a
a
a
a
a
a
a
a
C
"}
(85,1,1) = {"
f
I
S
Q
a
a
a
a
a
a
a
a
a
a
C
"}
(86,1,1) = {"
I
I
S
Q
a
a
a
a
a
a
a
a
a
a
C
"}
(87,1,1) = {"
I
I
S
Q
a
a
a
a
a
a
a
a
a
a
C
"}
(88,1,1) = {"
f
I
S
Q
a
a
a
a
a
a
a
a
a
a
C
"}
(89,1,1) = {"
f
I
S
Q
a
a
a
a
a
a
a
a
a
a
C
"}
(90,1,1) = {"
f
I
S
Q
a
a
a
a
a
a
a
a
a
a
C
"}
(91,1,1) = {"
I
I
S
Q
a
a
a
a
a
a
a
a
a
a
C
"}
(92,1,1) = {"
I
I
S
Q
a
a
a
a
a
a
a
a
a
a
C
"}
(93,1,1) = {"
I
I
S
Q
a
a
a
a
a
a
a
a
a
a
C
"}
(94,1,1) = {"
I
I
S
Q
a
a
a
a
a
a
a
a
a
a
C
"}
(95,1,1) = {"
f
I
S
Q
a
a
a
a
a
a
a
a
a
a
C
"}
(96,1,1) = {"
f
I
S
Q
a
a
a
a
a
a
a
a
a
a
C
"}
(97,1,1) = {"
f
I
S
Q
a
a
a
a
a
a
a
a
a
a
C
"}
(98,1,1) = {"
f
Y
S
Q
a
a
a
a
a
a
a
a
a
a
C
"}
(99,1,1) = {"
f
I
S
Q
a
a
a
a
a
a
a
a
a
a
C
"}
(100,1,1) = {"
f
c
S
Q
a
a
a
a
a
a
a
a
a
a
C
"}
(101,1,1) = {"
I
I
S
Q
a
a
a
a
a
a
a
a
a
a
C
"}
(102,1,1) = {"
f
Y
S
Q
a
a
a
a
a
a
a
a
a
a
C
"}
(103,1,1) = {"
I
I
S
Q
a
a
a
a
a
a
a
a
a
a
C
"}
(104,1,1) = {"
f
I
S
Q
W
a
a
a
a
a
a
a
a
a
C
"}
(105,1,1) = {"
f
I
S
Q
s
W
a
a
a
a
a
a
a
a
C
"}
(106,1,1) = {"
f
c
S
Q
d
i
o
a
a
a
a
a
a
a
C
"}
(107,1,1) = {"
f
I
S
Q
J
J
a
a
a
a
a
a
a
a
C
"}
(108,1,1) = {"
f
I
S
Q
a
a
a
a
a
a
a
a
a
a
C
"}
(109,1,1) = {"
f
I
S
Q
a
a
a
a
a
a
a
a
a
a
C
"}
(110,1,1) = {"
f
I
S
Q
a
a
a
a
a
a
a
a
a
a
C
"}
(111,1,1) = {"
f
I
S
Q
a
a
a
a
a
a
a
a
a
a
C
"}
(112,1,1) = {"
f
I
S
Q
a
a
a
a
a
a
a
a
a
a
C
"}
(113,1,1) = {"
f
I
S
Q
a
a
a
a
a
a
a
a
a
a
C
"}
(114,1,1) = {"
f
I
S
Q
a
a
a
a
a
a
a
a
a
a
C
"}
(115,1,1) = {"
f
I
S
Q
a
a
a
a
a
a
a
a
a
a
C
"}
(116,1,1) = {"
f
I
S
Q
a
a
a
a
a
a
a
a
a
a
C
"}
(117,1,1) = {"
f
I
S
Q
a
a
a
a
a
a
a
a
a
a
C
"}
(118,1,1) = {"
f
I
S
Q
a
a
a
a
a
a
a
a
a
a
C
"}
(119,1,1) = {"
f
I
S
Q
a
a
a
a
a
a
a
a
a
a
C
"}
(120,1,1) = {"
f
I
S
Q
a
a
a
a
a
a
a
a
a
a
C
"}
(121,1,1) = {"
f
I
S
Q
a
a
a
a
a
a
a
a
a
a
C
"}
(122,1,1) = {"
f
I
S
Q
a
a
a
a
a
a
a
a
a
a
C
"}
(123,1,1) = {"
f
I
S
Q
a
a
a
a
a
a
a
a
a
a
C
"}
(124,1,1) = {"
f
I
S
Q
a
a
a
a
a
a
a
a
a
a
C
"}
(125,1,1) = {"
f
I
S
Q
a
a
a
a
a
a
a
a
a
a
C
"}
(126,1,1) = {"
f
I
S
Q
a
a
a
a
a
a
a
a
a
a
C
"}
(127,1,1) = {"
f
I
S
Q
a
a
a
a
a
a
a
a
a
a
C
"}
(128,1,1) = {"
f
I
S
Q
a
a
a
a
a
a
a
a
a
a
C
"}
(129,1,1) = {"
f
I
S
Q
a
a
a
a
a
a
a
a
a
a
C
"}
(130,1,1) = {"
f
I
S
Q
W
a
a
a
a
a
a
a
a
a
C
"}
(131,1,1) = {"
f
I
S
Q
s
W
a
a
a
a
a
a
a
a
C
"}
(132,1,1) = {"
f
c
S
Q
z
b
o
a
a
a
a
a
a
a
C
"}
(133,1,1) = {"
f
I
S
Q
z
O
W
a
a
a
a
a
a
a
C
"}
(134,1,1) = {"
f
Y
S
Q
z
x
i
o
a
a
a
a
a
a
C
"}
(135,1,1) = {"
f
I
S
Q
q
j
J
a
a
a
a
a
a
a
C
"}
(136,1,1) = {"
f
I
S
Q
j
a
a
a
a
a
a
a
a
a
C
"}
(137,1,1) = {"
f
c
S
Q
a
a
a
a
a
a
a
a
a
a
C
"}
(138,1,1) = {"
f
I
S
Q
a
a
a
a
a
a
a
a
a
a
C
"}
(139,1,1) = {"
I
I
S
Q
a
a
a
a
a
a
a
a
a
a
C
"}
(140,1,1) = {"
I
I
v
Q
a
a
a
a
a
a
a
a
a
a
C
"}
(141,1,1) = {"
f
I
N
Q
a
a
a
a
a
a
a
a
a
a
C
"}
(142,1,1) = {"
f
I
N
Q
a
a
a
a
a
a
a
a
a
a
C
"}
(143,1,1) = {"
f
I
u
Q
a
a
a
a
a
a
a
a
a
a
C
"}
(144,1,1) = {"
I
I
A
Q
a
a
a
a
a
a
a
a
a
a
C
"}
(145,1,1) = {"
I
I
w
Q
a
a
a
a
a
a
a
a
a
a
C
"}
(146,1,1) = {"
I
I
v
Q
a
a
a
a
a
a
a
a
a
a
C
"}
(147,1,1) = {"
I
I
S
Q
a
a
a
a
a
a
a
a
a
a
C
"}
(148,1,1) = {"
f
I
S
Q
a
a
a
a
a
a
a
a
a
a
C
"}
(149,1,1) = {"
f
I
S
Q
a
a
a
a
a
a
a
a
a
a
C
"}
(150,1,1) = {"
f
I
S
Q
a
a
a
a
a
a
a
a
a
a
C
"}
(151,1,1) = {"
f
I
S
Q
a
a
a
a
a
a
a
a
a
a
C
"}
(152,1,1) = {"
f
I
S
Q
a
a
a
a
a
a
a
a
a
a
C
"}
(153,1,1) = {"
f
I
S
Q
a
a
a
a
a
a
a
a
a
a
C
"}
(154,1,1) = {"
I
I
S
Q
a
a
a
a
a
a
a
a
a
a
C
"}
(155,1,1) = {"
f
I
S
Q
a
a
a
a
a
a
a
a
a
a
C
"}
(156,1,1) = {"
I
I
S
Q
a
a
a
a
a
a
a
a
a
a
C
"}
(157,1,1) = {"
f
I
S
Q
a
a
a
a
a
a
a
a
a
a
C
"}
(158,1,1) = {"
f
I
S
Q
a
a
a
a
a
a
a
a
a
a
C
"}
(159,1,1) = {"
f
I
S
Q
a
a
a
a
a
a
a
a
a
a
C
"}
(160,1,1) = {"
f
I
S
Q
a
a
a
a
a
a
a
a
a
a
C
"}
(161,1,1) = {"
f
c
S
Q
a
a
a
a
a
a
a
a
a
a
C
"}
(162,1,1) = {"
I
I
S
Q
W
a
a
a
a
a
a
a
a
a
C
"}
(163,1,1) = {"
I
Y
S
Q
s
W
a
a
a
a
a
a
a
a
C
"}
(164,1,1) = {"
c
I
S
Q
d
i
o
a
a
a
a
a
a
a
C
"}
(165,1,1) = {"
I
I
S
Q
J
J
a
a
a
a
a
a
a
a
C
"}
(166,1,1) = {"
f
I
S
Q
a
a
a
a
a
a
a
a
a
a
C
"}
(167,1,1) = {"
f
I
S
Q
a
a
a
a
a
a
a
a
a
a
C
"}
(168,1,1) = {"
f
I
S
Q
a
a
a
a
a
a
a
a
a
a
C
"}
(169,1,1) = {"
I
I
S
Q
a
a
a
a
a
a
a
a
a
a
C
"}
(170,1,1) = {"
I
I
S
Q
a
a
a
a
a
a
a
a
a
a
C
"}
(171,1,1) = {"
I
I
S
Q
a
a
a
a
a
a
a
a
a
a
C
"}
(172,1,1) = {"
I
I
S
Q
a
a
a
a
a
a
a
a
a
a
C
"}
(173,1,1) = {"
f
I
S
Q
a
a
a
a
a
a
a
a
a
a
C
"}
(174,1,1) = {"
f
I
S
Q
a
a
a
a
a
a
a
a
a
a
C
"}
(175,1,1) = {"
f
I
S
Q
a
a
a
a
a
a
a
a
a
a
C
"}
(176,1,1) = {"
f
I
S
Q
a
a
a
a
a
a
a
a
a
a
C
"}
(177,1,1) = {"
f
I
S
Q
a
a
a
a
a
a
a
a
a
a
C
"}
(178,1,1) = {"
f
I
S
Q
a
a
a
a
a
a
a
a
a
a
C
"}
(179,1,1) = {"
I
I
S
Q
a
a
a
a
a
a
a
a
a
a
C
"}
(180,1,1) = {"
f
I
S
Q
a
a
a
a
a
a
a
a
a
a
C
"}
(181,1,1) = {"
I
I
S
Q
a
a
a
a
a
a
a
a
a
a
C
"}
(182,1,1) = {"
f
I
S
Q
a
a
a
a
a
a
a
a
a
a
C
"}
(183,1,1) = {"
f
I
S
Q
a
a
a
a
a
a
a
a
a
a
C
"}
(184,1,1) = {"
f
I
S
Q
a
a
a
a
a
a
a
a
a
a
C
"}
(185,1,1) = {"
f
I
S
Q
a
a
a
a
a
a
a
a
a
a
C
"}
(186,1,1) = {"
f
I
S
Q
a
a
a
a
a
a
a
a
a
a
C
"}
(187,1,1) = {"
f
I
S
Q
a
a
a
a
a
a
a
a
a
a
C
"}
(188,1,1) = {"
f
I
S
Q
a
a
a
a
a
a
a
a
a
a
C
"}
(189,1,1) = {"
f
I
S
Q
a
a
a
a
a
a
a
a
a
a
C
"}
(190,1,1) = {"
f
I
S
Q
a
a
a
a
a
a
a
a
a
a
C
"}
(191,1,1) = {"
f
I
S
Q
a
a
a
a
a
a
a
a
a
a
C
"}
(192,1,1) = {"
f
I
S
Q
a
a
a
a
a
a
a
a
a
a
C
"}
(193,1,1) = {"
f
I
S
Q
a
a
a
a
a
a
a
a
a
a
C
"}
(194,1,1) = {"
f
c
S
Q
a
a
a
a
a
a
a
a
a
a
C
"}
(195,1,1) = {"
f
Y
S
Q
a
a
a
a
a
a
a
a
a
a
C
"}
(196,1,1) = {"
f
I
S
Q
a
a
a
a
a
a
a
a
a
a
C
"}
(197,1,1) = {"
f
c
S
Q
a
a
a
a
a
a
a
a
a
a
C
"}
(198,1,1) = {"
f
I
S
Q
a
a
a
a
a
a
a
a
a
a
C
"}
(199,1,1) = {"
f
I
S
Q
a
a
a
a
a
a
a
a
a
a
C
"}
(200,1,1) = {"
f
I
S
Q
W
a
a
a
a
a
a
a
a
a
C
"}
(201,1,1) = {"
f
I
S
Q
s
W
a
a
a
a
a
a
a
a
C
"}
(202,1,1) = {"
f
I
S
Q
z
b
o
a
a
a
a
a
a
a
C
"}
(203,1,1) = {"
f
I
S
Q
z
O
W
a
a
a
a
a
a
a
C
"}
(204,1,1) = {"
I
I
S
Q
z
x
i
o
a
a
a
a
a
a
C
"}
(205,1,1) = {"
I
I
S
Q
q
j
J
a
a
a
a
a
a
a
C
"}
(206,1,1) = {"
f
I
S
Q
j
a
a
a
a
a
a
a
a
a
C
"}
(207,1,1) = {"
f
I
S
Q
a
a
a
a
a
a
a
a
a
a
C
"}
(208,1,1) = {"
f
I
S
Q
a
a
a
a
a
a
a
a
a
a
C
"}
(209,1,1) = {"
I
I
S
Q
a
a
a
a
a
a
a
a
a
a
C
"}
(210,1,1) = {"
I
I
S
Q
a
a
a
a
a
a
a
a
a
a
C
"}
(211,1,1) = {"
I
I
S
Q
a
a
a
a
a
a
a
a
a
a
C
"}
(212,1,1) = {"
f
I
S
Q
a
a
a
a
a
a
a
a
a
a
C
"}
(213,1,1) = {"
f
I
S
Q
a
a
a
a
a
a
a
a
a
a
C
"}
(214,1,1) = {"
f
I
S
Q
a
a
a
a
a
a
a
a
a
a
C
"}
(215,1,1) = {"
f
I
S
Q
a
a
a
a
a
a
a
a
a
a
C
"}
(216,1,1) = {"
f
I
S
Q
a
a
a
a
a
a
a
a
a
a
C
"}
(217,1,1) = {"
f
I
S
Q
a
a
a
a
a
a
a
a
a
a
C
"}
(218,1,1) = {"
f
I
S
Q
a
a
a
a
a
a
a
a
a
a
C
"}
(219,1,1) = {"
f
I
S
Q
a
a
a
a
a
a
a
a
a
a
C
"}
(220,1,1) = {"
f
I
S
Q
a
a
a
a
a
a
a
a
a
a
C
"}
(221,1,1) = {"
f
I
S
Q
a
a
a
a
a
a
a
a
a
a
C
"}
(222,1,1) = {"
f
I
S
Q
a
a
a
a
a
a
a
a
a
a
C
"}
(223,1,1) = {"
f
I
S
Q
a
a
a
a
a
a
a
a
a
a
C
"}
(224,1,1) = {"
f
I
S
Q
a
a
a
a
a
a
a
a
a
a
C
"}
(225,1,1) = {"
f
I
S
Q
a
a
a
a
a
a
a
a
a
a
C
"}
(226,1,1) = {"
f
I
S
Q
a
a
a
a
a
a
a
a
a
a
C
"}
(227,1,1) = {"
f
I
S
Q
a
a
a
a
a
a
a
a
a
a
C
"}
(228,1,1) = {"
f
I
S
Q
a
a
a
a
a
a
a
a
a
a
C
"}
(229,1,1) = {"
f
I
v
Q
a
a
a
a
a
a
a
a
a
a
C
"}
(230,1,1) = {"
f
I
N
Q
a
a
a
a
a
a
a
a
a
a
C
"}
(231,1,1) = {"
I
I
N
Q
a
a
a
a
a
a
a
a
a
a
C
"}
(232,1,1) = {"
I
I
u
Q
a
a
a
a
a
a
a
a
a
a
C
"}
(233,1,1) = {"
f
I
A
Q
a
a
a
a
a
a
a
a
a
a
C
"}
(234,1,1) = {"
f
I
w
Q
W
a
a
a
a
a
a
a
a
a
C
"}
(235,1,1) = {"
f
I
v
Q
s
W
a
a
a
a
a
a
a
a
C
"}
(236,1,1) = {"
c
I
S
Q
d
i
o
a
a
a
a
a
a
a
C
"}
(237,1,1) = {"
c
I
S
Q
J
J
a
a
a
a
a
a
a
a
C
"}
(238,1,1) = {"
Y
c
S
Q
a
a
a
a
a
a
a
a
a
a
C
"}
(239,1,1) = {"
I
I
S
Q
a
a
a
a
a
a
a
a
a
a
C
"}
(240,1,1) = {"
f
I
S
Q
a
a
a
a
a
a
a
a
a
a
C
"}
(241,1,1) = {"
f
I
S
Q
a
a
a
a
a
a
a
a
a
a
C
"}
(242,1,1) = {"
f
I
S
Q
a
a
a
a
a
a
a
a
a
a
C
"}
(243,1,1) = {"
f
I
S
Q
a
a
a
a
a
a
a
a
a
a
C
"}
(244,1,1) = {"
f
I
S
Q
a
a
a
a
a
a
a
a
a
a
C
"}
(245,1,1) = {"
f
I
S
Q
a
a
a
a
a
a
a
a
a
a
C
"}
(246,1,1) = {"
I
I
S
Q
a
a
a
a
a
a
a
a
a
a
C
"}
(247,1,1) = {"
f
I
S
Q
a
a
a
a
a
a
a
a
a
a
C
"}
(248,1,1) = {"
I
I
S
Q
a
a
a
a
a
a
a
a
a
a
C
"}
(249,1,1) = {"
f
I
S
Q
a
a
a
a
a
a
a
a
a
a
C
"}
(250,1,1) = {"
f
I
S
Q
a
a
a
a
a
a
a
a
a
a
C
"}
(251,1,1) = {"
f
I
S
Q
a
a
a
a
a
a
a
a
a
a
C
"}
(252,1,1) = {"
f
I
S
Q
a
a
a
a
a
a
a
a
a
a
C
"}
(253,1,1) = {"
f
I
S
Q
a
a
a
a
a
a
a
a
a
a
C
"}
(254,1,1) = {"
I
I
S
Q
W
a
a
a
a
a
a
a
a
a
C
"}
(255,1,1) = {"
I
Y
S
Q
s
W
a
a
a
a
a
a
a
a
C
"}
