//MAP CONVERTED BY dmm2tgm.py THIS HEADER COMMENT PREVENTS RECONVERSION, DO NOT REMOVE
"a" = (
/turf/closed/indestructible/train_border,
/area/space)
"o" = (
/turf/closed/mineral/random/icy_planet,
/area/space)
"s" = (
/obj/structure/flora/grass/green/style_3,
/obj/structure/flora/grass/green/style_3,
/turf/open/floor/fake_snow/safe,
/area/space)
"D" = (
/obj/structure/flora/grass/green/style_3,
/turf/open/floor/fake_snow/safe,
/area/space)
"H" = (
/obj/structure/flora/tree/pine/style_random,
/obj/structure/flora/grass/green/style_3,
/turf/open/floor/fake_snow/safe,
/area/space)
"S" = (
/turf/open/floor/fake_snow/safe,
/area/space)
"T" = (
/obj/structure/flora/tree/pine/style_random,
/turf/open/floor/fake_snow/safe,
/area/space)

(1,1,1) = {"
S
S
D
S
S
o
o
o
o
o
o
o
o
o
o
o
o
o
o
o
o
o
o
o
a
"}
(2,1,1) = {"
S
S
S
D
S
S
S
o
o
o
o
o
o
o
o
o
o
o
o
o
o
o
o
o
a
"}
(3,1,1) = {"
S
S
D
D
S
S
S
S
o
o
o
o
o
o
o
o
o
o
o
o
o
o
o
o
a
"}
(4,1,1) = {"
S
S
S
S
S
S
S
S
o
o
o
o
o
o
o
o
o
o
o
o
o
o
o
o
a
"}
(5,1,1) = {"
S
S
S
D
S
S
S
S
o
o
o
o
o
o
o
o
o
o
o
o
o
o
o
o
a
"}
(6,1,1) = {"
S
S
S
S
S
S
S
S
S
o
o
o
o
o
o
o
o
o
o
o
o
o
o
o
a
"}
(7,1,1) = {"
S
S
D
S
D
S
S
S
S
o
o
o
o
o
o
o
o
o
o
o
o
o
o
o
a
"}
(8,1,1) = {"
S
S
S
S
D
S
S
S
S
o
o
o
o
o
o
o
o
o
o
o
o
o
o
o
a
"}
(9,1,1) = {"
S
S
S
S
S
S
S
S
S
o
o
o
o
o
o
o
o
o
o
o
o
o
o
o
a
"}
(10,1,1) = {"
S
S
S
S
S
D
T
S
S
o
o
o
o
o
o
o
o
o
o
o
o
o
o
o
a
"}
(11,1,1) = {"
S
D
S
S
S
S
S
T
S
o
o
o
o
o
o
o
o
o
o
o
o
o
o
o
a
"}
(12,1,1) = {"
S
S
S
S
S
S
S
S
S
o
o
o
o
o
o
o
o
o
o
o
o
o
o
o
a
"}
(13,1,1) = {"
S
S
S
S
S
S
S
T
S
o
o
o
o
o
o
o
o
o
o
o
o
o
o
o
a
"}
(14,1,1) = {"
S
D
S
S
S
S
S
S
S
o
o
o
o
o
o
o
o
o
o
o
o
o
o
o
a
"}
(15,1,1) = {"
S
S
S
S
S
S
S
T
S
o
o
o
o
o
o
o
o
o
o
o
o
o
o
o
a
"}
(16,1,1) = {"
S
S
S
S
S
H
S
S
D
o
o
o
o
o
o
o
o
o
o
o
o
o
o
o
a
"}
(17,1,1) = {"
S
S
S
S
S
D
T
S
S
o
o
o
o
o
o
o
o
o
o
o
o
o
o
o
a
"}
(18,1,1) = {"
S
S
D
S
S
D
S
S
S
o
o
o
o
o
o
o
o
o
o
o
o
o
o
o
a
"}
(19,1,1) = {"
S
S
S
S
D
S
T
S
S
o
o
o
o
o
o
o
o
o
o
o
o
o
o
o
a
"}
(20,1,1) = {"
S
S
S
H
T
T
S
T
S
o
o
o
o
o
o
o
o
o
o
o
o
o
o
o
a
"}
(21,1,1) = {"
S
S
S
S
S
S
H
S
S
o
o
o
o
o
o
o
o
o
o
o
o
o
o
o
a
"}
(22,1,1) = {"
S
S
H
S
S
S
S
T
S
o
o
o
o
o
o
o
o
o
o
o
o
o
o
o
a
"}
(23,1,1) = {"
S
S
D
S
S
S
T
S
S
o
o
o
o
o
o
o
o
o
o
o
o
o
o
o
a
"}
(24,1,1) = {"
S
S
s
S
S
H
S
T
S
o
o
o
o
o
o
o
o
o
o
o
o
o
o
o
a
"}
(25,1,1) = {"
S
S
S
S
S
S
S
S
S
o
o
o
o
o
o
o
o
o
o
o
o
o
o
o
a
"}
(26,1,1) = {"
S
S
S
T
D
S
S
T
o
o
o
o
o
o
o
o
o
o
o
o
o
o
o
o
a
"}
(27,1,1) = {"
S
S
S
S
D
S
T
S
o
o
o
o
o
o
o
o
o
o
o
o
o
o
o
o
a
"}
(28,1,1) = {"
S
S
D
S
S
S
S
S
o
o
o
o
o
o
o
o
o
o
o
o
o
o
o
o
a
"}
(29,1,1) = {"
S
S
S
D
S
S
S
T
o
o
o
o
o
o
o
o
o
o
o
o
o
o
o
o
a
"}
(30,1,1) = {"
S
S
D
S
S
S
T
S
o
o
o
o
o
o
o
o
o
o
o
o
o
o
o
o
a
"}
(31,1,1) = {"
S
S
S
S
S
S
S
S
o
o
o
o
o
o
o
o
o
o
o
o
o
o
o
o
a
"}
(32,1,1) = {"
S
S
D
D
S
S
S
o
o
o
o
o
o
o
o
o
o
o
o
o
o
o
o
o
a
"}
(33,1,1) = {"
S
S
D
S
S
S
S
o
o
o
o
o
o
o
o
o
o
o
o
o
o
o
o
o
a
"}
(34,1,1) = {"
S
S
S
S
S
S
S
o
o
o
o
o
o
o
o
o
o
o
o
o
o
o
o
o
a
"}
(35,1,1) = {"
S
S
D
S
S
S
S
o
o
o
o
o
o
o
o
o
o
o
o
o
o
o
o
o
a
"}
(36,1,1) = {"
S
S
S
S
S
S
S
o
o
o
o
o
o
o
o
o
o
o
o
o
o
o
o
o
a
"}
(37,1,1) = {"
S
S
S
S
S
S
S
o
o
o
o
o
o
o
o
o
o
o
o
o
o
o
o
o
a
"}
(38,1,1) = {"
S
S
S
S
S
S
S
o
o
o
o
o
o
o
o
o
o
o
o
o
o
o
o
o
a
"}
(39,1,1) = {"
S
S
S
S
S
S
S
o
o
o
o
o
o
o
o
o
o
o
o
o
o
o
o
o
a
"}
(40,1,1) = {"
S
S
S
S
S
S
S
o
o
o
o
o
o
o
o
o
o
o
o
o
o
o
o
o
a
"}
(41,1,1) = {"
S
S
D
S
S
S
S
o
o
o
o
o
o
o
o
o
o
o
o
o
o
o
o
o
a
"}
(42,1,1) = {"
S
S
S
S
S
S
S
o
o
o
o
o
o
o
o
o
o
o
o
o
o
o
o
o
a
"}
(43,1,1) = {"
S
S
S
S
S
S
S
o
o
o
o
o
o
o
o
o
o
o
o
o
o
o
o
o
a
"}
(44,1,1) = {"
S
S
S
S
S
S
S
o
o
o
o
o
o
o
o
o
o
o
o
o
o
o
o
o
a
"}
(45,1,1) = {"
S
S
D
S
S
S
S
o
o
o
o
o
o
o
o
o
o
o
o
o
o
o
o
o
a
"}
(46,1,1) = {"
S
S
S
S
S
S
S
o
o
o
o
o
o
o
o
o
o
o
o
o
o
o
o
o
a
"}
(47,1,1) = {"
S
S
S
S
S
S
S
o
o
o
o
o
o
o
o
o
o
o
o
o
o
o
o
o
a
"}
(48,1,1) = {"
S
S
S
S
S
S
S
o
o
o
o
o
o
o
o
o
o
o
o
o
o
o
o
o
a
"}
(49,1,1) = {"
S
S
S
D
S
S
S
o
o
o
o
o
o
o
o
o
o
o
o
o
o
o
o
o
a
"}
(50,1,1) = {"
S
S
S
S
S
S
S
S
o
o
o
o
o
o
o
o
o
o
o
o
o
o
o
o
a
"}
(51,1,1) = {"
S
S
S
S
S
S
S
S
o
o
o
o
o
o
o
o
o
o
o
o
o
o
o
o
a
"}
(52,1,1) = {"
S
S
S
D
S
S
S
S
o
o
o
o
o
o
o
o
o
o
o
o
o
o
o
o
a
"}
(53,1,1) = {"
S
S
S
T
S
S
S
S
o
o
o
o
o
o
o
o
o
o
o
o
o
o
o
o
a
"}
(54,1,1) = {"
S
S
S
S
T
S
S
S
o
o
o
o
o
o
o
o
o
o
o
o
o
o
o
o
a
"}
(55,1,1) = {"
S
S
S
D
S
T
S
S
o
o
o
o
o
o
o
o
o
o
o
o
o
o
o
o
a
"}
(56,1,1) = {"
S
S
S
S
T
S
T
S
o
o
o
o
o
o
o
o
o
o
o
o
o
o
o
o
a
"}
(57,1,1) = {"
S
S
T
T
S
S
S
S
o
o
o
o
o
o
o
o
o
o
o
o
o
o
o
o
a
"}
(58,1,1) = {"
S
S
S
S
T
S
T
S
o
o
o
o
o
o
o
o
o
o
o
o
o
o
o
o
a
"}
(59,1,1) = {"
S
S
S
D
S
T
S
S
o
o
o
o
o
o
o
o
o
o
o
o
o
o
o
o
a
"}
(60,1,1) = {"
S
S
S
S
T
S
T
S
o
o
o
o
o
o
o
o
o
o
o
o
o
o
o
o
a
"}
(61,1,1) = {"
S
S
S
H
S
S
S
S
S
o
o
o
o
o
o
o
o
o
o
o
o
o
o
o
a
"}
(62,1,1) = {"
S
S
S
S
S
D
S
S
S
o
o
o
o
o
o
o
o
o
o
o
o
o
o
o
a
"}
(63,1,1) = {"
S
S
S
T
S
T
S
S
S
o
o
o
o
o
o
o
o
o
o
o
o
o
o
o
a
"}
(64,1,1) = {"
S
T
T
D
S
S
T
S
S
o
o
o
o
o
o
o
o
o
o
o
o
o
o
o
a
"}
(65,1,1) = {"
S
S
S
T
S
S
S
S
S
o
o
o
o
o
o
o
o
o
o
o
o
o
o
o
a
"}
(66,1,1) = {"
S
S
S
S
S
S
T
S
S
o
o
o
o
o
o
o
o
o
o
o
o
o
o
o
a
"}
(67,1,1) = {"
S
S
S
H
T
H
S
S
o
o
o
o
o
o
o
o
o
o
o
o
o
o
o
o
a
"}
(68,1,1) = {"
S
S
H
S
S
S
T
S
o
o
o
o
o
o
o
o
o
o
o
o
o
o
o
o
a
"}
(69,1,1) = {"
S
S
D
S
S
S
S
S
o
o
o
o
o
o
o
o
o
o
o
o
o
o
o
o
a
"}
(70,1,1) = {"
S
S
S
H
S
S
T
o
o
o
o
o
o
o
o
o
o
o
o
o
o
o
o
o
a
"}
(71,1,1) = {"
S
S
T
S
S
T
S
o
o
o
o
o
o
o
o
o
o
o
o
o
o
o
o
o
a
"}
(72,1,1) = {"
S
S
S
S
S
S
S
o
o
o
o
o
o
o
o
o
o
o
o
o
o
o
o
o
a
"}
(73,1,1) = {"
S
S
S
D
D
S
S
o
o
o
o
o
o
o
o
o
o
o
o
o
o
o
o
o
a
"}
(74,1,1) = {"
S
S
D
S
S
S
S
o
o
o
o
o
o
o
o
o
o
o
o
o
o
o
o
o
a
"}
(75,1,1) = {"
S
S
S
S
S
S
o
o
o
o
o
o
o
o
o
o
o
o
o
o
o
o
o
o
a
"}
(76,1,1) = {"
S
S
S
S
S
S
o
o
o
o
o
o
o
o
o
o
o
o
o
o
o
o
o
o
a
"}
(77,1,1) = {"
S
S
S
D
S
S
o
o
o
o
o
o
o
o
o
o
o
o
o
o
o
o
o
o
a
"}
(78,1,1) = {"
S
S
S
S
S
S
o
o
o
o
o
o
o
o
o
o
o
o
o
o
o
o
o
o
a
"}
(79,1,1) = {"
S
D
S
S
S
S
o
o
o
o
o
o
o
o
o
o
o
o
o
o
o
o
o
o
a
"}
(80,1,1) = {"
S
S
S
D
S
S
o
o
o
o
o
o
o
o
o
o
o
o
o
o
o
o
o
o
a
"}
(81,1,1) = {"
S
S
S
S
S
S
o
o
o
o
o
o
o
o
o
o
o
o
o
o
o
o
o
o
a
"}
(82,1,1) = {"
S
D
S
D
S
o
o
o
o
o
o
o
o
o
o
o
o
o
o
o
o
o
o
o
a
"}
(83,1,1) = {"
S
S
S
S
S
o
o
o
o
o
o
o
o
o
o
o
o
o
o
o
o
o
o
o
a
"}
(84,1,1) = {"
S
S
S
S
S
o
o
o
o
o
o
o
o
o
o
o
o
o
o
o
o
o
o
o
a
"}
(85,1,1) = {"
S
D
S
S
S
o
o
o
o
o
o
o
o
o
o
o
o
o
o
o
o
o
o
o
a
"}
(86,1,1) = {"
S
S
S
S
S
o
o
o
o
o
o
o
o
o
o
o
o
o
o
o
o
o
o
o
a
"}
(87,1,1) = {"
S
S
D
S
S
o
o
o
o
o
o
o
o
o
o
o
o
o
o
o
o
o
o
o
a
"}
(88,1,1) = {"
S
S
S
S
S
o
o
o
o
o
o
o
o
o
o
o
o
o
o
o
o
o
o
o
a
"}
(89,1,1) = {"
S
S
S
S
S
o
o
o
o
o
o
o
o
o
o
o
o
o
o
o
o
o
o
o
a
"}
(90,1,1) = {"
S
S
S
S
D
o
o
o
o
o
o
o
o
o
o
o
o
o
o
o
o
o
o
o
a
"}
(91,1,1) = {"
S
S
S
S
S
o
o
o
o
o
o
o
o
o
o
o
o
o
o
o
o
o
o
o
a
"}
(92,1,1) = {"
S
S
S
S
S
o
o
o
o
o
o
o
o
o
o
o
o
o
o
o
o
o
o
o
a
"}
(93,1,1) = {"
S
S
S
S
S
o
o
o
o
o
o
o
o
o
o
o
o
o
o
o
o
o
o
o
a
"}
(94,1,1) = {"
S
S
S
S
S
o
o
o
o
o
o
o
o
o
o
o
o
o
o
o
o
o
o
o
a
"}
(95,1,1) = {"
S
S
D
S
S
o
o
o
o
o
o
o
o
o
o
o
o
o
o
o
o
o
o
o
a
"}
(96,1,1) = {"
S
S
S
S
S
o
o
o
o
o
o
o
o
o
o
o
o
o
o
o
o
o
o
o
a
"}
(97,1,1) = {"
S
S
S
S
S
o
o
o
o
o
o
o
o
o
o
o
o
o
o
o
o
o
o
o
a
"}
(98,1,1) = {"
S
S
S
S
S
o
o
o
o
o
o
o
o
o
o
o
o
o
o
o
o
o
o
o
a
"}
(99,1,1) = {"
S
S
S
S
S
o
o
o
o
o
o
o
o
o
o
o
o
o
o
o
o
o
o
o
a
"}
(100,1,1) = {"
S
S
D
S
S
o
o
o
o
o
o
o
o
o
o
o
o
o
o
o
o
o
o
o
a
"}
(101,1,1) = {"
S
S
S
S
S
o
o
o
o
o
o
o
o
o
o
o
o
o
o
o
o
o
o
o
a
"}
(102,1,1) = {"
S
S
S
S
S
o
o
o
o
o
o
o
o
o
o
o
o
o
o
o
o
o
o
o
a
"}
(103,1,1) = {"
S
S
S
S
D
S
o
o
o
o
o
o
o
o
o
o
o
o
o
o
o
o
o
o
a
"}
(104,1,1) = {"
S
D
S
S
S
S
o
o
o
o
o
o
o
o
o
o
o
o
o
o
o
o
o
o
a
"}
(105,1,1) = {"
S
S
S
S
S
S
o
o
o
o
o
o
o
o
o
o
o
o
o
o
o
o
o
o
a
"}
(106,1,1) = {"
S
D
S
S
S
S
o
o
o
o
o
o
o
o
o
o
o
o
o
o
o
o
o
o
a
"}
(107,1,1) = {"
S
S
S
S
S
S
o
o
o
o
o
o
o
o
o
o
o
o
o
o
o
o
o
o
a
"}
(108,1,1) = {"
S
S
S
S
S
S
S
o
o
o
o
o
o
o
o
o
o
o
o
o
o
o
o
o
a
"}
(109,1,1) = {"
S
S
S
S
S
S
S
o
o
o
o
o
o
o
o
o
o
o
o
o
o
o
o
o
a
"}
(110,1,1) = {"
S
S
D
S
S
S
S
o
o
o
o
o
o
o
o
o
o
o
o
o
o
o
o
o
a
"}
(111,1,1) = {"
S
S
S
S
S
S
S
o
o
o
o
o
o
o
o
o
o
o
o
o
o
o
o
o
a
"}
(112,1,1) = {"
S
S
D
D
S
S
S
o
o
o
o
o
o
o
o
o
o
o
o
o
o
o
o
o
a
"}
(113,1,1) = {"
S
S
S
S
S
S
S
o
o
o
o
o
o
o
o
o
o
o
o
o
o
o
o
o
a
"}
(114,1,1) = {"
S
S
S
S
S
S
S
o
o
o
o
o
o
o
o
o
o
o
o
o
o
o
o
o
a
"}
(115,1,1) = {"
S
S
D
D
S
S
S
o
o
o
o
o
o
o
o
o
o
o
o
o
o
o
o
o
a
"}
(116,1,1) = {"
S
S
S
S
S
S
S
o
o
o
o
o
o
o
o
o
o
o
o
o
o
o
o
o
a
"}
(117,1,1) = {"
S
S
S
S
S
S
S
S
o
o
o
o
o
o
o
o
o
o
o
o
o
o
o
o
a
"}
(118,1,1) = {"
S
S
D
D
S
S
S
S
o
o
o
o
o
o
o
o
o
o
o
o
o
o
o
o
a
"}
(119,1,1) = {"
S
S
S
S
S
S
S
S
o
o
o
o
o
o
o
o
o
o
o
o
o
o
o
o
a
"}
(120,1,1) = {"
S
S
H
D
S
S
S
S
o
o
o
o
o
o
o
o
o
o
o
o
o
o
o
o
a
"}
(121,1,1) = {"
S
S
S
T
S
S
S
S
S
o
o
o
o
o
o
o
o
o
o
o
o
o
o
o
a
"}
(122,1,1) = {"
S
S
S
S
S
S
S
S
S
o
o
o
o
o
o
o
o
o
o
o
o
o
o
o
a
"}
(123,1,1) = {"
S
S
S
T
D
T
S
S
S
o
o
o
o
o
o
o
o
o
o
o
o
o
o
o
a
"}
(124,1,1) = {"
S
T
T
S
D
S
T
S
S
o
o
o
o
o
o
o
o
o
o
o
o
o
o
o
a
"}
(125,1,1) = {"
S
S
S
H
D
S
S
S
S
o
o
o
o
o
o
o
o
o
o
o
o
o
o
o
a
"}
(126,1,1) = {"
S
S
S
D
D
S
T
S
S
o
o
o
o
o
o
o
o
o
o
o
o
o
o
o
a
"}
(127,1,1) = {"
S
S
S
S
S
T
S
S
S
o
o
o
o
o
o
o
o
o
o
o
o
o
o
o
a
"}
(128,1,1) = {"
S
S
D
S
S
S
T
S
S
o
o
o
o
o
o
o
o
o
o
o
o
o
o
o
a
"}
(129,1,1) = {"
S
S
S
T
S
S
S
S
S
o
o
o
o
o
o
o
o
o
o
o
o
o
o
o
a
"}
(130,1,1) = {"
S
D
S
S
T
S
T
S
S
o
o
o
o
o
o
o
o
o
o
o
o
o
o
o
a
"}
(131,1,1) = {"
S
T
S
S
S
S
S
S
S
o
o
o
o
o
o
o
o
o
o
o
o
o
o
o
a
"}
(132,1,1) = {"
S
S
S
S
T
S
S
S
S
o
o
o
o
o
o
o
o
o
o
o
o
o
o
o
a
"}
(133,1,1) = {"
S
S
T
T
S
S
S
S
S
o
o
o
o
o
o
o
o
o
o
o
o
o
o
o
a
"}
(134,1,1) = {"
S
D
S
S
T
T
S
S
S
o
o
o
o
o
o
o
o
o
o
o
o
o
o
o
a
"}
(135,1,1) = {"
T
H
S
S
S
D
S
S
S
o
o
o
o
o
o
o
o
o
o
o
o
o
o
o
a
"}
(136,1,1) = {"
S
S
S
S
T
T
S
S
S
o
o
o
o
o
o
o
o
o
o
o
o
o
o
o
a
"}
(137,1,1) = {"
S
D
S
T
S
D
S
S
S
o
o
o
o
o
o
o
o
o
o
o
o
o
o
o
a
"}
(138,1,1) = {"
S
D
S
S
S
H
S
S
S
o
o
o
o
o
o
o
o
o
o
o
o
o
o
o
a
"}
(139,1,1) = {"
S
T
S
S
S
S
S
S
S
o
o
o
o
o
o
o
o
o
o
o
o
o
o
o
a
"}
(140,1,1) = {"
D
S
S
S
S
T
S
S
S
o
o
o
o
o
o
o
o
o
o
o
o
o
o
o
a
"}
(141,1,1) = {"
S
S
S
S
T
D
S
S
S
o
o
o
o
o
o
o
o
o
o
o
o
o
o
o
a
"}
(142,1,1) = {"
D
S
S
S
S
S
S
S
o
o
o
o
o
o
o
o
o
o
o
o
o
o
o
o
a
"}
(143,1,1) = {"
S
S
S
S
S
S
S
S
o
o
o
o
o
o
o
o
o
o
o
o
o
o
o
o
a
"}
(144,1,1) = {"
S
S
S
S
S
D
S
S
o
o
o
o
o
o
o
o
o
o
o
o
o
o
o
o
a
"}
(145,1,1) = {"
D
S
S
S
S
S
S
S
o
o
o
o
o
o
o
o
o
o
o
o
o
o
o
o
a
"}
(146,1,1) = {"
S
S
S
S
S
S
S
S
o
o
o
o
o
o
o
o
o
o
o
o
o
o
o
o
a
"}
(147,1,1) = {"
S
S
S
S
S
D
S
S
o
o
o
o
o
o
o
o
o
o
o
o
o
o
o
o
a
"}
(148,1,1) = {"
S
S
S
S
S
S
S
o
o
o
o
o
o
o
o
o
o
o
o
o
o
o
o
o
a
"}
(149,1,1) = {"
S
S
S
S
S
S
S
o
o
o
o
o
o
o
o
o
o
o
o
o
o
o
o
o
a
"}
(150,1,1) = {"
S
S
S
S
D
S
S
o
o
o
o
o
o
o
o
o
o
o
o
o
o
o
o
o
a
"}
(151,1,1) = {"
S
S
S
S
S
S
S
o
o
o
o
o
o
o
o
o
o
o
o
o
o
o
o
o
a
"}
(152,1,1) = {"
S
S
S
S
S
S
S
o
o
o
o
o
o
o
o
o
o
o
o
o
o
o
o
o
a
"}
(153,1,1) = {"
S
S
S
S
S
S
S
o
o
o
o
o
o
o
o
o
o
o
o
o
o
o
o
o
a
"}
(154,1,1) = {"
D
S
S
S
S
S
o
o
o
o
o
o
o
o
o
o
o
o
o
o
o
o
o
o
a
"}
(155,1,1) = {"
S
S
S
S
S
S
o
o
o
o
o
o
o
o
o
o
o
o
o
o
o
o
o
o
a
"}
(156,1,1) = {"
S
S
S
S
D
S
o
o
o
o
o
o
o
o
o
o
o
o
o
o
o
o
o
o
a
"}
(157,1,1) = {"
D
S
S
S
S
S
o
o
o
o
o
o
o
o
o
o
o
o
o
o
o
o
o
o
a
"}
(158,1,1) = {"
S
S
S
S
S
S
o
o
o
o
o
o
o
o
o
o
o
o
o
o
o
o
o
o
a
"}
(159,1,1) = {"
S
S
S
S
S
S
o
o
o
o
o
o
o
o
o
o
o
o
o
o
o
o
o
o
a
"}
(160,1,1) = {"
D
S
S
S
S
S
o
o
o
o
o
o
o
o
o
o
o
o
o
o
o
o
o
o
a
"}
(161,1,1) = {"
S
S
S
D
S
S
o
o
o
o
o
o
o
o
o
o
o
o
o
o
o
o
o
o
a
"}
(162,1,1) = {"
S
S
S
S
S
S
o
o
o
o
o
o
o
o
o
o
o
o
o
o
o
o
o
o
a
"}
(163,1,1) = {"
S
D
D
S
S
S
o
o
o
o
o
o
o
o
o
o
o
o
o
o
o
o
o
o
a
"}
(164,1,1) = {"
S
S
S
S
S
S
o
o
o
o
o
o
o
o
o
o
o
o
o
o
o
o
o
o
a
"}
(165,1,1) = {"
S
D
S
S
S
S
o
o
o
o
o
o
o
o
o
o
o
o
o
o
o
o
o
o
a
"}
(166,1,1) = {"
S
S
S
S
S
o
o
o
o
o
o
o
o
o
o
o
o
o
o
o
o
o
o
o
a
"}
(167,1,1) = {"
S
S
S
D
S
o
o
o
o
o
o
o
o
o
o
o
o
o
o
o
o
o
o
o
a
"}
(168,1,1) = {"
S
D
S
D
S
o
o
o
o
o
o
o
o
o
o
o
o
o
o
o
o
o
o
o
a
"}
(169,1,1) = {"
S
D
S
S
S
o
o
o
o
o
o
o
o
o
o
o
o
o
o
o
o
o
o
o
a
"}
(170,1,1) = {"
S
D
D
D
S
o
o
o
o
o
o
o
o
o
o
o
o
o
o
o
o
o
o
o
a
"}
(171,1,1) = {"
S
D
S
S
S
o
o
o
o
o
o
o
o
o
o
o
o
o
o
o
o
o
o
o
a
"}
(172,1,1) = {"
S
S
S
D
S
o
o
o
o
o
o
o
o
o
o
o
o
o
o
o
o
o
o
o
a
"}
(173,1,1) = {"
S
S
S
S
S
o
o
o
o
o
o
o
o
o
o
o
o
o
o
o
o
o
o
o
a
"}
(174,1,1) = {"
S
S
D
S
S
o
o
o
o
o
o
o
o
o
o
o
o
o
o
o
o
o
o
o
a
"}
(175,1,1) = {"
S
S
D
S
S
o
o
o
o
o
o
o
o
o
o
o
o
o
o
o
o
o
o
o
a
"}
(176,1,1) = {"
S
S
D
S
S
o
o
o
o
o
o
o
o
o
o
o
o
o
o
o
o
o
o
o
a
"}
(177,1,1) = {"
S
S
D
S
S
S
o
o
o
o
o
o
o
o
o
o
o
o
o
o
o
o
o
o
a
"}
(178,1,1) = {"
S
S
D
S
D
S
o
o
o
o
o
o
o
o
o
o
o
o
o
o
o
o
o
o
a
"}
(179,1,1) = {"
S
S
D
S
S
S
o
o
o
o
o
o
o
o
o
o
o
o
o
o
o
o
o
o
a
"}
(180,1,1) = {"
S
S
D
S
S
S
o
o
o
o
o
o
o
o
o
o
o
o
o
o
o
o
o
o
a
"}
(181,1,1) = {"
S
S
S
S
D
S
o
o
o
o
o
o
o
o
o
o
o
o
o
o
o
o
o
o
a
"}
(182,1,1) = {"
S
S
S
S
S
S
o
o
o
o
o
o
o
o
o
o
o
o
o
o
o
o
o
o
a
"}
(183,1,1) = {"
S
S
S
D
S
S
o
o
o
o
o
o
o
o
o
o
o
o
o
o
o
o
o
o
a
"}
(184,1,1) = {"
S
T
S
S
S
S
o
o
o
o
o
o
o
o
o
o
o
o
o
o
o
o
o
o
a
"}
(185,1,1) = {"
S
S
T
D
S
S
o
o
o
o
o
o
o
o
o
o
o
o
o
o
o
o
o
o
a
"}
(186,1,1) = {"
S
D
S
S
S
S
o
o
o
o
o
o
o
o
o
o
o
o
o
o
o
o
o
o
a
"}
(187,1,1) = {"
S
D
S
S
S
S
o
o
o
o
o
o
o
o
o
o
o
o
o
o
o
o
o
o
a
"}
(188,1,1) = {"
S
H
S
S
S
S
o
o
o
o
o
o
o
o
o
o
o
o
o
o
o
o
o
o
a
"}
(189,1,1) = {"
S
S
S
T
S
S
o
o
o
o
o
o
o
o
o
o
o
o
o
o
o
o
o
o
a
"}
(190,1,1) = {"
S
D
S
S
T
S
o
o
o
o
o
o
o
o
o
o
o
o
o
o
o
o
o
o
a
"}
(191,1,1) = {"
S
S
S
S
S
S
o
o
o
o
o
o
o
o
o
o
o
o
o
o
o
o
o
o
a
"}
(192,1,1) = {"
T
H
S
S
T
S
o
o
o
o
o
o
o
o
o
o
o
o
o
o
o
o
o
o
a
"}
(193,1,1) = {"
S
S
T
T
S
S
o
o
o
o
o
o
o
o
o
o
o
o
o
o
o
o
o
o
a
"}
(194,1,1) = {"
S
S
S
S
T
S
o
o
o
o
o
o
o
o
o
o
o
o
o
o
o
o
o
o
a
"}
(195,1,1) = {"
S
S
S
S
S
S
o
o
o
o
o
o
o
o
o
o
o
o
o
o
o
o
o
o
a
"}
(196,1,1) = {"
T
D
S
S
T
S
o
o
o
o
o
o
o
o
o
o
o
o
o
o
o
o
o
o
a
"}
(197,1,1) = {"
S
T
S
T
S
S
S
o
o
o
o
o
o
o
o
o
o
o
o
o
o
o
o
o
a
"}
(198,1,1) = {"
S
S
S
S
S
S
S
o
o
o
o
o
o
o
o
o
o
o
o
o
o
o
o
o
a
"}
(199,1,1) = {"
S
T
S
T
S
S
S
S
o
o
o
o
o
o
o
o
o
o
o
o
o
o
o
o
a
"}
(200,1,1) = {"
T
S
S
S
T
S
S
S
o
o
o
o
o
o
o
o
o
o
o
o
o
o
o
o
a
"}
