//MAP CONVERTED BY dmm2tgm.py THIS HEADER COMMENT PREVENTS RECONVERSION, DO NOT REMOVE
"a" = (
/obj/structure/flora/tree/pine/style_random,
/obj/effect/light_emitter/daylight,
/turf/open/misc/asteroid/snow/indestructible,
/area/trainstation/outdoor)
"e" = (
/obj/effect/light_emitter/daylight,
/turf/open/misc/asteroid/snow/indestructible,
/area/trainstation/outdoor)
"f" = (
/mob/living/basic/mining/wolf,
/obj/effect/light_emitter/daylight,
/turf/open/misc/asteroid/snow/standard_air,
/area/trainstation/outdoor)
"g" = (
/obj/effect/light_emitter/daylight,
/turf/closed/indestructible/rock/snow/ice/ore,
/area/trainstation/outdoor)
"o" = (
/obj/structure/flora/tree/dead/style_random,
/obj/effect/light_emitter/daylight,
/turf/open/misc/asteroid/snow/indestructible,
/area/trainstation/outdoor)
"r" = (
/mob/living/basic/mining/wolf,
/obj/effect/light_emitter/daylight,
/turf/open/misc/asteroid/snow/indestructible,
/area/trainstation/outdoor)
"w" = (
/mob/living/basic/bear/snow,
/obj/effect/light_emitter/daylight,
/turf/open/misc/asteroid/snow/standard_air,
/area/trainstation/outdoor)
"E" = (
/obj/structure/flora/rock/style_random,
/obj/effect/light_emitter/daylight,
/turf/open/misc/asteroid/snow/indestructible,
/area/trainstation/outdoor)
"I" = (
/obj/structure/flora/tree/pine/style_random,
/mob/living/basic/mining/wolf,
/obj/effect/light_emitter/daylight,
/turf/open/misc/asteroid/snow/indestructible,
/area/trainstation/outdoor)
"M" = (
/mob/living/basic/bear/snow,
/obj/effect/light_emitter/daylight,
/turf/open/misc/asteroid/snow/indestructible,
/area/trainstation/outdoor)
"N" = (
/obj/structure/flora/tree/pine/style_random,
/mob/living/basic/bear/snow,
/obj/effect/light_emitter/daylight,
/turf/open/misc/asteroid/snow/indestructible,
/area/trainstation/outdoor)
"P" = (
/obj/structure/flora/bush/snow/style_random,
/obj/effect/light_emitter/daylight,
/turf/open/misc/asteroid/snow/indestructible,
/area/trainstation/outdoor)
"X" = (
/obj/effect/light_emitter/daylight,
/turf/open/misc/asteroid/snow/standard_air,
/area/trainstation/outdoor)

(1,1,1) = {"
X
X
X
X
X
X
X
X
X
X
X
X
a
e
e
e
e
e
e
e
P
e
X
e
P
e
X
X
a
e
e
e
e
a
e
e
e
a
X
g
"}
(2,1,1) = {"
X
X
X
X
X
a
e
e
e
e
e
e
e
P
e
X
e
a
e
e
e
a
X
e
e
a
X
X
e
o
e
e
e
a
P
a
e
a
X
g
"}
(3,1,1) = {"
X
X
a
e
e
e
e
e
e
e
P
e
X
e
a
X
a
e
E
P
e
e
a
P
e
e
a
X
a
e
E
e
e
e
a
e
e
e
a
g
"}
(4,1,1) = {"
X
X
e
o
e
e
e
a
e
e
e
a
X
e
e
a
a
a
e
P
P
e
e
P
P
e
e
X
X
X
X
e
a
e
e
e
a
e
e
g
"}
(5,1,1) = {"
X
X
a
e
E
e
a
e
E
P
e
e
a
P
e
e
e
r
e
a
P
e
a
a
P
e
a
X
o
X
X
e
e
P
a
e
a
P
a
g
"}
(6,1,1) = {"
X
X
X
X
X
e
a
a
e
P
P
e
e
P
e
a
e
e
e
e
a
e
e
e
a
e
e
X
e
e
X
M
e
a
e
e
e
X
e
g
"}
(7,1,1) = {"
X
X
o
X
X
e
e
e
e
a
P
e
a
a
e
e
e
a
e
e
e
E
e
e
e
E
e
X
e
X
e
e
e
a
P
a
e
e
e
g
"}
(8,1,1) = {"
e
e
e
e
e
e
e
P
e
X
a
e
e
e
E
e
a
e
E
P
a
e
a
P
a
e
a
e
e
P
e
X
e
X
X
a
e
e
a
g
"}
(9,1,1) = {"
o
e
e
e
a
e
e
e
a
X
e
E
e
a
e
a
e
X
X
a
e
e
e
a
e
e
e
e
e
e
a
X
P
e
e
X
a
e
e
g
"}
(10,1,1) = {"
e
E
e
a
e
E
P
e
e
a
a
e
e
e
a
e
e
e
E
e
e
e
E
e
a
e
e
e
a
e
e
e
e
e
a
e
e
e
X
g
"}
(11,1,1) = {"
X
X
e
a
a
e
P
P
e
e
e
E
e
a
e
E
P
a
e
a
P
a
e
a
e
E
e
a
e
E
P
a
a
e
a
P
a
e
e
g
"}
(12,1,1) = {"
X
X
e
e
e
e
a
P
e
a
a
e
a
e
X
X
a
e
e
e
a
e
e
e
a
e
a
e
X
X
a
e
a
e
e
e
a
e
e
g
"}
(13,1,1) = {"
e
e
e
e
e
e
e
P
e
X
e
e
e
a
e
X
e
e
e
X
e
e
e
X
e
e
e
a
e
X
e
e
a
P
a
e
a
e
X
g
"}
(14,1,1) = {"
o
e
e
e
a
e
e
e
a
X
e
e
X
e
e
X
a
a
e
e
a
X
X
a
e
e
X
e
e
X
a
a
e
a
e
e
e
e
X
g
"}
(15,1,1) = {"
e
E
e
a
e
E
P
e
e
X
a
e
e
X
e
X
X
a
e
e
X
X
X
e
e
E
e
X
e
X
X
a
e
e
e
a
e
a
X
g
"}
(16,1,1) = {"
X
X
e
a
a
e
P
P
e
X
a
e
e
X
e
e
e
X
a
e
e
X
X
a
N
e
a
X
e
e
e
X
P
a
e
a
P
e
X
g
"}
(17,1,1) = {"
X
X
e
e
e
e
a
e
e
e
e
e
e
X
a
a
e
e
e
E
e
X
X
X
e
e
e
X
a
a
e
e
e
e
a
e
e
e
X
g
"}
(18,1,1) = {"
e
X
e
a
e
e
e
a
e
e
X
a
e
e
e
e
e
e
e
P
e
X
X
o
e
e
X
e
e
e
e
e
e
e
a
P
a
e
X
g
"}
(19,1,1) = {"
X
e
e
e
E
e
a
e
E
P
X
e
o
e
e
e
a
e
e
e
a
f
X
e
X
X
a
e
e
e
a
e
e
e
e
a
e
e
X
g
"}
(20,1,1) = {"
X
a
e
a
e
a
e
X
X
a
e
e
e
a
e
e
X
e
X
X
a
e
e
X
X
X
e
P
a
e
a
P
e
a
e
e
e
a
X
g
"}
(21,1,1) = {"
e
e
X
e
e
e
a
e
X
e
e
e
X
a
e
e
X
e
e
e
X
a
e
e
X
X
a
a
e
e
e
a
a
e
P
a
e
a
X
g
"}
(22,1,1) = {"
E
P
e
e
e
X
e
e
X
a
a
e
e
e
e
e
X
a
a
e
e
e
E
e
X
X
X
e
e
e
X
e
e
e
e
a
e
e
X
g
"}
(23,1,1) = {"
X
a
e
a
e
e
X
e
X
X
a
e
e
X
a
e
e
e
e
e
e
e
P
e
X
X
o
e
a
e
e
e
e
a
e
e
e
a
X
g
"}
(24,1,1) = {"
X
e
e
a
e
e
X
e
e
e
X
a
e
X
e
o
e
e
e
a
e
e
e
a
X
X
e
a
e
E
P
a
X
e
P
a
e
a
X
g
"}
(25,1,1) = {"
e
e
a
e
e
e
a
X
a
e
e
e
E
e
X
X
X
a
e
e
e
a
e
e
a
e
a
e
X
X
a
e
e
e
a
P
a
e
X
g
"}
(26,1,1) = {"
a
e
a
P
a
e
a
e
e
e
e
e
P
e
a
a
e
e
E
e
a
e
e
e
e
e
e
a
e
X
e
e
a
e
P
a
e
a
X
g
"}
(27,1,1) = {"
e
e
e
a
e
e
e
e
e
a
e
e
e
a
e
e
E
a
e
a
e
X
a
e
e
e
X
e
e
X
a
a
e
e
e
a
e
e
X
g
"}
(28,1,1) = {"
e
e
X
e
e
e
X
e
a
e
E
X
X
e
a
a
e
e
e
e
a
X
e
o
a
e
e
X
e
X
X
a
e
a
e
e
e
a
X
g
"}
(29,1,1) = {"
a
e
e
e
E
e
e
e
X
X
X
X
X
X
e
e
e
e
e
X
e
e
X
a
a
e
e
X
e
e
e
X
X
e
P
a
e
a
X
g
"}
(30,1,1) = {"
e
E
P
a
e
a
P
a
o
X
X
X
X
e
e
e
e
a
e
e
X
e
X
X
e
e
e
X
a
a
e
e
e
e
a
P
a
e
X
g
"}
(31,1,1) = {"
X
X
a
e
e
e
a
e
e
e
X
e
e
e
a
a
e
a
e
e
X
e
e
e
X
e
e
E
e
a
e
e
e
a
e
e
e
a
e
g
"}
(32,1,1) = {"
e
X
e
e
e
X
e
e
X
X
e
e
e
a
a
a
e
e
e
e
X
a
a
e
X
P
a
e
a
e
E
e
X
e
P
a
e
a
a
g
"}
(33,1,1) = {"
e
X
a
a
e
e
a
X
e
X
a
e
a
e
e
e
e
X
a
e
e
e
e
e
e
a
e
e
e
a
e
a
e
e
a
P
a
e
e
g
"}
(34,1,1) = {"
e
X
X
a
e
e
X
X
X
e
X
X
a
e
e
e
a
e
e
e
a
X
X
e
X
e
e
e
w
e
e
e
P
a
e
a
P
e
X
g
"}
(35,1,1) = {"
e
e
e
X
e
X
X
a
e
X
X
X
e
P
a
e
a
P
a
e
a
e
e
X
X
a
X
X
a
e
e
X
e
e
a
e
e
e
e
g
"}
(36,1,1) = {"
a
a
e
e
X
X
X
e
e
e
X
X
a
a
e
e
e
a
e
e
e
e
e
e
X
X
X
X
e
e
E
e
e
e
a
P
a
e
e
g
"}
(37,1,1) = {"
e
e
e
e
e
X
X
a
E
e
X
X
X
e
e
e
X
e
e
e
X
e
E
e
X
e
X
X
a
a
e
a
e
e
e
a
e
e
e
g
"}
(38,1,1) = {"
e
X
X
E
e
X
X
X
P
e
X
X
o
e
a
e
e
e
E
e
e
e
P
e
X
e
X
X
X
e
e
e
e
a
e
e
e
a
E
g
"}
(39,1,1) = {"
a
e
X
P
e
X
X
o
e
a
X
X
e
a
e
E
P
a
e
a
P
a
e
a
X
e
X
X
o
e
e
X
a
e
P
a
e
a
P
g
"}
(40,1,1) = {"
e
e
X
e
a
X
X
e
e
e
a
e
a
e
X
X
a
e
e
e
a
e
e
e
a
a
X
X
e
X
X
a
e
e
e
a
e
e
e
g
"}
(41,1,1) = {"
X
e
X
e
e
a
e
a
e
e
e
e
e
a
e
X
e
e
e
f
e
e
e
e
e
a
e
e
X
X
X
e
e
a
e
e
e
a
e
g
"}
(42,1,1) = {"
X
e
e
e
e
e
e
e
a
e
e
e
X
e
e
X
a
a
e
e
a
X
a
e
e
X
a
e
e
X
X
a
X
e
P
a
e
a
e
g
"}
(43,1,1) = {"
X
a
a
a
e
e
e
X
e
o
a
e
e
X
e
X
X
a
e
e
X
X
e
o
a
e
e
E
e
X
X
X
e
e
a
P
a
e
e
g
"}
(44,1,1) = {"
e
e
e
e
o
a
e
e
X
a
a
e
e
X
e
e
e
X
a
e
e
X
X
a
a
e
e
P
e
X
X
o
X
e
P
a
e
a
e
g
"}
(45,1,1) = {"
X
e
e
X
a
a
e
e
X
X
e
e
e
X
a
a
e
e
e
E
e
X
X
X
e
e
e
e
a
X
X
e
e
e
a
P
a
e
a
g
"}
(46,1,1) = {"
e
X
e
X
X
e
e
e
e
e
X
a
e
e
e
e
e
e
e
P
e
X
e
e
X
e
a
e
e
a
e
a
e
X
X
a
e
e
e
g
"}
(47,1,1) = {"
e
X
e
e
e
X
a
e
e
e
e
e
e
e
P
e
X
X
X
X
X
X
e
e
a
a
e
e
e
e
e
e
P
e
e
X
a
e
X
g
"}
(48,1,1) = {"
e
X
a
a
e
e
e
E
e
X
X
X
g
g
g
g
X
X
X
X
X
X
e
e
e
e
X
a
e
e
e
X
e
e
a
e
e
e
e
g
"}
(49,1,1) = {"
e
e
e
e
e
e
e
P
e
X
X
g
g
g
g
g
g
g
g
X
X
X
a
e
e
a
X
e
o
a
e
e
a
e
a
P
a
e
e
g
"}
(50,1,1) = {"
X
X
X
X
X
X
X
X
X
X
X
g
g
g
g
g
g
g
g
g
g
X
e
o
a
e
a
X
X
e
a
e
a
e
e
e
a
e
a
g
"}
(51,1,1) = {"
e
e
e
a
e
e
e
a
X
X
X
X
g
g
g
g
g
g
g
g
g
g
X
a
a
e
e
a
e
a
e
X
a
P
a
e
a
e
e
g
"}
(52,1,1) = {"
P
a
e
a
P
a
e
a
e
X
X
X
g
g
g
g
g
g
g
g
g
g
X
X
e
e
e
e
e
e
a
e
e
a
e
e
e
e
e
g
"}
(53,1,1) = {"
a
e
e
e
a
e
e
e
e
X
X
X
X
g
g
g
g
g
g
g
g
g
e
e
X
a
e
e
e
X
e
e
e
e
e
a
e
a
X
g
"}
(54,1,1) = {"
e
e
e
X
e
e
e
X
e
X
X
X
X
X
g
g
g
g
g
g
g
g
g
g
X
e
o
a
e
e
X
e
P
a
e
a
P
e
X
g
"}
(55,1,1) = {"
e
a
e
e
e
E
e
e
e
X
X
X
X
X
X
X
g
g
g
g
g
g
g
g
X
X
a
a
e
e
X
e
e
e
a
e
e
e
X
g
"}
(56,1,1) = {"
a
e
E
P
a
e
a
P
a
X
X
X
X
X
X
X
X
X
X
X
g
g
g
g
X
X
X
e
e
e
X
a
e
e
a
P
a
e
X
g
"}
(57,1,1) = {"
e
X
X
a
e
e
e
a
e
X
X
X
X
X
X
X
X
X
X
X
X
X
X
X
X
e
e
X
a
e
e
e
e
e
e
a
e
e
X
g
"}
(58,1,1) = {"
a
e
X
e
e
e
X
e
e
e
e
a
X
X
X
X
X
X
X
X
X
X
X
X
X
e
e
e
e
e
a
e
e
a
e
e
e
a
e
g
"}
(59,1,1) = {"
e
e
X
a
a
e
e
a
X
a
e
a
e
X
X
X
X
X
X
X
X
X
X
X
X
a
e
e
e
X
e
e
a
e
P
a
e
a
X
g
"}
(60,1,1) = {"
X
e
X
X
a
e
e
X
X
e
e
e
e
X
X
X
X
X
X
e
X
X
a
e
e
e
o
a
e
e
X
e
e
e
e
a
e
e
X
g
"}
(61,1,1) = {"
X
e
e
e
X
a
e
e
X
e
e
X
e
e
e
E
e
a
e
e
e
a
e
e
e
E
e
a
e
e
X
e
e
a
e
e
e
a
X
g
"}
(62,1,1) = {"
X
a
a
e
e
e
E
e
X
E
e
e
e
P
a
e
a
e
E
e
a
e
E
P
a
e
a
e
e
e
X
a
X
e
P
a
e
a
X
g
"}
(63,1,1) = {"
e
e
e
e
e
e
P
e
X
e
a
P
a
a
e
e
e
a
e
a
e
X
X
a
e
e
e
X
a
e
e
e
e
e
a
P
a
e
X
g
"}
(64,1,1) = {"
e
a
e
a
e
X
X
a
e
e
e
a
e
e
e
e
X
e
e
e
a
e
X
e
e
e
X
X
X
a
a
e
e
a
e
e
e
a
e
g
"}
(65,1,1) = {"
e
e
e
e
a
e
X
e
e
e
X
e
e
a
X
X
a
e
e
X
e
e
X
a
a
e
e
X
X
X
e
e
a
e
P
a
e
a
e
g
"}
(66,1,1) = {"
e
e
e
X
e
e
X
a
a
e
e
a
X
X
X
X
e
e
E
e
X
e
X
X
a
e
e
X
X
o
e
a
e
e
e
a
e
e
e
g
"}
(67,1,1) = {"
o
a
e
e
X
e
X
X
a
e
e
X
X
e
X
X
a
a
e
a
X
e
e
e
X
a
e
X
X
e
a
e
e
a
e
e
e
a
a
g
"}
(68,1,1) = {"
a
a
e
e
X
e
e
e
X
a
e
e
X
e
X
X
X
e
e
e
X
a
a
e
e
e
E
a
e
a
e
X
X
e
P
a
e
a
e
g
"}
(69,1,1) = {"
X
e
e
e
X
a
a
e
e
e
E
e
X
e
X
X
o
e
e
X
e
e
e
e
r
e
P
e
e
e
a
e
e
e
a
P
a
e
e
g
"}
(70,1,1) = {"
e
X
a
e
e
e
e
e
e
e
P
e
g
a
X
X
e
X
X
a
e
e
e
a
e
e
e
e
e
X
M
e
e
e
a
e
e
e
X
g
"}
(71,1,1) = {"
X
X
X
X
X
g
g
g
g
g
g
g
g
a
e
e
X
X
X
e
P
a
e
a
P
a
e
a
e
e
X
e
e
e
a
P
a
e
X
g
"}
(72,1,1) = {"
X
X
X
X
g
g
g
g
g
g
g
g
g
X
a
e
e
X
X
a
a
e
e
e
a
e
e
a
e
e
X
e
e
e
e
a
e
e
X
g
"}
(73,1,1) = {"
X
X
X
X
g
g
g
g
g
g
g
g
g
e
e
E
e
X
X
X
e
e
e
X
e
e
e
e
e
e
X
a
e
a
e
e
e
a
X
g
"}
(74,1,1) = {"
X
X
X
g
g
g
g
g
g
g
g
g
g
e
e
P
e
X
X
o
e
a
e
e
e
E
e
X
a
e
e
e
a
e
P
a
e
a
X
g
"}
(75,1,1) = {"
X
X
X
g
g
g
g
g
g
g
g
X
X
e
e
e
a
X
X
e
a
e
E
P
a
e
a
X
e
P
a
e
e
e
e
a
e
e
X
g
"}
(76,1,1) = {"
X
X
X
X
g
g
g
g
g
X
X
X
X
e
a
e
e
a
e
a
e
X
X
a
e
e
e
X
a
a
e
e
e
a
e
e
e
a
X
g
"}
(77,1,1) = {"
X
X
X
X
X
X
X
X
X
X
X
X
X
a
e
e
e
e
e
e
a
e
X
e
e
e
X
X
X
e
e
e
X
e
P
a
e
a
X
g
"}
(78,1,1) = {"
X
a
e
e
e
a
e
e
e
a
X
X
X
e
X
a
e
e
e
X
e
e
X
a
a
e
e
X
o
e
a
e
e
e
a
P
a
e
X
g
"}
(79,1,1) = {"
X
e
P
a
e
a
P
a
e
a
e
X
X
a
X
e
o
a
e
e
X
e
X
X
a
e
e
X
e
a
e
E
X
e
P
a
e
a
X
g
"}
(80,1,1) = {"
X
a
a
e
e
e
a
e
e
e
e
X
X
X
X
X
X
X
X
e
e
a
e
a
e
e
a
e
a
e
X
X
e
e
a
P
a
e
X
g
"}
(81,1,1) = {"
X
X
e
e
e
X
e
e
e
X
e
X
X
X
X
X
X
X
X
e
e
e
e
e
e
e
e
e
e
a
e
X
e
e
a
P
a
e
X
g
"}
(82,1,1) = {"
X
o
e
a
e
e
e
E
e
e
e
a
e
e
e
a
X
X
X
a
e
e
e
X
a
e
e
e
X
e
e
X
a
a
e
e
a
X
X
g
"}
(83,1,1) = {"
X
e
a
e
E
P
a
e
a
P
a
a
P
a
e
a
e
X
X
e
o
a
e
e
e
o
a
e
e
X
e
X
X
a
e
e
X
X
X
g
"}
(84,1,1) = {"
e
a
e
X
X
a
e
e
e
a
e
e
a
e
e
e
e
X
X
X
a
a
e
e
X
a
a
e
e
X
e
e
e
a
e
e
e
a
X
g
"}
(85,1,1) = {"
e
e
a
e
X
e
e
e
X
e
e
X
e
e
e
X
e
X
X
X
X
e
e
e
X
X
e
e
e
X
a
a
e
a
P
a
e
a
X
g
"}
(86,1,1) = {"
e
X
e
e
X
a
a
e
e
a
X
e
e
E
e
e
e
X
X
e
e
X
a
e
e
e
X
a
e
e
e
e
e
e
a
e
e
e
X
g
"}
(87,1,1) = {"
e
e
X
e
X
X
a
e
e
X
X
P
a
e
a
P
a
w
X
X
X
X
X
g
g
g
g
g
g
g
X
e
a
e
e
e
a
e
X
g
"}
(88,1,1) = {"
e
e
X
e
e
e
X
a
e
e
X
a
e
e
e
a
e
X
X
X
X
X
g
g
g
g
g
g
g
g
X
e
e
P
a
e
a
P
X
g
"}
(89,1,1) = {"
e
e
X
a
a
e
e
e
E
e
X
e
e
e
X
e
e
X
X
X
X
X
g
g
g
g
g
g
g
X
e
e
e
a
e
e
e
X
X
g
"}
(90,1,1) = {"
a
e
e
e
e
e
e
e
P
e
X
a
a
e
e
a
X
X
X
X
X
g
g
g
g
g
g
g
X
X
e
a
e
e
e
a
e
X
X
g
"}
(91,1,1) = {"
e
X
a
a
e
e
e
E
e
X
a
e
e
e
a
e
e
e
a
X
X
g
g
g
g
g
g
g
X
X
e
e
P
a
e
a
P
X
X
g
"}
(92,1,1) = {"
e
e
e
a
e
e
e
a
e
X
e
P
a
e
a
P
a
e
a
e
g
g
g
g
g
g
g
X
X
e
a
e
e
e
a
e
X
X
X
g
"}
(93,1,1) = {"
e
e
e
a
P
a
e
a
X
X
a
a
e
e
e
a
e
e
e
e
g
g
g
g
g
g
X
X
X
e
e
P
e
a
e
e
e
a
X
g
"}
(94,1,1) = {"
o
a
e
e
a
e
e
e
X
X
X
e
e
e
X
e
e
e
X
e
g
g
g
g
g
X
X
X
X
e
e
a
e
a
P
a
e
a
X
g
"}
(95,1,1) = {"
a
a
a
e
e
e
a
e
X
X
o
e
a
e
e
e
E
e
e
e
g
g
g
g
g
X
X
X
X
a
e
e
e
e
a
e
e
e
X
g
"}
(96,1,1) = {"
X
e
e
P
a
e
a
P
X
X
e
a
e
E
P
a
e
a
P
a
X
g
g
g
X
X
X
X
X
e
P
a
e
a
e
e
e
a
X
g
"}
(97,1,1) = {"
e
X
X
e
X
X
e
e
a
e
a
e
X
X
a
e
e
e
a
e
X
g
X
e
X
X
a
e
e
e
a
e
e
a
P
a
e
a
X
g
"}
(98,1,1) = {"
X
e
e
X
X
X
e
e
e
e
e
a
e
X
e
e
e
X
e
e
X
X
e
X
X
X
e
P
a
e
a
P
e
e
a
e
e
e
X
g
"}
(99,1,1) = {"
X
e
a
e
e
e
a
e
e
e
X
e
e
X
a
a
e
e
a
X
X
X
e
e
X
X
a
a
e
e
e
a
a
e
e
e
a
e
X
g
"}
(100,1,1) = {"
X
e
a
P
a
e
a
o
a
e
e
X
e
X
X
a
e
e
X
X
X
X
E
e
X
X
e
X
X
a
e
e
e
P
a
e
a
P
X
g
"}
(101,1,1) = {"
e
e
e
a
e
e
e
a
a
e
e
X
e
e
e
X
a
e
e
a
e
e
e
a
a
e
X
X
X
e
P
a
e
a
P
a
e
a
e
g
"}
(102,1,1) = {"
X
a
e
e
e
a
e
X
e
e
e
X
a
a
e
e
e
E
e
a
P
a
e
a
a
e
e
X
w
a
a
e
a
e
e
e
a
e
e
g
"}
(103,1,1) = {"
X
e
P
a
e
a
P
e
X
a
e
e
e
e
e
M
e
P
e
e
a
e
e
e
e
E
e
X
X
X
e
e
a
P
a
e
a
X
e
g
"}
(104,1,1) = {"
X
X
e
e
e
e
a
X
X
e
a
e
E
P
a
e
a
P
a
e
e
e
a
e
e
P
e
X
e
a
e
e
e
a
e
e
e
e
e
g
"}
(105,1,1) = {"
X
X
a
e
e
e
e
a
e
a
e
X
X
a
e
e
e
a
r
P
a
e
a
P
P
e
a
X
e
a
P
a
e
e
e
a
e
P
a
g
"}
(106,1,1) = {"
X
X
e
o
a
e
e
e
e
e
a
e
X
e
e
e
X
e
e
E
r
X
e
o
a
e
e
a
e
e
a
e
P
a
e
a
P
a
e
g
"}
(107,1,1) = {"
X
X
X
a
a
a
e
e
e
X
e
e
X
a
a
e
e
a
X
P
e
X
X
a
a
e
e
a
a
e
e
e
a
e
e
e
X
e
e
g
"}
(108,1,1) = {"
X
X
X
X
e
e
o
a
e
e
X
e
X
X
a
e
e
X
X
e
a
X
X
X
M
a
e
e
e
P
a
e
a
P
a
e
e
a
X
g
"}
(109,1,1) = {"
X
X
e
e
X
X
a
a
e
e
X
e
e
e
X
a
e
e
X
e
e
a
e
e
X
e
a
e
e
e
a
e
X
X
a
e
e
X
X
g
"}
(110,1,1) = {"
X
X
X
X
X
X
X
e
e
e
X
a
a
e
e
e
E
e
X
e
e
e
e
e
a
X
e
P
a
e
a
P
e
e
X
a
e
e
X
g
"}
(111,1,1) = {"
e
X
X
a
e
e
e
a
e
e
e
a
X
e
e
e
P
e
w
a
e
e
e
X
e
X
e
X
X
a
e
e
e
a
e
e
e
a
X
g
"}
(112,1,1) = {"
X
X
X
e
P
a
e
a
P
a
e
a
e
X
X
X
X
X
X
e
o
a
e
e
X
e
X
X
X
e
P
a
e
a
P
a
e
a
e
g
"}
(113,1,1) = {"
e
X
X
a
a
e
e
e
a
e
e
e
e
X
X
X
X
X
X
X
a
a
X
e
X
e
e
X
X
a
e
a
e
e
e
a
e
e
e
g
"}
(114,1,1) = {"
e
X
X
X
e
e
e
X
e
e
e
X
e
X
X
X
X
X
X
X
X
e
e
X
X
E
e
X
X
X
e
a
P
a
e
a
e
X
e
g
"}
(115,1,1) = {"
e
X
X
o
e
a
e
e
e
E
e
e
e
X
X
g
g
g
g
e
e
X
e
e
X
P
e
X
X
o
e
e
a
e
e
e
e
e
e
g
"}
(116,1,1) = {"
a
X
X
e
a
e
E
P
a
e
a
P
a
X
g
g
g
g
g
X
X
X
E
e
X
e
a
X
X
e
a
e
e
e
a
e
a
P
a
g
"}
(117,1,1) = {"
e
a
e
a
e
X
X
a
e
e
e
a
e
X
g
g
g
g
g
g
g
X
P
e
X
e
e
a
e
a
e
P
a
e
a
P
e
a
e
g
"}
(118,1,1) = {"
e
e
e
e
a
e
X
e
e
e
X
e
e
g
g
g
g
g
g
g
g
X
e
a
X
e
e
e
e
e
a
e
e
a
e
e
e
a
e
g
"}
(119,1,1) = {"
e
e
e
X
e
e
X
a
a
e
e
a
X
g
g
g
g
g
g
g
g
g
e
e
a
a
e
e
e
X
e
e
e
a
P
a
e
a
X
g
"}
(120,1,1) = {"
o
a
e
e
X
e
X
X
a
e
e
X
X
g
g
g
g
g
g
g
g
g
e
e
e
e
o
e
e
e
X
e
e
e
a
e
e
e
X
g
"}
(121,1,1) = {"
a
a
e
e
X
e
e
e
X
a
e
e
X
X
g
g
g
g
g
g
g
g
a
e
e
X
e
e
e
e
X
M
e
e
e
e
a
e
X
g
"}
(122,1,1) = {"
X
e
e
e
X
a
a
e
e
e
E
e
X
X
X
X
g
g
g
g
g
g
e
o
a
X
X
e
e
e
X
e
e
P
a
e
a
P
X
g
"}
(123,1,1) = {"
e
X
a
e
e
e
e
e
e
e
P
e
X
X
X
X
g
g
g
g
g
g
X
a
a
e
e
X
e
e
e
e
e
e
a
e
e
e
X
g
"}
(124,1,1) = {"
e
e
X
e
e
e
X
a
e
e
X
X
X
X
X
X
X
X
g
g
g
g
X
X
e
e
a
X
X
e
e
e
e
e
e
e
a
e
a
g
"}
(125,1,1) = {"
e
e
X
a
a
e
e
e
E
e
X
X
X
X
X
X
X
X
g
g
g
g
e
e
X
e
e
a
e
a
e
X
e
P
a
e
a
P
e
g
"}
(126,1,1) = {"
a
e
e
e
e
e
e
e
P
e
X
X
X
X
X
X
X
X
g
g
g
g
X
X
X
e
e
e
e
e
a
e
e
a
P
a
e
a
e
g
"}
(127,1,1) = {"
X
X
e
X
X
a
e
e
e
a
e
e
e
a
X
X
X
X
g
g
g
g
X
X
X
a
e
e
e
X
e
e
e
e
a
e
e
e
X
g
"}
(128,1,1) = {"
X
e
X
X
X
e
P
a
e
a
P
a
e
a
e
X
X
X
g
g
g
g
X
X
X
e
o
a
e
e
X
e
a
e
e
e
a
e
X
g
"}
(129,1,1) = {"
e
e
e
X
X
a
a
e
e
e
a
e
e
e
e
X
X
X
g
g
g
X
e
X
X
X
a
a
e
e
X
e
e
P
a
e
a
P
X
g
"}
(130,1,1) = {"
e
E
e
X
X
X
e
e
e
X
e
e
e
X
e
X
X
X
g
g
g
e
X
X
X
X
X
e
e
e
X
a
e
a
e
e
e
a
X
g
"}
(131,1,1) = {"
e
P
e
X
X
o
e
a
e
e
e
E
e
e
e
X
X
X
X
g
g
e
e
X
X
e
e
X
a
e
e
e
e
a
P
a
e
a
X
g
"}
(132,1,1) = {"
e
e
a
X
X
e
a
e
E
P
a
e
a
P
a
X
X
X
X
X
X
E
e
X
X
X
e
e
e
X
e
e
e
e
a
e
e
e
X
g
"}
(133,1,1) = {"
e
e
e
a
e
a
e
X
X
a
e
e
e
a
e
a
X
X
X
X
X
P
e
X
X
o
e
a
e
e
e
E
a
e
e
e
a
e
X
g
"}
(134,1,1) = {"
e
e
e
e
e
e
a
e
X
e
e
e
X
e
e
a
e
X
X
X
X
e
a
X
e
X
X
a
e
e
e
a
e
P
a
e
a
P
X
g
"}
(135,1,1) = {"
a
a
e
e
e
X
e
e
X
a
a
e
e
a
X
e
e
X
X
X
X
e
e
e
X
X
X
e
P
a
e
a
a
e
e
e
a
e
X
g
"}
(136,1,1) = {"
e
e
o
a
e
e
X
e
X
X
a
e
e
X
X
X
e
X
X
X
e
e
e
e
e
X
X
a
a
e
e
e
e
P
a
e
a
P
X
g
"}
(137,1,1) = {"
X
X
a
a
e
e
X
e
e
e
X
a
e
e
X
e
e
X
X
X
e
a
e
E
e
X
X
X
e
e
e
X
e
e
e
X
e
X
X
g
"}
(138,1,1) = {"
e
X
X
e
e
e
X
a
a
e
e
e
E
e
X
P
a
X
X
X
E
e
o
P
e
X
X
o
e
a
e
e
e
E
e
e
e
X
X
g
"}
(139,1,1) = {"
e
e
e
X
a
e
e
e
e
e
e
e
P
e
X
e
e
a
e
e
e
a
X
e
a
X
X
e
a
e
E
P
a
e
a
e
e
e
a
g
"}
(140,1,1) = {"
e
X
X
e
e
e
e
e
a
e
X
X
X
e
P
a
e
a
P
a
e
a
e
e
e
a
e
a
e
X
X
a
e
e
a
P
a
e
a
g
"}
(141,1,1) = {"
a
X
X
a
e
e
e
X
e
e
e
X
X
a
a
e
e
e
a
e
e
e
e
X
e
X
X
a
e
e
e
a
e
e
e
a
e
e
e
g
"}
(142,1,1) = {"
e
a
e
e
o
a
e
X
e
E
e
X
X
X
e
e
e
X
e
e
e
X
e
e
X
X
X
e
P
a
e
e
a
a
e
e
e
a
e
g
"}
(143,1,1) = {"
e
e
e
X
a
a
e
e
X
P
e
X
X
o
e
a
e
e
e
E
e
e
e
e
M
X
X
a
a
e
e
e
a
e
P
a
e
a
P
g
"}
(144,1,1) = {"
e
e
e
X
X
e
e
e
e
e
a
X
X
e
a
e
E
P
a
e
a
P
a
E
e
X
X
X
e
e
e
e
e
a
e
e
e
X
X
g
"}
(145,1,1) = {"
o
a
e
e
e
X
a
E
e
e
e
a
e
a
e
X
X
a
e
e
e
a
e
P
e
X
X
o
e
a
e
a
e
e
a
e
e
e
a
g
"}
(146,1,1) = {"
a
a
e
e
X
e
e
P
e
e
e
e
e
e
a
e
X
M
e
e
f
e
e
e
a
X
X
e
a
e
E
e
P
e
a
P
a
e
a
g
"}
(147,1,1) = {"
X
e
e
e
X
a
a
e
a
a
e
e
e
X
e
e
X
a
a
e
e
a
X
e
e
a
e
a
e
X
X
e
a
e
e
a
e
e
e
g
"}
(148,1,1) = {"
e
a
e
e
e
a
X
e
e
e
o
a
e
e
X
e
X
X
a
e
e
X
X
e
e
e
e
e
a
e
X
e
e
a
e
e
e
a
e
g
"}
(149,1,1) = {"
e
a
P
a
e
a
e
e
e
X
a
a
e
e
X
e
e
e
X
a
e
e
X
a
e
e
e
X
e
e
X
a
e
e
P
a
e
a
P
g
"}
(150,1,1) = {"
e
e
a
e
e
e
e
a
e
X
X
e
e
e
X
a
a
e
e
e
E
e
X
e
o
a
e
e
X
e
X
e
P
a
e
a
P
X
X
g
"}
(151,1,1) = {"
e
X
e
e
e
X
e
e
o
e
e
X
a
e
e
e
e
e
e
e
P
e
X
X
a
a
e
e
X
e
e
e
a
P
a
e
a
X
X
g
"}
(152,1,1) = {"
e
e
e
E
e
e
e
X
a
a
e
e
X
e
e
e
X
a
e
e
X
o
e
X
X
e
e
e
w
a
a
e
e
e
a
e
e
e
a
g
"}
(153,1,1) = {"
E
P
a
e
a
P
a
X
X
e
e
e
X
a
a
e
e
e
E
e
X
e
a
e
e
X
a
e
e
e
e
a
e
e
a
P
a
e
a
g
"}
(154,1,1) = {"
X
a
e
e
e
a
e
e
e
X
a
e
e
e
e
e
e
e
P
e
X
a
e
P
e
X
X
o
e
a
e
e
P
e
e
a
e
e
e
g
"}
(155,1,1) = {"
X
e
e
e
X
e
e
X
X
X
g
g
g
g
X
X
X
e
e
e
e
e
a
e
a
X
X
e
e
a
e
e
e
a
e
e
e
a
e
g
"}
(156,1,1) = {"
X
a
a
e
e
a
X
X
X
g
g
g
g
g
g
X
X
a
e
e
e
X
e
e
e
a
e
a
e
a
P
a
e
e
P
a
e
a
P
g
"}
(157,1,1) = {"
X
X
a
e
e
X
X
X
X
g
g
g
g
g
g
g
X
e
o
a
e
e
X
e
e
e
e
e
e
e
a
e
e
a
P
a
e
a
X
g
"}
(158,1,1) = {"
e
e
X
a
e
e
X
X
X
g
g
g
g
g
g
g
g
X
a
a
e
e
X
a
e
e
e
X
a
e
e
e
e
e
a
e
e
e
X
g
"}
(159,1,1) = {"
a
e
e
e
E
e
X
X
X
g
g
g
g
g
g
g
g
X
X
e
e
e
X
e
o
a
e
e
e
P
a
e
a
e
e
e
a
e
X
g
"}
(160,1,1) = {"
e
e
e
e
P
e
X
X
X
X
g
g
g
g
g
g
g
e
e
X
I
e
e
X
a
a
e
e
X
e
e
e
e
P
a
e
a
P
X
g
"}
(161,1,1) = {"
e
X
a
e
e
X
a
X
X
X
X
g
g
g
g
g
g
g
g
g
g
X
X
X
X
e
e
e
X
a
a
e
e
e
a
e
e
e
a
g
"}
(162,1,1) = {"
e
e
e
E
e
X
e
X
X
X
X
X
g
g
g
g
g
g
g
g
g
g
X
e
e
X
a
e
e
e
e
e
e
e
a
P
a
e
a
g
"}
(163,1,1) = {"
e
e
e
P
e
X
e
X
X
X
X
X
X
g
g
g
g
g
g
g
g
g
g
e
a
X
X
e
a
e
E
P
a
e
e
a
e
e
e
g
"}
(164,1,1) = {"
X
a
a
e
e
a
X
X
X
X
X
X
X
X
g
g
g
g
g
g
g
g
g
e
e
a
e
a
e
X
X
a
e
a
e
e
e
a
e
g
"}
(165,1,1) = {"
X
X
a
e
e
X
X
X
X
X
X
X
X
X
X
X
g
g
g
g
g
g
g
e
e
e
e
e
a
e
X
e
e
e
P
a
e
a
P
g
"}
(166,1,1) = {"
e
e
X
a
e
e
X
X
X
X
X
X
X
X
X
X
X
X
g
g
g
g
X
a
e
e
e
X
e
e
X
a
a
e
a
P
a
e
a
g
"}
(167,1,1) = {"
a
e
e
e
E
e
X
X
X
X
X
e
X
X
a
e
e
e
a
e
e
e
a
X
e
X
X
a
e
e
e
a
e
e
e
a
e
e
e
g
"}
(168,1,1) = {"
e
e
e
e
P
e
X
X
X
X
e
f
X
X
e
P
a
e
a
P
a
e
a
e
X
X
X
M
P
a
e
a
P
a
e
e
e
a
e
g
"}
(169,1,1) = {"
a
e
e
e
a
e
e
e
a
X
e
e
X
X
a
a
e
e
e
a
e
e
e
e
e
X
X
a
a
e
e
e
a
e
P
a
e
a
P
g
"}
(170,1,1) = {"
e
P
a
e
a
P
a
e
a
e
E
e
X
X
X
e
e
e
w
e
e
e
X
e
e
X
X
X
e
e
e
X
e
e
a
e
e
e
a
g
"}
(171,1,1) = {"
a
a
e
e
e
a
e
e
e
e
P
e
X
X
o
e
a
e
e
e
E
e
e
e
e
X
X
o
e
a
e
e
e
e
a
P
a
e
a
g
"}
(172,1,1) = {"
X
e
e
e
X
e
e
e
X
e
e
a
X
X
e
a
e
E
P
a
e
a
P
a
a
X
X
e
a
e
E
P
a
e
e
a
e
e
e
g
"}
(173,1,1) = {"
o
e
a
e
e
e
E
e
e
e
e
e
a
e
a
r
X
X
a
e
e
e
a
e
e
a
e
a
e
X
X
a
e
a
e
e
e
a
e
g
"}
(174,1,1) = {"
e
a
e
E
P
a
e
a
P
a
e
e
e
e
e
a
e
X
e
e
e
X
e
e
e
e
e
e
a
e
X
e
e
e
P
a
e
a
P
g
"}
(175,1,1) = {"
a
e
X
X
a
e
e
e
a
e
a
e
e
e
X
e
e
X
a
a
e
e
a
X
e
e
e
X
e
e
X
a
e
e
a
e
e
e
X
g
"}
(176,1,1) = {"
e
a
e
X
e
e
e
X
e
e
e
o
a
e
e
X
e
X
X
a
e
e
X
X
o
a
e
e
X
e
X
X
a
e
e
e
a
e
X
g
"}
(177,1,1) = {"
X
e
e
X
a
a
e
e
a
X
X
a
a
e
e
X
e
e
e
X
a
e
e
X
a
a
e
e
X
e
e
e
e
P
a
e
a
P
X
g
"}
(178,1,1) = {"
e
X
e
X
X
a
e
e
X
X
X
X
e
e
e
X
a
a
e
e
e
E
e
X
X
e
e
e
X
a
a
e
e
e
E
e
X
X
X
g
"}
(179,1,1) = {"
e
X
e
e
e
X
a
e
e
X
e
e
X
a
e
e
e
e
e
e
e
P
e
X
e
X
a
e
e
e
e
e
e
e
P
e
X
X
X
g
"}
(180,1,1) = {"
g
g
g
g
g
g
g
g
g
g
g
g
g
g
g
g
g
g
g
g
g
g
g
g
g
g
g
g
g
g
g
g
g
g
g
g
g
g
g
g
"}
