//MAP CONVERTED BY dmm2tgm.py THIS HEADER COMMENT PREVENTS RECONVERSION, DO NOT REMOVE
"a" = (
/obj/effect/light_emitter/daylight,
/turf/open/misc/ice/coldroom,
/area/trainstation/outdoor)
"d" = (
/obj/item/restraints/legcuffs/beartrap/prearmed,
/obj/effect/light_emitter/daylight,
/turf/open/misc/asteroid/snow/indestructible,
/area/trainstation/outdoor)
"e" = (
/obj/structure/flora/rock/style_random,
/obj/structure/flora/bush/snow/style_random,
/obj/effect/light_emitter/daylight,
/turf/open/misc/asteroid/snow/indestructible,
/area/trainstation/outdoor)
"g" = (
/obj/structure/flora/tree/pine/style_random,
/obj/effect/light_emitter/daylight,
/turf/open/misc/asteroid/snow/indestructible,
/area/trainstation/outdoor)
"h" = (
/obj/effect/turf_decal/siding/wood,
/obj/effect/light_emitter/daylight,
/turf/open/floor/wood,
/area/trainstation/indoors)
"j" = (
/obj/effect/turf_decal/siding/wood{
	dir = 5
	},
/obj/structure/chair/wood,
/obj/effect/light_emitter/daylight,
/turf/open/floor/wood,
/area/trainstation/indoors)
"k" = (
/obj/effect/light_emitter/daylight,
/turf/open/floor/wood,
/area/trainstation/indoors)
"l" = (
/obj/structure/mineral_door/wood/large_gate{
	dir = 8
	},
/obj/effect/light_emitter/daylight,
/turf/open/misc/asteroid/snow/indestructible,
/area/trainstation/outdoor)
"n" = (
/obj/effect/light_emitter/daylight,
/turf/closed/indestructible/rock/snow/ice/ore,
/area/trainstation/outdoor)
"o" = (
/mob/living/basic/bear/snow,
/obj/effect/light_emitter/daylight,
/turf/open/misc/asteroid/snow/indestructible,
/area/trainstation/outdoor)
"p" = (
/obj/structure/flora/bush/snow/style_random,
/mob/living/basic/bear/snow,
/obj/effect/light_emitter/daylight,
/turf/open/misc/asteroid/snow/indestructible,
/area/trainstation/outdoor)
"t" = (
/obj/structure/flora/bush/snow/style_random,
/obj/effect/light_emitter/daylight,
/turf/open/misc/asteroid/snow/indestructible,
/area/trainstation/outdoor)
"u" = (
/obj/item/chair/wood,
/obj/effect/light_emitter/daylight,
/turf/open/floor/wood,
/area/trainstation/indoors)
"v" = (
/obj/effect/turf_decal/siding/wood,
/obj/effect/light_emitter/daylight,
/turf/open/misc/ice/coldroom,
/area/trainstation/outdoor)
"w" = (
/obj/effect/turf_decal/siding/wood{
	dir = 8
	},
/obj/effect/light_emitter/daylight,
/turf/open/floor/wood,
/area/trainstation/indoors)
"x" = (
/obj/effect/turf_decal/siding/wood{
	dir = 10
	},
/obj/effect/light_emitter/daylight,
/turf/open/floor/wood,
/area/trainstation/indoors)
"z" = (
/obj/structure/mineral_door/wood/large_gate,
/obj/effect/light_emitter/daylight,
/turf/open/misc/asteroid/snow/indestructible,
/area/trainstation/outdoor)
"A" = (
/mob/living/basic/pet/fox,
/obj/effect/light_emitter/daylight,
/turf/open/misc/asteroid/snow/indestructible,
/area/trainstation/outdoor)
"B" = (
/obj/structure/barricade/wooden/crude,
/obj/structure/barricade/wooden/crude/snow,
/obj/structure/mineral_door/wood,
/obj/effect/light_emitter/daylight,
/turf/open/floor/wood,
/area/trainstation/indoors)
"C" = (
/obj/effect/turf_decal/siding/wood{
	dir = 1
	},
/obj/effect/light_emitter/daylight,
/turf/open/misc/ice/coldroom,
/area/trainstation/outdoor)
"D" = (
/obj/structure/flora/rock/style_random,
/obj/effect/light_emitter/daylight,
/turf/open/misc/asteroid/snow/indestructible,
/area/trainstation/outdoor)
"F" = (
/obj/effect/turf_decal/siding/wood{
	dir = 1
	},
/obj/effect/light_emitter/daylight,
/turf/open/floor/wood,
/area/trainstation/indoors)
"G" = (
/obj/effect/turf_decal/siding/wood{
	dir = 4
	},
/obj/structure/table/wood,
/obj/effect/light_emitter/daylight,
/turf/open/floor/wood,
/area/trainstation/indoors)
"H" = (
/obj/effect/light_emitter/daylight,
/turf/open/floor/wood/large,
/area/trainstation/outdoor)
"I" = (
/obj/structure/table/wood,
/obj/effect/light_emitter/daylight,
/turf/open/floor/wood,
/area/trainstation/indoors)
"J" = (
/obj/effect/light_emitter/daylight,
/turf/open/misc/asteroid/snow/indestructible,
/area/trainstation/outdoor)
"M" = (
/obj/effect/turf_decal/siding/wood{
	dir = 4
	},
/obj/effect/light_emitter/daylight,
/turf/open/floor/wood,
/area/trainstation/indoors)
"N" = (
/obj/effect/turf_decal/siding/wood{
	dir = 1
	},
/obj/structure/closet/crate/wooden/storage_barrel,
/obj/effect/light_emitter/daylight,
/turf/open/floor/wood,
/area/trainstation/indoors)
"P" = (
/obj/effect/turf_decal/siding/wood{
	dir = 6
	},
/obj/effect/light_emitter/daylight,
/turf/open/floor/wood,
/area/trainstation/indoors)
"Q" = (
/obj/structure/flora/tree/pine/style_random,
/obj/structure/flora/bush/snow/style_random,
/obj/effect/light_emitter/daylight,
/turf/open/misc/asteroid/snow/indestructible,
/area/trainstation/outdoor)
"R" = (
/obj/effect/turf_decal/siding/wood{
	dir = 1
	},
/obj/effect/light_emitter/daylight,
/turf/open/misc/asteroid/snow/indestructible,
/area/trainstation/outdoor)
"S" = (
/obj/effect/turf_decal/siding/wood{
	dir = 9
	},
/obj/structure/closet/crate/wooden/storage_barrel,
/obj/effect/light_emitter/daylight,
/turf/open/floor/wood,
/area/trainstation/indoors)
"T" = (
/obj/structure/closet/crate/wooden/storage_barrel,
/obj/effect/light_emitter/daylight,
/turf/open/misc/asteroid/snow/indestructible,
/area/trainstation/outdoor)
"U" = (
/obj/effect/turf_decal/siding/wood,
/obj/effect/light_emitter/daylight,
/turf/open/misc/asteroid/snow/indestructible,
/area/trainstation/outdoor)
"V" = (
/obj/effect/turf_decal/siding/wood{
	dir = 8
	},
/obj/structure/closet/crate/wooden/storage_barrel,
/obj/effect/light_emitter/daylight,
/turf/open/floor/wood,
/area/trainstation/indoors)
"X" = (
/obj/effect/light_emitter/daylight,
/turf/closed/indestructible/wood,
/area/trainstation/indoors)
"Y" = (
/obj/structure/closet/crate/wooden/storage_barrel,
/obj/effect/light_emitter/daylight,
/turf/open/floor/wood,
/area/trainstation/indoors)
"Z" = (
/obj/effect/turf_decal/siding/wood{
	dir = 1
	},
/obj/structure/chair/wood,
/obj/effect/light_emitter/daylight,
/turf/open/floor/wood,
/area/trainstation/indoors)

(1,1,1) = {"
J
J
J
J
J
J
J
J
J
J
J
J
J
J
J
J
J
J
J
J
J
J
J
J
J
J
J
J
J
J
J
J
J
J
J
J
J
J
J
n
"}
(2,1,1) = {"
J
J
J
J
J
J
J
J
J
J
J
J
J
J
J
J
J
J
J
J
J
J
J
J
J
J
J
J
J
J
J
J
J
J
J
J
J
J
J
n
"}
(3,1,1) = {"
J
J
J
J
J
J
J
t
J
g
J
D
t
J
g
J
J
J
J
J
J
J
J
J
J
J
J
J
t
J
g
J
D
t
J
g
J
J
J
n
"}
(4,1,1) = {"
J
J
J
t
J
J
g
g
J
J
J
J
J
J
J
J
t
J
g
J
D
t
J
g
J
J
J
g
g
J
J
J
J
J
J
J
J
J
J
n
"}
(5,1,1) = {"
J
J
g
g
J
J
J
J
g
J
J
J
J
g
J
J
g
J
J
J
J
J
J
J
g
J
D
J
J
J
J
J
g
J
D
t
J
J
J
n
"}
(6,1,1) = {"
J
J
J
J
g
t
J
e
J
J
g
J
J
J
J
J
J
g
J
g
J
g
J
g
J
D
J
g
J
g
J
g
J
D
J
J
t
J
J
n
"}
(7,1,1) = {"
J
t
J
e
J
J
J
t
J
g
J
D
t
J
g
J
e
J
J
J
D
t
J
g
J
D
J
J
D
t
J
g
J
D
J
g
g
J
J
n
"}
(8,1,1) = {"
J
J
J
t
J
J
t
g
J
J
J
J
J
J
J
t
t
J
g
J
D
t
J
t
J
g
J
J
D
t
J
t
J
g
J
J
J
J
J
n
"}
(9,1,1) = {"
J
J
t
g
J
J
J
J
t
t
Q
J
J
t
g
J
t
J
J
J
g
J
t
J
g
J
t
J
g
J
p
J
g
J
t
J
e
J
J
n
"}
(10,1,1) = {"
J
J
J
J
t
J
J
J
Q
t
t
J
J
J
t
g
g
J
g
J
J
J
J
J
J
J
J
J
J
J
J
J
J
J
J
J
t
J
J
n
"}
(11,1,1) = {"
J
J
J
J
Q
J
J
J
J
J
J
g
J
d
J
t
J
g
J
g
J
J
J
J
J
J
J
g
J
J
J
J
J
J
J
t
g
J
J
n
"}
(12,1,1) = {"
J
J
J
J
J
g
J
J
g
J
J
J
J
J
J
J
e
J
J
J
J
J
J
J
J
J
J
J
J
J
J
J
J
J
J
J
J
J
J
n
"}
(13,1,1) = {"
J
g
J
J
g
J
J
g
J
D
t
J
g
J
A
J
t
J
J
J
g
J
J
t
J
g
J
J
g
J
J
t
J
g
J
D
t
J
J
n
"}
(14,1,1) = {"
J
J
J
g
J
J
g
J
D
t
J
g
J
D
t
J
g
J
J
J
J
t
J
g
J
J
J
J
J
t
J
g
J
J
J
J
J
t
J
n
"}
(15,1,1) = {"
J
J
g
J
D
t
J
g
J
D
t
J
J
J
J
J
J
t
g
J
J
J
J
J
J
J
t
g
J
J
t
t
Q
J
J
t
g
J
J
n
"}
(16,1,1) = {"
J
J
J
J
J
J
J
J
g
J
J
g
J
J
J
J
J
Q
J
J
J
J
J
J
J
J
J
J
J
J
Q
t
t
J
J
J
t
g
J
n
"}
(17,1,1) = {"
J
J
J
J
J
J
J
J
J
J
g
J
D
t
J
J
J
J
J
g
J
J
t
J
g
J
D
t
J
J
J
J
J
g
J
A
J
t
J
n
"}
(18,1,1) = {"
J
t
J
g
J
D
t
J
g
J
J
D
t
J
g
J
J
g
J
J
t
J
g
J
J
J
J
J
J
J
g
J
J
J
J
J
J
J
J
n
"}
(19,1,1) = {"
g
g
J
J
J
J
J
J
J
J
t
J
g
J
J
J
g
J
D
t
J
g
J
J
J
J
g
J
J
g
J
D
t
J
g
J
J
J
J
n
"}
(20,1,1) = {"
J
J
g
J
J
J
J
g
J
g
g
J
J
J
J
g
J
D
t
J
g
J
D
t
J
J
J
J
g
J
D
t
J
g
J
D
t
J
J
n
"}
(21,1,1) = {"
J
e
J
J
g
J
J
J
J
J
J
g
J
J
J
J
J
g
J
J
J
J
g
J
J
g
J
J
J
J
J
J
J
g
J
D
t
J
J
n
"}
(22,1,1) = {"
J
t
J
g
J
D
t
J
t
J
e
J
J
J
t
J
g
J
D
t
J
g
J
J
J
J
J
g
g
J
g
J
g
J
D
J
J
t
J
n
"}
(23,1,1) = {"
t
g
J
J
J
J
J
J
J
J
t
J
J
g
g
J
J
J
J
J
J
J
J
g
J
J
J
J
J
D
t
J
g
J
D
J
g
g
J
n
"}
(24,1,1) = {"
J
J
t
t
Q
J
J
t
J
t
g
J
J
J
J
g
J
J
J
J
g
J
J
J
t
J
g
J
J
D
t
J
t
J
g
J
J
J
J
n
"}
(25,1,1) = {"
J
J
Q
t
t
J
J
J
t
J
g
J
D
t
J
g
J
g
J
J
J
J
J
g
g
J
J
J
J
g
J
t
J
g
J
t
J
e
J
n
"}
(26,1,1) = {"
J
J
J
J
J
g
J
g
g
J
J
J
J
J
J
J
J
J
D
t
J
g
J
J
J
g
J
g
J
d
J
J
J
J
J
J
J
t
J
n
"}
(27,1,1) = {"
J
t
J
g
J
D
t
J
g
J
J
J
J
J
g
J
J
J
J
J
J
J
t
J
e
J
J
J
g
J
J
J
J
J
J
J
t
g
J
n
"}
(28,1,1) = {"
g
g
J
J
J
J
J
J
J
J
J
g
J
J
J
J
J
Q
J
J
t
g
J
J
t
J
t
J
J
J
J
J
J
J
J
J
J
J
J
n
"}
(29,1,1) = {"
J
J
g
J
J
J
J
g
J
J
g
J
D
t
J
g
J
t
J
J
J
t
g
t
g
J
J
J
J
g
J
J
t
J
g
J
D
t
J
n
"}
(30,1,1) = {"
J
e
J
J
g
J
J
J
J
J
J
J
J
J
J
J
t
J
g
J
J
J
t
J
J
t
J
t
J
J
t
J
g
J
J
J
J
J
J
n
"}
(31,1,1) = {"
J
t
J
g
J
D
t
J
g
J
t
Q
J
J
t
g
J
J
J
J
J
o
J
J
J
Q
J
J
J
t
t
Q
J
J
t
g
J
J
J
n
"}
(32,1,1) = {"
t
g
J
J
J
J
J
J
J
t
t
t
J
J
J
t
g
t
J
g
J
J
J
J
J
J
J
J
J
Q
t
t
J
J
J
t
g
J
J
n
"}
(33,1,1) = {"
J
J
t
t
Q
J
J
t
g
o
J
J
g
J
J
J
t
J
g
J
D
t
J
J
J
g
J
J
J
J
J
J
g
J
J
J
t
J
J
n
"}
(34,1,1) = {"
J
J
Q
t
t
J
J
J
t
g
J
J
J
J
J
J
J
J
J
J
J
J
J
J
g
J
g
J
J
g
J
J
J
J
J
J
J
J
J
n
"}
(35,1,1) = {"
J
J
J
J
J
g
J
J
J
t
D
t
J
g
J
J
J
J
J
J
J
J
J
g
J
D
J
J
g
J
D
t
J
g
J
J
J
J
J
n
"}
(36,1,1) = {"
J
J
g
J
J
J
J
J
J
J
t
J
g
J
D
t
J
J
J
J
J
J
J
J
J
J
J
g
J
D
t
J
g
J
D
t
J
J
J
n
"}
(37,1,1) = {"
J
g
J
D
t
J
g
J
J
J
J
J
J
J
J
J
J
J
J
J
J
J
J
J
J
J
J
J
J
J
J
J
g
J
J
J
t
J
J
n
"}
(38,1,1) = {"
g
J
D
t
J
g
J
D
t
J
a
a
a
J
J
J
J
J
J
J
J
J
J
J
J
J
g
J
J
g
J
J
J
J
J
J
J
J
J
n
"}
(39,1,1) = {"
J
J
J
J
a
a
a
a
a
a
a
a
a
a
a
a
a
a
J
J
J
J
J
J
J
J
J
J
g
J
D
t
J
g
J
J
J
J
J
n
"}
(40,1,1) = {"
J
J
J
J
a
a
a
a
a
a
a
a
a
a
a
a
a
a
a
a
J
J
J
J
J
J
J
g
J
D
t
J
g
J
D
t
J
J
J
n
"}
(41,1,1) = {"
J
J
J
J
a
a
a
a
a
a
a
a
a
a
a
a
a
a
a
a
a
a
J
J
J
J
J
J
J
J
J
J
J
J
J
J
J
J
n
n
"}
(42,1,1) = {"
J
J
J
J
a
a
a
a
a
a
a
a
a
a
a
a
a
a
a
a
a
a
a
a
J
J
J
J
J
J
J
J
J
J
J
J
J
n
n
n
"}
(43,1,1) = {"
J
J
J
J
a
a
a
a
a
a
a
a
a
a
a
a
a
a
a
a
a
a
a
a
a
J
J
n
n
n
n
n
n
n
n
n
n
n
n
n
"}
(44,1,1) = {"
J
J
J
J
a
a
a
a
a
a
a
a
a
a
a
a
a
a
a
a
a
a
a
a
a
a
n
n
n
n
n
n
n
n
n
n
n
n
n
n
"}
(45,1,1) = {"
J
J
J
a
a
a
a
a
a
a
a
a
a
a
a
a
a
a
a
a
a
a
a
a
a
a
a
a
n
n
n
n
n
n
n
n
n
n
n
n
"}
(46,1,1) = {"
J
J
J
a
a
a
a
a
a
a
a
a
a
a
a
a
a
a
a
a
a
a
a
a
a
a
a
a
a
a
n
n
n
n
n
n
n
n
n
n
"}
(47,1,1) = {"
J
J
J
a
a
a
a
a
a
a
a
a
a
a
a
a
a
a
a
a
a
a
a
a
a
a
a
a
a
a
a
n
n
n
n
n
n
n
n
n
"}
(48,1,1) = {"
J
J
J
a
a
a
a
a
a
a
a
a
a
a
a
a
a
a
a
a
a
a
a
a
a
a
a
a
a
a
a
a
n
n
n
n
n
n
n
n
"}
(49,1,1) = {"
J
J
a
a
a
a
a
a
a
a
a
a
a
a
a
a
a
a
a
a
a
a
a
a
a
a
a
a
a
a
a
a
a
a
n
n
n
n
n
n
"}
(50,1,1) = {"
J
J
a
a
a
a
a
a
a
a
a
a
a
a
a
a
a
a
a
a
a
a
a
a
a
a
a
a
a
a
a
a
a
a
a
n
n
n
n
n
"}
(51,1,1) = {"
J
J
a
a
a
a
a
a
a
a
a
a
a
a
a
a
a
a
a
a
a
a
a
a
a
a
a
a
a
a
a
a
a
a
a
a
n
n
n
n
"}
(52,1,1) = {"
J
J
a
a
a
a
a
a
a
a
a
a
a
a
a
a
a
a
a
a
a
a
a
a
a
a
a
a
a
a
a
a
a
a
a
a
a
n
n
n
"}
(53,1,1) = {"
J
J
a
a
a
a
a
a
a
a
a
a
a
a
a
a
a
a
a
a
a
a
a
a
a
a
a
a
a
a
a
a
a
a
a
a
a
n
n
n
"}
(54,1,1) = {"
J
J
a
a
a
a
a
a
a
a
a
a
a
a
a
a
a
a
a
a
a
a
a
a
a
a
a
a
a
a
a
a
a
a
a
a
a
a
n
n
"}
(55,1,1) = {"
J
J
a
a
a
a
a
a
a
a
a
a
a
a
a
a
a
a
a
a
a
a
a
a
a
a
a
a
a
a
a
a
a
a
a
a
a
a
n
n
"}
(56,1,1) = {"
J
J
a
a
a
a
a
a
a
a
a
a
a
a
a
a
a
a
a
a
a
a
a
a
a
a
a
a
a
a
a
a
a
a
a
a
a
a
n
n
"}
(57,1,1) = {"
J
J
a
a
a
a
a
a
a
a
a
a
a
a
a
a
a
a
a
a
a
a
a
a
a
a
a
a
a
a
a
a
a
a
a
a
a
a
n
n
"}
(58,1,1) = {"
J
a
a
a
a
a
a
a
a
a
a
a
a
a
a
a
a
a
a
a
a
a
a
a
a
a
a
a
a
a
a
a
a
a
a
a
a
a
a
n
"}
(59,1,1) = {"
J
a
a
a
a
a
a
a
a
a
a
a
a
a
a
a
a
a
a
a
a
a
a
a
a
a
a
a
a
a
a
a
a
a
a
a
a
a
a
n
"}
(60,1,1) = {"
J
a
a
a
a
a
a
a
a
a
a
a
a
a
a
a
a
a
a
a
a
a
a
a
a
a
a
a
a
a
a
a
a
a
a
a
a
a
a
n
"}
(61,1,1) = {"
J
a
a
a
a
a
a
a
a
a
a
a
a
a
a
a
a
a
a
a
a
a
a
a
a
a
a
a
a
a
a
a
a
a
a
a
a
a
a
n
"}
(62,1,1) = {"
J
a
a
a
a
a
a
a
a
a
a
a
a
a
a
a
a
a
a
a
a
a
a
a
a
a
a
a
a
a
a
a
a
a
a
a
a
a
a
n
"}
(63,1,1) = {"
J
a
a
a
a
a
a
a
a
a
a
a
a
a
a
a
a
a
a
a
a
a
a
a
a
a
a
a
a
a
a
a
a
a
a
a
a
a
a
n
"}
(64,1,1) = {"
J
a
a
a
a
a
a
a
a
a
a
a
a
a
a
a
a
a
a
a
a
a
a
a
a
a
a
a
a
a
a
a
a
a
a
a
a
a
a
n
"}
(65,1,1) = {"
J
a
a
a
a
a
a
a
a
a
a
a
a
a
a
a
a
a
a
a
a
a
a
a
a
a
a
a
a
a
a
a
a
a
a
a
a
a
a
n
"}
(66,1,1) = {"
J
a
a
a
a
a
a
a
a
a
a
a
a
a
a
a
a
a
a
a
a
a
a
a
a
a
a
a
a
a
a
a
a
a
a
a
a
a
a
n
"}
(67,1,1) = {"
J
a
a
a
a
a
a
a
a
a
a
a
a
a
a
a
a
a
a
a
a
a
a
a
a
a
a
a
a
a
a
a
a
a
a
a
a
a
a
n
"}
(68,1,1) = {"
J
a
a
a
a
a
a
a
a
a
a
a
a
a
a
a
a
a
a
a
a
a
a
a
a
a
a
a
a
a
a
a
a
a
a
a
a
a
a
n
"}
(69,1,1) = {"
J
a
a
a
a
a
a
a
a
a
a
a
a
a
a
a
a
a
a
a
a
a
a
a
a
a
a
a
a
a
a
a
a
a
a
a
a
a
a
n
"}
(70,1,1) = {"
J
a
a
a
a
a
a
a
a
a
a
a
a
a
a
a
a
a
a
a
a
a
a
a
a
a
a
a
a
a
a
a
a
a
a
a
a
a
a
n
"}
(71,1,1) = {"
J
a
a
a
a
a
a
a
a
a
a
a
a
a
a
a
a
a
a
a
a
a
a
a
a
a
a
a
a
a
a
a
a
a
a
a
a
a
a
n
"}
(72,1,1) = {"
J
a
a
a
a
a
a
a
a
a
a
a
a
a
a
a
a
a
a
a
a
a
a
a
a
a
a
a
a
a
a
a
a
a
a
a
a
a
a
n
"}
(73,1,1) = {"
J
a
a
a
a
a
a
a
a
a
a
a
a
a
a
a
a
a
a
a
a
a
a
a
a
a
a
a
a
a
a
a
a
a
a
a
a
a
a
n
"}
(74,1,1) = {"
J
a
a
a
a
a
a
a
a
a
a
a
a
a
a
a
a
a
a
a
a
a
a
a
a
a
a
a
a
a
a
a
a
a
a
a
a
a
a
n
"}
(75,1,1) = {"
J
a
a
a
a
a
a
a
a
a
a
a
a
a
a
a
a
a
a
a
a
a
a
a
a
a
a
a
a
a
a
a
a
a
a
a
a
a
a
n
"}
(76,1,1) = {"
J
a
a
a
a
a
a
a
a
a
a
a
a
a
a
a
a
a
a
a
a
a
a
a
a
a
a
a
a
a
a
a
a
a
a
a
a
a
a
n
"}
(77,1,1) = {"
J
a
a
a
a
a
a
a
a
a
a
a
a
a
a
a
a
a
a
a
a
a
a
a
a
a
a
a
a
a
a
a
a
a
a
a
a
a
a
n
"}
(78,1,1) = {"
J
a
a
a
a
a
a
a
a
a
a
a
a
a
a
a
a
a
a
a
a
a
a
a
a
a
a
a
a
a
a
a
a
a
a
a
a
a
a
n
"}
(79,1,1) = {"
J
a
a
a
a
a
a
a
a
a
a
a
a
a
a
a
a
a
a
a
a
a
a
a
a
a
a
a
a
a
a
a
a
a
a
a
a
a
a
n
"}
(80,1,1) = {"
J
a
a
a
a
a
a
a
a
a
a
a
a
a
a
a
a
a
a
a
a
a
a
a
a
a
a
a
a
a
a
a
a
a
a
a
a
a
a
n
"}
(81,1,1) = {"
J
a
a
a
a
a
a
a
a
a
a
a
a
a
a
a
a
a
a
a
a
a
a
a
a
a
a
a
a
a
a
a
a
a
a
a
a
a
a
n
"}
(82,1,1) = {"
J
a
a
a
a
a
a
a
a
a
a
a
a
a
a
a
a
a
a
a
a
a
a
a
a
a
a
a
a
a
a
a
a
a
a
a
a
a
a
n
"}
(83,1,1) = {"
J
a
a
a
a
a
a
a
a
a
a
a
a
a
a
a
a
a
a
a
a
a
a
a
a
a
a
a
a
a
a
a
a
a
a
a
a
a
a
n
"}
(84,1,1) = {"
J
a
a
a
a
a
a
a
a
a
a
a
a
a
a
a
a
a
a
a
a
a
a
a
a
a
a
a
a
a
a
a
a
a
a
a
a
a
a
n
"}
(85,1,1) = {"
J
a
a
a
a
a
a
a
a
a
a
a
a
a
a
a
a
a
a
a
a
a
a
a
a
a
a
a
a
a
a
a
a
a
a
a
a
a
a
n
"}
(86,1,1) = {"
J
a
a
a
a
a
a
a
a
a
a
a
a
a
a
a
a
a
a
a
a
a
a
a
a
a
a
a
a
a
a
a
a
a
a
a
a
a
a
n
"}
(87,1,1) = {"
J
a
a
a
a
a
a
a
a
a
a
a
a
a
a
a
a
a
a
a
a
a
a
a
a
a
a
a
a
a
a
a
a
a
a
a
a
a
a
n
"}
(88,1,1) = {"
J
a
a
a
a
a
a
a
a
a
a
a
a
a
a
a
a
a
a
a
a
a
a
a
a
a
a
a
a
a
a
a
a
a
a
a
a
a
a
n
"}
(89,1,1) = {"
J
a
a
a
a
a
a
a
a
a
a
a
a
a
a
a
a
a
a
a
a
a
a
a
a
a
a
a
a
a
a
a
a
a
a
a
a
a
a
n
"}
(90,1,1) = {"
J
a
a
a
a
a
a
a
a
a
a
a
a
a
a
a
a
a
a
a
a
a
a
a
a
a
a
a
a
a
a
a
a
a
a
a
a
a
a
n
"}
(91,1,1) = {"
J
a
a
a
a
a
a
a
a
a
a
a
a
a
a
a
a
a
a
a
a
a
a
a
a
a
a
a
a
a
a
a
a
a
a
a
a
a
a
n
"}
(92,1,1) = {"
J
a
a
a
a
a
a
a
a
a
a
a
a
a
a
a
a
a
a
a
a
a
a
a
a
a
a
a
a
a
a
a
a
a
a
a
a
a
a
n
"}
(93,1,1) = {"
J
a
a
a
a
a
a
a
a
a
a
a
a
a
a
a
a
a
a
a
a
a
a
a
a
a
a
a
a
a
a
a
a
a
a
a
a
a
a
n
"}
(94,1,1) = {"
J
a
a
a
a
a
a
a
a
a
a
a
a
a
a
a
a
a
a
a
a
a
a
a
a
a
a
a
a
a
a
a
a
a
a
a
a
a
a
n
"}
(95,1,1) = {"
J
a
a
a
a
a
a
a
a
a
a
a
a
a
a
a
a
a
a
a
a
a
a
a
a
a
a
a
a
a
a
a
a
a
a
a
a
a
a
n
"}
(96,1,1) = {"
J
a
a
a
a
a
a
a
a
a
a
a
a
a
a
a
a
a
a
a
a
a
a
a
a
a
a
a
a
a
a
a
a
a
a
a
a
a
a
n
"}
(97,1,1) = {"
J
a
a
a
a
a
a
a
a
a
a
a
a
a
a
a
a
a
a
a
a
a
a
a
a
a
a
a
a
a
a
a
a
a
a
a
a
a
a
n
"}
(98,1,1) = {"
J
a
a
a
a
a
a
a
a
a
a
a
a
a
a
a
a
a
a
a
a
a
a
a
a
a
a
a
a
a
a
a
a
a
a
a
a
a
a
n
"}
(99,1,1) = {"
J
a
a
a
a
a
a
a
a
a
a
a
a
a
a
a
a
a
a
a
a
a
a
a
a
a
a
a
a
a
a
a
a
a
a
a
a
a
a
n
"}
(100,1,1) = {"
J
a
a
a
a
a
a
a
a
a
a
a
a
a
a
a
a
a
a
a
a
a
a
a
a
a
a
a
a
a
a
a
a
a
a
a
a
a
a
n
"}
(101,1,1) = {"
J
a
a
a
a
a
a
a
a
a
a
a
a
a
a
a
a
a
a
a
a
a
a
a
a
a
a
a
a
a
a
a
a
a
a
a
a
a
a
n
"}
(102,1,1) = {"
J
a
a
a
a
a
a
a
a
a
a
a
a
a
a
a
a
a
a
a
a
a
a
a
a
a
a
a
a
a
a
a
a
a
a
a
a
a
a
n
"}
(103,1,1) = {"
J
a
a
a
a
a
a
a
a
a
a
a
a
a
a
a
a
a
a
a
a
a
a
a
a
a
a
a
a
a
a
a
a
a
a
a
a
a
a
n
"}
(104,1,1) = {"
J
a
a
a
a
a
a
a
a
a
a
a
a
a
a
a
a
a
a
a
a
a
a
a
a
a
a
a
a
a
a
a
a
a
a
a
a
a
a
n
"}
(105,1,1) = {"
J
a
a
a
a
a
a
a
a
a
a
a
a
a
a
a
a
a
a
a
a
a
a
a
a
a
a
a
a
a
a
a
a
a
a
a
a
a
a
n
"}
(106,1,1) = {"
J
a
a
a
a
a
a
a
a
a
a
a
a
a
a
a
a
a
a
a
a
a
a
a
a
a
a
a
a
a
a
a
a
a
a
a
a
a
a
n
"}
(107,1,1) = {"
J
a
a
a
a
a
a
a
a
a
a
a
a
a
a
a
a
a
a
a
a
a
a
a
a
a
a
a
a
a
a
a
a
a
a
a
a
a
a
n
"}
(108,1,1) = {"
J
J
a
a
a
a
a
a
a
a
a
a
a
a
a
a
a
a
a
a
a
a
a
a
a
a
a
a
a
a
a
a
a
a
a
a
a
a
a
n
"}
(109,1,1) = {"
J
J
a
a
a
a
a
a
a
a
a
a
a
a
a
a
a
a
a
a
a
a
a
a
a
a
a
a
a
a
a
a
a
a
a
a
a
a
a
n
"}
(110,1,1) = {"
J
J
a
a
a
a
a
a
a
a
a
a
a
a
a
a
a
a
a
a
a
a
a
a
a
a
a
a
a
a
a
a
a
a
a
a
a
a
a
n
"}
(111,1,1) = {"
J
J
a
a
a
a
a
a
a
a
a
a
a
a
a
a
a
a
a
a
a
a
a
a
a
a
a
a
a
a
a
a
a
a
a
a
a
a
a
n
"}
(112,1,1) = {"
J
J
J
a
a
a
a
a
a
a
a
a
a
a
a
a
a
a
a
a
a
a
a
a
a
a
a
a
a
a
a
a
a
a
a
a
a
a
a
n
"}
(113,1,1) = {"
J
J
J
a
a
a
a
a
a
a
a
a
a
a
a
a
a
a
a
a
a
a
a
a
a
a
a
a
a
a
a
a
a
a
a
a
a
a
a
n
"}
(114,1,1) = {"
J
J
J
a
a
a
a
a
a
a
a
a
a
a
a
a
a
a
a
a
a
a
a
a
a
a
a
a
a
a
a
a
a
a
a
a
a
a
a
n
"}
(115,1,1) = {"
J
J
J
a
a
a
a
a
a
a
a
a
a
a
a
a
a
a
a
a
a
a
a
a
a
a
a
a
a
a
a
a
a
v
H
H
C
a
a
n
"}
(116,1,1) = {"
J
J
J
a
a
a
a
a
a
a
a
a
a
a
a
a
a
a
a
a
a
a
a
a
a
a
a
a
a
a
a
a
a
v
H
H
C
a
a
n
"}
(117,1,1) = {"
J
J
J
a
a
a
a
a
a
a
a
a
a
a
a
a
a
a
a
a
a
a
a
a
a
a
a
a
a
a
a
a
a
v
H
H
C
a
a
n
"}
(118,1,1) = {"
J
J
J
a
a
a
a
a
a
a
a
a
a
a
a
a
a
a
a
a
a
a
a
a
a
a
a
a
a
a
a
a
a
v
H
H
C
a
a
n
"}
(119,1,1) = {"
J
J
J
a
a
a
a
a
a
a
a
a
a
a
a
a
a
a
a
a
a
a
a
a
a
a
a
a
a
a
a
a
a
v
H
H
C
a
a
n
"}
(120,1,1) = {"
J
J
J
J
a
a
a
a
a
a
a
a
a
a
a
a
a
a
a
a
a
a
a
a
a
a
a
a
a
a
a
a
a
v
H
H
C
a
a
n
"}
(121,1,1) = {"
J
J
J
J
a
a
a
a
a
a
a
a
a
a
a
a
a
a
a
a
a
a
a
a
a
a
a
a
a
a
a
a
a
v
H
H
C
a
a
n
"}
(122,1,1) = {"
J
J
J
J
a
a
a
a
a
a
a
a
a
a
a
a
a
a
a
a
a
a
a
a
a
a
a
a
a
a
a
a
a
v
H
H
C
a
a
n
"}
(123,1,1) = {"
J
J
J
J
J
J
J
a
a
a
a
a
a
a
a
a
a
a
a
a
a
a
a
a
a
a
a
a
a
a
a
a
a
v
H
H
C
J
J
n
"}
(124,1,1) = {"
J
J
J
J
J
J
J
J
J
a
a
a
a
a
a
a
a
a
a
a
a
a
a
a
a
a
a
a
a
a
a
a
J
U
H
H
R
J
J
n
"}
(125,1,1) = {"
J
D
t
J
g
J
J
J
J
J
J
J
J
J
a
a
a
a
a
a
a
a
a
J
J
J
J
J
J
z
J
J
T
J
J
J
J
J
J
n
"}
(126,1,1) = {"
J
J
J
J
J
J
J
J
J
J
J
J
J
J
J
J
J
J
J
J
J
J
J
J
J
J
J
J
J
z
T
X
X
X
B
X
X
X
J
n
"}
(127,1,1) = {"
J
J
J
g
J
J
J
J
J
J
J
J
J
J
J
J
J
J
J
J
J
J
J
J
J
J
J
J
J
z
T
X
S
V
w
w
x
X
J
n
"}
(128,1,1) = {"
g
J
J
J
J
J
t
J
g
J
J
J
J
J
J
J
J
J
J
J
J
J
J
J
J
J
J
J
J
z
J
X
N
Y
k
k
h
X
J
n
"}
(129,1,1) = {"
J
D
t
J
g
J
J
J
J
J
J
J
J
J
J
J
J
J
J
J
J
J
t
J
g
J
J
J
J
z
J
X
N
k
k
k
h
X
J
n
"}
(130,1,1) = {"
J
J
J
J
J
t
J
g
J
J
J
J
J
J
J
J
J
g
J
g
J
g
g
J
J
J
J
J
J
J
J
X
Z
I
u
k
h
X
J
n
"}
(131,1,1) = {"
Q
J
J
t
g
J
J
J
J
J
J
J
t
J
J
J
J
J
J
J
J
J
J
g
J
J
J
J
J
J
J
X
F
I
I
k
h
X
J
n
"}
(132,1,1) = {"
t
J
J
J
t
g
t
J
g
J
J
g
g
J
J
J
t
J
t
J
t
J
e
J
J
g
J
J
J
J
J
X
j
G
G
M
P
X
J
n
"}
(133,1,1) = {"
J
g
J
J
J
t
J
J
J
J
J
J
J
J
g
J
D
t
J
J
J
J
t
J
g
J
J
J
J
z
J
X
X
X
X
X
X
X
J
n
"}
(134,1,1) = {"
J
J
J
J
J
J
J
t
g
g
J
g
J
g
J
D
J
J
t
t
J
t
g
J
J
J
J
g
J
z
J
J
J
J
J
J
J
J
J
n
"}
(135,1,1) = {"
t
J
g
J
J
J
A
J
t
J
D
t
J
g
J
D
J
g
g
J
J
J
J
t
t
Q
J
J
J
J
J
J
J
J
l
J
J
l
l
n
"}
(136,1,1) = {"
J
g
J
D
t
J
J
J
J
J
D
t
J
t
J
g
J
J
J
J
J
J
J
Q
t
t
t
J
e
J
J
J
J
J
J
J
J
J
J
n
"}
(137,1,1) = {"
J
J
g
J
J
J
J
J
J
J
g
J
t
J
g
J
t
J
e
J
J
J
J
J
J
J
J
J
t
J
g
J
J
J
J
J
J
J
J
n
"}
(138,1,1) = {"
J
g
J
D
t
J
g
J
J
J
J
J
J
J
J
J
J
J
t
J
g
J
J
g
J
J
J
t
g
J
J
J
J
J
J
J
J
J
J
n
"}
(139,1,1) = {"
g
J
D
t
J
g
J
D
t
J
J
J
J
J
g
J
D
t
J
J
J
J
g
J
D
t
J
J
J
t
t
Q
J
J
t
g
J
J
J
n
"}
(140,1,1) = {"
J
J
J
J
J
J
J
J
o
g
J
g
J
g
J
D
J
J
t
g
J
g
J
D
J
J
t
J
g
J
D
t
J
g
J
t
g
J
J
n
"}
(141,1,1) = {"
J
J
J
J
J
J
J
J
J
J
D
t
J
g
J
D
J
g
g
t
J
g
J
D
J
g
g
J
A
J
J
J
J
J
J
J
t
J
J
n
"}
(142,1,1) = {"
J
J
J
J
J
g
J
D
t
J
D
t
J
t
J
g
J
J
J
t
J
t
J
g
J
J
J
g
J
J
J
J
g
J
J
J
J
J
J
n
"}
(143,1,1) = {"
g
J
g
J
g
J
D
J
J
J
g
J
t
J
g
J
t
J
e
J
t
J
g
J
t
J
e
J
J
g
J
J
J
J
J
J
J
J
J
n
"}
(144,1,1) = {"
J
D
t
J
g
J
D
J
g
J
J
J
J
J
J
J
J
J
J
g
J
D
t
J
J
J
t
J
g
J
D
t
J
g
J
t
J
J
J
n
"}
(145,1,1) = {"
J
D
t
J
t
J
g
J
J
g
J
d
J
J
g
J
g
J
g
J
D
J
J
t
J
t
g
J
J
J
J
J
J
J
t
J
J
J
J
n
"}
(146,1,1) = {"
J
g
J
t
J
g
J
t
J
J
J
J
J
J
J
D
t
J
g
J
D
J
g
g
J
J
J
t
t
Q
J
J
t
g
J
J
J
J
J
n
"}
(147,1,1) = {"
J
J
J
J
J
J
J
J
J
g
J
D
t
J
J
D
t
J
t
J
g
J
J
J
J
D
t
J
g
J
J
J
J
t
g
J
J
J
J
n
"}
(148,1,1) = {"
g
J
J
J
g
J
g
J
g
J
D
J
J
t
J
g
J
t
J
g
J
t
J
e
J
J
J
J
J
J
g
J
J
J
t
J
J
J
J
n
"}
(149,1,1) = {"
J
J
J
J
J
D
t
J
g
J
D
J
g
g
J
J
J
J
J
J
J
J
J
t
J
J
J
g
J
J
J
J
J
J
J
J
J
J
n
n
"}
(150,1,1) = {"
J
g
J
J
J
D
t
J
t
J
g
J
J
J
g
J
J
J
J
J
J
J
t
g
g
J
J
J
J
J
J
g
J
J
J
J
J
J
n
n
"}
(151,1,1) = {"
J
J
t
J
J
g
J
t
J
g
J
t
J
e
J
J
J
J
J
J
J
J
J
J
t
J
g
J
g
J
g
J
D
t
J
J
J
J
n
n
"}
(152,1,1) = {"
J
J
J
J
J
J
J
J
J
J
A
J
J
t
J
g
J
J
t
J
g
J
D
t
J
J
J
J
J
t
J
J
J
J
J
J
J
n
n
n
"}
(153,1,1) = {"
D
t
J
g
g
J
J
J
J
J
J
J
t
g
J
J
t
J
g
J
J
J
J
J
J
g
J
J
g
J
J
J
J
J
J
J
J
n
n
n
"}
(154,1,1) = {"
t
J
g
J
J
J
J
J
J
J
J
J
J
J
J
g
J
D
t
J
J
J
J
J
J
J
J
J
t
g
J
J
J
J
J
J
J
n
n
n
"}
(155,1,1) = {"
J
J
J
J
J
g
J
J
t
J
g
J
D
t
t
J
g
J
D
t
J
J
J
J
g
o
J
J
J
t
J
J
J
J
J
n
n
n
n
n
"}
(156,1,1) = {"
J
J
J
J
J
J
t
J
g
J
J
J
J
J
J
J
t
J
e
J
J
g
J
J
J
J
J
t
J
J
J
J
J
J
n
n
n
n
n
n
"}
(157,1,1) = {"
t
J
g
J
J
J
g
J
D
t
J
g
J
D
t
J
J
g
J
D
t
J
g
J
J
g
J
J
J
J
J
n
n
n
n
n
n
n
n
n
"}
(158,1,1) = {"
J
J
J
J
J
J
J
Q
t
t
J
J
J
t
g
g
J
J
J
J
J
J
J
J
J
J
t
g
t
J
J
n
n
n
n
n
n
n
n
n
"}
(159,1,1) = {"
J
g
J
J
J
J
J
J
J
J
g
J
J
J
t
J
g
J
J
J
J
g
J
J
t
g
J
t
J
J
n
n
n
n
n
n
n
n
n
n
"}
(160,1,1) = {"
J
J
J
J
g
J
J
g
J
J
J
J
J
J
J
D
t
J
g
J
J
J
J
J
J
t
g
J
J
J
n
n
n
n
n
n
n
n
n
n
"}
(161,1,1) = {"
t
J
g
J
J
J
g
J
D
t
J
g
J
J
J
J
J
J
J
J
t
J
g
J
J
J
t
J
J
J
n
n
n
n
n
n
n
n
n
n
"}
(162,1,1) = {"
J
J
J
t
J
g
J
D
t
J
g
J
D
t
J
J
J
g
J
J
J
J
J
t
J
J
J
J
J
n
n
n
n
n
n
n
n
n
n
n
"}
(163,1,1) = {"
J
t
g
J
J
J
d
J
o
t
J
e
J
J
g
J
J
J
J
J
J
t
g
J
J
J
J
J
J
n
n
n
n
n
n
n
n
n
n
n
"}
(164,1,1) = {"
J
J
t
g
J
J
J
J
J
J
J
t
J
g
J
D
t
J
g
J
J
J
t
g
D
t
J
J
J
n
n
n
n
n
n
n
n
n
n
n
"}
(165,1,1) = {"
J
J
J
t
J
J
J
J
J
J
t
g
J
J
J
J
J
J
J
t
J
J
J
t
J
J
J
J
n
n
n
n
n
n
n
n
n
n
n
n
"}
(166,1,1) = {"
J
J
J
J
J
J
J
J
J
J
J
J
t
t
Q
J
J
t
g
J
J
J
J
J
J
J
J
n
n
n
n
n
n
n
n
n
n
n
n
n
"}
(167,1,1) = {"
g
J
J
J
J
J
J
J
J
J
J
J
Q
t
t
J
J
J
t
g
g
J
J
J
J
J
n
n
n
n
n
n
n
n
n
n
n
n
n
n
"}
(168,1,1) = {"
J
D
t
J
J
J
J
J
J
J
J
J
J
J
J
g
J
J
J
t
J
D
t
J
n
n
n
n
n
n
n
n
n
n
n
n
n
n
n
n
"}
(169,1,1) = {"
J
J
J
J
J
J
J
J
J
g
J
J
g
J
J
J
J
J
J
J
n
n
n
n
n
n
n
n
n
n
n
n
n
n
n
n
n
n
n
n
"}
(170,1,1) = {"
n
n
n
n
n
n
n
n
n
n
n
n
n
n
n
n
n
n
n
n
n
n
n
n
n
n
n
n
n
n
n
n
n
n
n
n
n
n
n
n
"}
