//MAP CONVERTED BY dmm2tgm.py THIS HEADER COMMENT PREVENTS RECONVERSION, DO NOT REMOVE
"a" = (
/turf/open/misc/ice/coldroom,
/area/trainstation/outdoor)
"c" = (
/turf/open/indestructible/train_platform/bottom,
/area/trainstation/outdoor)
"e" = (
/obj/structure/flora/rock/style_random,
/turf/open/misc/asteroid/snow/indestructible,
/area/trainstation/outdoor)
"i" = (
/obj/structure/chair/sofa/bench/right,
/turf/open/indestructible/train_platform,
/area/trainstation/outdoor)
"j" = (
/obj/structure/flora/tree/dead/style_random,
/turf/open/misc/asteroid/snow/indestructible,
/area/trainstation/outdoor)
"k" = (
/obj/structure/flora/bush/snow/style_random,
/turf/open/misc/asteroid/snow/indestructible,
/area/trainstation/outdoor)
"l" = (
/turf/open/misc/asteroid/snow/indestructible,
/area/trainstation/outdoor)
"p" = (
/obj/effect/spawner/random/structure/billboard/nanotrasen,
/turf/open/indestructible/train_platform,
/area/trainstation/outdoor)
"q" = (
/obj/structure/flora/tree/pine/style_random,
/obj/structure/flora/bush/snow/style_random,
/turf/open/misc/asteroid/snow/indestructible,
/area/trainstation/outdoor)
"s" = (
/obj/structure/flora/tree/pine/style_random,
/turf/open/misc/asteroid/snow/indestructible,
/area/trainstation/outdoor)
"t" = (
/obj/effect/spawner/random/structure/billboard/roadsigns,
/turf/open/indestructible/train_platform,
/area/trainstation/outdoor)
"u" = (
/obj/structure/flora/rock/style_random,
/obj/structure/flora/bush/snow/style_random,
/turf/open/misc/asteroid/snow/indestructible,
/area/trainstation/outdoor)
"v" = (
/turf/open/misc/asteroid/snow/standard_air,
/area/trainstation/outdoor)
"z" = (
/obj/effect/spawner/random/structure/shipping_container,
/turf/open/indestructible/train_platform,
/area/trainstation/outdoor)
"A" = (
/obj/structure/chair/sofa/bench/left,
/turf/open/indestructible/train_platform,
/area/trainstation/outdoor)
"B" = (
/turf/closed/indestructible/normal_wall,
/area/trainstation/outdoor)
"C" = (
/obj/effect/spawner/random/structure/crate_loot,
/turf/open/indestructible/train_platform,
/area/trainstation/outdoor)
"F" = (
/obj/structure/chair/sofa/bench/left{
	dir = 1
	},
/turf/open/indestructible/train_platform,
/area/trainstation/outdoor)
"H" = (
/turf/open/indestructible/train_platform,
/area/trainstation/outdoor)
"J" = (
/obj/structure/prop/general/trashblue{
	pixel_y = 14
	},
/turf/open/indestructible/train_platform,
/area/trainstation/outdoor)
"M" = (
/obj/structure/prop/general/zenithplatform3,
/turf/open/indestructible/train_platform,
/area/trainstation/outdoor)
"N" = (
/obj/structure/chair/sofa/bench/right{
	dir = 1
	},
/turf/open/indestructible/train_platform,
/area/trainstation/outdoor)
"O" = (
/turf/closed/indestructible/rock/snow/ice/ore,
/area/trainstation/outdoor)
"V" = (
/obj/structure/flora/tree/dead/style_random,
/obj/structure/flora/bush/snow/style_random,
/turf/open/misc/asteroid/snow/indestructible,
/area/trainstation/outdoor)

(1,1,1) = {"
v
l
l
l
l
l
l
l
l
v
l
v
v
v
v
v
v
v
v
v
v
v
v
v
v
v
v
v
v
O
"}
(2,1,1) = {"
v
l
s
l
l
l
l
s
l
l
l
l
l
s
l
j
v
l
v
v
v
v
v
v
v
v
v
v
v
O
"}
(3,1,1) = {"
v
u
l
l
s
l
l
l
l
s
l
l
l
l
s
l
v
l
l
l
l
l
s
l
j
v
l
v
v
O
"}
(4,1,1) = {"
v
k
l
s
l
e
k
l
u
l
l
s
l
l
l
l
v
l
s
l
l
l
l
s
l
v
l
v
v
O
"}
(5,1,1) = {"
v
s
l
l
v
v
v
v
k
l
s
l
e
k
l
s
v
u
l
l
s
l
l
l
l
v
l
s
v
O
"}
(6,1,1) = {"
v
l
s
l
l
l
l
s
s
l
l
v
v
v
v
v
v
k
l
s
l
e
k
l
s
v
l
l
v
O
"}
(7,1,1) = {"
v
u
l
l
s
l
l
l
l
s
l
l
l
l
s
l
v
s
l
l
v
v
v
v
v
v
l
l
v
O
"}
(8,1,1) = {"
v
k
l
s
l
e
k
l
u
l
l
s
l
l
l
l
v
l
s
l
l
l
l
s
l
v
s
l
v
O
"}
(9,1,1) = {"
v
s
l
l
v
v
v
v
k
l
s
l
e
k
l
s
v
u
l
l
s
l
l
l
l
v
l
s
v
O
"}
(10,1,1) = {"
v
l
k
k
q
l
l
k
s
l
l
v
v
v
v
v
k
k
l
s
l
e
k
l
s
v
l
l
v
O
"}
(11,1,1) = {"
v
l
q
k
k
l
l
l
l
k
k
q
l
l
k
s
l
s
l
l
v
v
v
v
v
k
l
l
v
O
"}
(12,1,1) = {"
v
l
l
l
l
s
l
v
l
q
k
k
l
l
l
k
s
l
k
k
q
l
l
k
s
l
l
l
v
O
"}
(13,1,1) = {"
v
l
s
l
l
l
l
v
l
l
l
l
s
l
v
l
k
l
q
k
k
l
l
l
k
s
l
l
v
O
"}
(14,1,1) = {"
v
s
l
e
k
l
s
v
l
s
l
l
l
l
v
l
l
l
l
l
l
s
l
v
l
k
k
l
v
O
"}
(15,1,1) = {"
v
v
v
v
l
l
l
l
s
l
e
k
l
s
v
l
l
l
s
l
l
l
l
v
l
l
l
l
v
O
"}
(16,1,1) = {"
v
v
v
v
l
l
l
s
l
e
k
l
s
l
e
k
l
s
l
e
k
l
s
v
l
l
l
l
v
O
"}
(17,1,1) = {"
v
v
v
v
l
s
l
l
l
l
s
l
l
v
v
v
v
v
v
k
l
l
l
j
l
k
s
l
v
O
"}
(18,1,1) = {"
l
l
s
l
l
l
s
l
l
s
l
s
l
l
l
l
s
l
v
l
s
l
s
l
l
l
l
l
v
O
"}
(19,1,1) = {"
l
s
l
e
k
l
l
l
j
l
u
l
l
s
l
l
l
l
v
l
l
l
l
l
s
j
l
l
v
O
"}
(20,1,1) = {"
l
s
s
l
k
l
l
s
l
e
k
l
s
l
e
k
l
s
v
l
l
s
l
j
l
l
l
l
v
O
"}
(21,1,1) = {"
l
l
l
l
s
l
l
l
s
k
l
l
s
s
l
k
l
l
v
l
l
l
l
l
e
k
s
l
v
O
"}
(22,1,1) = {"
s
l
l
l
l
s
l
l
l
l
l
l
l
l
l
s
l
j
v
l
s
l
l
s
l
l
l
l
v
O
"}
(23,1,1) = {"
l
l
s
l
l
l
s
l
l
s
l
s
l
l
l
l
s
l
v
l
l
l
l
l
l
k
s
l
v
O
"}
(24,1,1) = {"
l
s
l
e
k
l
l
l
j
l
u
l
l
s
l
l
l
l
v
l
l
s
l
l
s
l
l
l
v
O
"}
(25,1,1) = {"
l
l
v
v
v
l
l
s
l
e
k
l
s
l
e
k
l
s
v
l
l
l
s
l
l
k
l
j
v
O
"}
(26,1,1) = {"
s
l
l
l
l
s
l
l
l
l
s
l
l
v
v
v
v
v
v
l
j
l
s
l
l
l
s
l
v
O
"}
(27,1,1) = {"
l
l
s
l
l
l
s
l
l
s
l
s
l
l
l
l
s
l
v
s
l
l
l
l
l
q
k
l
v
O
"}
(28,1,1) = {"
l
s
l
e
k
l
l
l
j
l
u
l
l
s
l
l
l
l
v
l
l
s
l
s
j
k
l
l
v
O
"}
(29,1,1) = {"
l
l
v
v
v
l
l
s
l
e
k
l
s
l
e
k
l
s
v
l
l
l
l
l
k
l
l
l
v
O
"}
(30,1,1) = {"
k
k
q
l
l
s
l
l
l
l
s
l
l
v
v
v
v
v
k
l
l
s
s
l
k
l
l
s
v
O
"}
(31,1,1) = {"
q
k
k
l
l
l
l
s
l
v
l
k
k
q
l
l
k
s
l
l
l
l
l
l
s
l
j
l
v
O
"}
(32,1,1) = {"
l
l
l
s
l
l
l
l
l
v
l
q
k
k
l
l
l
k
s
l
s
l
l
l
l
s
l
l
v
O
"}
(33,1,1) = {"
s
l
l
l
l
e
k
l
s
v
l
l
l
l
s
l
v
l
k
k
q
l
l
k
s
l
l
l
v
O
"}
(34,1,1) = {"
l
e
k
l
s
l
j
l
u
l
l
s
l
l
l
l
v
l
l
l
l
j
l
u
l
l
s
l
v
O
"}
(35,1,1) = {"
v
v
v
l
l
s
l
e
k
l
s
l
e
k
l
s
v
l
l
l
s
l
e
k
l
v
v
v
v
O
"}
(36,1,1) = {"
v
v
v
s
l
l
l
l
s
l
l
v
v
v
v
v
v
l
s
l
l
l
l
s
l
v
v
v
v
O
"}
(37,1,1) = {"
v
v
v
v
v
v
v
v
v
v
v
v
v
v
v
v
v
l
k
k
k
s
l
l
k
l
j
l
u
O
"}
(38,1,1) = {"
v
v
v
l
l
l
s
k
l
l
s
s
l
k
l
l
v
l
k
q
k
l
l
l
V
s
l
e
k
O
"}
(39,1,1) = {"
l
s
l
l
l
l
l
l
l
l
l
l
l
s
l
j
v
j
k
k
k
l
s
l
l
l
l
a
a
O
"}
(40,1,1) = {"
s
l
e
k
s
l
l
s
l
s
l
l
l
l
s
l
v
l
k
k
q
l
l
k
s
k
a
a
a
O
"}
(41,1,1) = {"
s
s
l
k
l
l
j
l
u
l
l
s
l
l
l
l
v
l
q
k
k
l
l
l
k
k
a
a
a
O
"}
(42,1,1) = {"
l
l
l
s
l
s
l
e
k
l
s
l
e
k
l
s
v
l
k
k
q
l
l
q
u
k
a
a
a
O
"}
(43,1,1) = {"
l
l
l
l
l
l
l
l
s
l
l
v
v
v
v
v
v
k
l
l
l
j
l
k
s
q
a
a
a
O
"}
(44,1,1) = {"
l
s
l
l
s
l
l
s
l
s
l
l
l
l
s
l
v
l
s
l
s
l
l
l
l
a
a
a
a
O
"}
(45,1,1) = {"
s
l
e
k
l
l
j
l
u
l
l
s
l
l
l
l
v
l
l
l
l
l
s
j
a
a
a
a
a
O
"}
(46,1,1) = {"
l
v
v
v
l
s
l
e
k
l
s
l
e
k
l
s
v
l
l
s
l
j
l
l
a
a
a
a
a
O
"}
(47,1,1) = {"
l
l
l
l
l
l
s
k
l
l
s
s
l
k
l
l
v
l
l
l
l
l
e
k
a
a
a
a
a
O
"}
(48,1,1) = {"
l
s
l
l
l
l
l
l
l
l
l
l
l
s
l
j
v
l
s
l
l
s
l
a
a
a
a
a
a
O
"}
(49,1,1) = {"
s
l
e
k
s
l
l
s
l
s
l
l
l
l
s
l
v
l
l
l
l
l
a
a
a
a
a
a
a
O
"}
(50,1,1) = {"
l
v
v
v
l
l
j
l
u
l
l
s
l
l
l
l
v
l
l
s
l
l
a
a
a
a
a
a
a
O
"}
(51,1,1) = {"
k
q
l
l
l
s
l
e
k
l
s
l
e
k
l
s
v
l
l
l
s
l
a
a
a
a
a
a
a
O
"}
(52,1,1) = {"
k
k
l
l
l
l
l
l
s
l
l
v
v
v
v
v
v
l
j
l
s
l
a
a
a
a
a
a
a
O
"}
(53,1,1) = {"
l
l
s
l
s
l
l
s
l
s
l
l
l
l
s
l
v
s
l
l
l
l
l
q
a
a
a
a
a
O
"}
(54,1,1) = {"
l
l
l
l
l
l
j
l
u
l
l
s
l
l
l
l
v
l
l
s
l
s
j
k
a
a
a
a
a
O
"}
(55,1,1) = {"
e
k
l
s
v
v
v
v
s
l
l
l
l
s
l
l
v
v
v
v
v
v
l
j
a
a
a
a
a
O
"}
(56,1,1) = {"
l
s
l
l
v
v
v
v
l
s
l
l
s
l
s
l
l
l
l
s
l
v
s
l
a
a
a
a
a
O
"}
(57,1,1) = {"
s
l
e
k
v
v
v
v
l
l
l
j
l
u
l
l
s
l
l
l
l
v
l
l
a
a
a
a
a
O
"}
(58,1,1) = {"
s
s
l
k
v
v
l
l
l
j
l
u
l
l
s
l
l
l
l
v
l
l
l
l
j
a
a
a
a
O
"}
(59,1,1) = {"
l
l
l
s
v
v
l
l
s
l
e
k
l
s
l
e
k
l
s
v
l
l
l
s
l
e
a
a
a
O
"}
(60,1,1) = {"
l
l
l
l
v
v
s
l
l
l
l
s
l
l
v
v
v
v
v
v
l
s
l
l
l
l
a
a
a
O
"}
(61,1,1) = {"
l
s
l
l
v
v
v
v
v
v
v
v
v
v
v
v
v
v
v
v
l
k
k
k
s
l
a
a
a
O
"}
(62,1,1) = {"
s
l
e
k
v
v
l
l
l
s
k
l
l
s
s
l
k
l
l
v
l
k
q
k
l
l
l
V
a
O
"}
(63,1,1) = {"
l
v
v
v
v
v
s
l
l
l
l
l
l
l
l
l
l
s
l
j
v
l
k
k
l
s
l
l
v
O
"}
(64,1,1) = {"
l
l
l
l
v
v
l
s
l
l
s
l
l
s
l
l
l
l
s
l
v
l
k
q
l
l
k
s
v
O
"}
(65,1,1) = {"
l
s
l
l
v
v
l
l
l
j
l
u
u
l
l
s
l
l
l
l
v
l
k
k
l
l
l
k
v
O
"}
(66,1,1) = {"
s
l
e
k
v
v
l
l
s
l
e
k
k
l
s
l
e
k
l
s
v
l
k
q
l
l
q
u
v
O
"}
(67,1,1) = {"
l
v
v
v
v
v
s
l
l
l
l
s
s
l
l
v
v
v
v
v
v
l
l
l
j
l
k
s
v
O
"}
(68,1,1) = {"
k
q
l
l
v
v
l
s
l
l
s
l
l
s
l
l
l
l
s
l
v
s
l
s
l
l
l
l
v
O
"}
(69,1,1) = {"
k
k
l
l
v
v
l
l
l
j
l
u
u
l
l
s
l
l
l
l
v
l
l
l
l
s
j
l
v
O
"}
(70,1,1) = {"
l
l
s
l
v
v
l
l
s
l
e
k
k
l
s
l
e
k
l
s
v
l
s
l
j
l
l
l
v
O
"}
(71,1,1) = {"
l
l
l
l
v
v
l
l
l
s
k
l
s
l
l
v
v
v
v
v
k
l
l
l
l
e
k
s
v
O
"}
(72,1,1) = {"
e
k
l
s
v
v
s
l
l
l
l
l
l
k
k
q
l
l
k
s
l
l
l
l
s
l
l
l
v
O
"}
(73,1,1) = {"
v
v
v
v
v
v
l
s
l
l
s
l
l
q
k
k
l
l
l
k
s
l
l
l
l
l
k
s
v
O
"}
(74,1,1) = {"
v
v
v
v
v
v
l
l
l
j
l
u
l
l
l
l
s
l
v
l
k
k
s
l
l
s
l
l
v
O
"}
(75,1,1) = {"
v
v
v
v
v
v
l
l
s
l
e
k
l
s
l
l
l
l
v
l
l
l
l
s
l
l
k
l
v
O
"}
(76,1,1) = {"
v
v
v
v
v
v
s
l
l
l
l
s
s
l
e
k
l
s
v
l
l
l
l
s
l
l
l
s
v
O
"}
(77,1,1) = {"
v
v
v
v
v
v
l
s
l
l
s
l
s
l
l
l
l
s
l
l
l
l
l
s
l
j
v
l
v
O
"}
(78,1,1) = {"
v
v
v
v
v
v
l
l
l
j
l
u
l
l
s
l
l
l
l
s
l
l
l
l
s
l
v
l
v
O
"}
(79,1,1) = {"
c
H
H
H
H
H
M
v
v
v
v
v
v
v
v
v
v
v
u
l
l
s
l
l
l
l
v
l
v
O
"}
(80,1,1) = {"
c
H
H
H
H
H
M
v
v
v
v
v
v
v
v
v
v
v
k
l
s
l
e
k
l
s
v
l
v
O
"}
(81,1,1) = {"
c
H
H
H
H
H
M
v
v
B
B
B
B
B
B
B
v
v
s
l
l
v
v
v
v
v
v
l
v
O
"}
(82,1,1) = {"
c
H
H
F
i
H
M
v
v
B
v
v
v
v
v
B
v
v
l
s
l
l
l
l
s
l
v
s
v
O
"}
(83,1,1) = {"
c
H
H
N
A
H
M
v
v
B
v
v
v
v
v
B
v
v
u
l
l
s
l
l
l
l
v
l
v
O
"}
(84,1,1) = {"
c
H
H
H
J
H
M
v
v
B
v
v
v
v
v
B
v
v
k
l
s
l
e
k
l
s
v
l
v
O
"}
(85,1,1) = {"
c
H
H
F
i
H
M
v
v
B
v
v
v
v
v
B
v
v
s
l
l
v
v
v
v
v
k
l
v
O
"}
(86,1,1) = {"
c
H
H
N
A
H
M
v
v
B
v
v
v
v
v
B
v
v
l
k
k
q
l
l
k
s
l
l
v
O
"}
(87,1,1) = {"
c
H
H
H
H
H
M
v
v
B
v
v
v
v
v
B
v
v
l
q
k
k
l
l
l
k
s
l
v
O
"}
(88,1,1) = {"
c
H
H
H
H
H
M
v
v
B
v
v
v
v
v
B
v
v
l
l
l
l
s
l
v
l
k
k
v
O
"}
(89,1,1) = {"
c
H
H
H
H
H
M
v
v
B
v
v
v
v
v
B
v
v
l
s
l
l
l
l
v
l
l
l
v
O
"}
(90,1,1) = {"
c
H
H
H
H
H
M
v
v
B
v
v
v
v
v
B
v
v
s
l
e
k
l
s
v
l
l
l
v
O
"}
(91,1,1) = {"
c
H
H
F
i
H
M
v
v
B
v
v
v
v
v
B
v
v
v
v
v
v
v
v
v
v
v
v
v
O
"}
(92,1,1) = {"
c
H
H
N
A
H
M
v
v
B
v
v
v
v
v
B
B
B
B
B
B
v
v
v
v
v
v
v
v
O
"}
(93,1,1) = {"
c
H
H
H
J
H
M
v
v
B
v
v
v
v
v
v
v
v
v
v
B
v
v
v
v
v
v
v
v
O
"}
(94,1,1) = {"
c
H
H
F
i
H
M
v
v
B
v
v
v
v
v
v
v
v
v
v
B
v
v
v
v
v
v
v
v
O
"}
(95,1,1) = {"
c
H
H
N
A
H
M
v
v
B
v
v
v
v
v
v
v
v
v
v
B
v
v
v
v
v
v
v
v
O
"}
(96,1,1) = {"
c
H
H
H
H
H
M
v
v
B
v
v
v
v
v
v
v
v
v
v
B
v
v
v
v
v
v
v
v
O
"}
(97,1,1) = {"
c
H
H
H
H
H
M
v
v
B
v
v
v
v
v
v
v
v
v
v
B
v
v
v
v
v
v
v
v
O
"}
(98,1,1) = {"
c
H
H
H
H
H
M
v
v
B
v
v
v
v
v
v
v
v
v
v
B
v
v
v
v
v
v
v
v
O
"}
(99,1,1) = {"
c
H
H
H
H
H
M
v
v
B
B
B
B
B
B
B
B
B
B
B
B
v
v
v
v
v
v
v
v
O
"}
(100,1,1) = {"
c
H
H
F
i
H
M
v
v
v
v
v
v
v
v
v
v
v
v
v
v
v
v
v
v
v
v
v
v
O
"}
(101,1,1) = {"
c
H
H
N
A
H
M
v
v
v
v
v
v
v
v
v
v
v
v
v
v
v
v
v
v
v
v
v
v
O
"}
(102,1,1) = {"
c
H
H
H
J
H
M
v
l
l
v
v
v
v
v
v
k
l
v
v
v
a
a
a
a
v
v
v
v
O
"}
(103,1,1) = {"
c
H
H
F
i
H
M
v
s
l
l
l
l
s
l
v
l
s
v
v
v
a
a
a
a
v
v
v
v
O
"}
(104,1,1) = {"
c
H
H
N
A
H
M
v
l
l
s
l
l
l
l
v
l
l
v
v
a
a
a
a
a
a
v
v
v
O
"}
(105,1,1) = {"
c
H
H
H
H
H
M
v
l
s
l
e
k
l
s
v
l
l
v
v
a
a
a
a
a
a
a
v
v
O
"}
(106,1,1) = {"
c
H
H
H
H
H
M
v
l
s
s
l
k
l
l
v
l
l
v
v
a
a
a
a
a
a
a
v
v
O
"}
(107,1,1) = {"
c
H
H
H
H
H
M
v
l
l
l
l
s
l
j
v
l
s
v
v
a
a
a
a
a
a
a
v
v
O
"}
(108,1,1) = {"
c
H
H
H
H
H
M
v
s
l
l
l
l
s
l
v
l
l
v
v
a
a
a
a
a
a
a
v
v
O
"}
(109,1,1) = {"
c
H
H
F
i
H
M
v
l
l
s
l
l
l
l
v
l
l
v
v
v
a
a
a
a
a
a
v
v
O
"}
(110,1,1) = {"
c
H
H
N
A
H
M
v
l
s
l
e
k
l
s
v
l
l
v
v
v
a
a
a
a
a
a
v
v
O
"}
(111,1,1) = {"
c
H
H
H
J
H
M
v
l
l
v
v
v
v
v
v
l
j
v
v
v
v
a
a
a
a
a
v
v
O
"}
(112,1,1) = {"
c
H
H
F
i
H
M
v
s
l
l
l
l
s
l
v
s
l
v
v
v
v
a
a
a
a
v
v
v
O
"}
(113,1,1) = {"
c
H
H
N
A
H
M
v
l
l
s
l
l
l
l
v
l
l
v
v
v
v
v
v
v
v
v
v
v
O
"}
(114,1,1) = {"
c
H
H
H
H
H
M
v
l
l
v
v
v
v
v
v
k
l
v
v
v
v
v
v
v
v
v
v
v
O
"}
(115,1,1) = {"
c
H
H
H
H
H
M
v
s
l
l
l
l
s
l
v
l
l
l
v
v
v
v
v
v
k
l
v
v
O
"}
(116,1,1) = {"
c
H
H
H
H
H
M
v
l
l
s
l
l
l
l
v
l
s
l
l
l
l
s
l
v
l
s
v
v
O
"}
(117,1,1) = {"
c
H
H
H
H
H
M
v
l
s
l
e
k
l
s
v
l
l
l
s
l
l
l
l
v
l
l
v
v
O
"}
(118,1,1) = {"
c
H
H
H
H
H
M
v
l
s
s
l
k
l
l
v
l
l
s
l
e
k
l
s
v
l
l
v
v
O
"}
(119,1,1) = {"
c
H
z
H
H
H
M
v
l
l
l
l
s
l
j
v
l
l
s
s
l
k
l
l
v
l
l
v
v
O
"}
(120,1,1) = {"
c
H
H
H
H
z
M
v
s
l
l
l
l
l
v
v
v
l
l
l
l
s
l
j
v
l
s
v
v
O
"}
(121,1,1) = {"
c
H
H
H
H
H
M
v
l
l
s
l
s
l
l
l
l
s
l
l
l
l
s
l
v
l
l
v
v
O
"}
(122,1,1) = {"
c
H
H
C
H
H
M
v
l
s
l
e
l
l
s
l
l
l
l
s
l
l
l
l
v
l
l
v
v
O
"}
(123,1,1) = {"
c
H
H
z
H
H
M
v
l
l
v
v
l
s
l
e
k
l
s
l
e
k
l
s
v
l
l
v
v
O
"}
(124,1,1) = {"
c
H
H
H
H
H
M
v
s
l
l
l
l
s
s
l
k
l
l
v
v
v
v
v
v
l
j
v
v
O
"}
(125,1,1) = {"
c
H
H
H
C
H
M
v
l
l
s
l
l
l
l
l
s
s
l
l
l
l
s
l
v
s
l
v
v
O
"}
(126,1,1) = {"
c
t
H
H
H
H
M
v
l
l
l
l
s
l
l
l
l
l
l
s
l
l
l
l
v
l
l
v
v
O
"}
(127,1,1) = {"
c
H
H
H
H
H
M
v
v
v
v
l
l
l
s
l
l
l
l
l
l
s
l
l
v
v
v
v
v
O
"}
(128,1,1) = {"
c
H
H
H
H
H
M
v
v
v
v
v
l
s
l
e
k
l
s
l
e
k
l
s
v
l
l
v
v
O
"}
(129,1,1) = {"
c
p
H
H
H
H
M
v
v
v
v
v
l
l
v
v
v
l
l
v
v
v
v
v
v
l
j
v
v
O
"}
(130,1,1) = {"
c
H
H
H
H
H
M
v
v
v
v
v
s
l
l
l
l
s
l
l
l
l
s
l
v
s
l
v
v
O
"}
(131,1,1) = {"
c
H
H
H
H
H
M
v
v
v
v
v
l
l
s
l
l
l
l
v
v
v
v
v
v
k
l
v
v
O
"}
(132,1,1) = {"
c
H
H
H
H
H
M
v
v
v
v
v
l
l
l
l
s
s
l
l
l
l
s
l
v
l
s
v
v
O
"}
(133,1,1) = {"
v
v
v
v
v
v
v
v
v
v
v
v
v
v
v
v
v
l
l
s
l
l
l
l
v
l
l
v
v
O
"}
(134,1,1) = {"
v
v
v
v
v
v
v
v
v
v
v
v
v
v
v
v
v
l
s
l
e
k
l
s
v
l
l
v
v
O
"}
(135,1,1) = {"
v
v
v
v
v
v
v
v
v
v
v
v
v
v
v
v
v
l
s
s
l
k
l
l
v
l
l
v
v
O
"}
(136,1,1) = {"
v
v
v
v
v
v
v
v
v
v
v
v
v
v
v
v
v
l
l
l
l
s
l
j
v
l
s
v
v
O
"}
(137,1,1) = {"
v
B
B
B
B
B
B
B
B
B
B
B
B
B
B
v
v
s
l
l
l
l
s
l
v
l
l
v
v
O
"}
(138,1,1) = {"
v
B
v
v
v
v
v
v
v
v
v
v
v
v
B
v
v
l
l
s
l
l
l
l
v
l
l
v
v
O
"}
(139,1,1) = {"
v
B
v
v
v
v
v
v
v
v
v
v
v
v
B
v
v
l
s
l
e
k
l
s
v
l
l
v
v
O
"}
(140,1,1) = {"
v
B
v
v
v
v
v
v
v
v
v
v
v
v
B
v
v
l
l
v
v
v
v
v
v
l
j
v
v
O
"}
(141,1,1) = {"
v
B
v
v
v
v
v
v
v
v
v
v
v
v
B
v
v
s
l
l
l
l
s
l
v
s
l
v
v
O
"}
(142,1,1) = {"
v
B
v
v
v
v
v
v
v
v
v
v
v
v
B
v
v
l
l
s
l
l
l
l
v
l
l
v
v
O
"}
(143,1,1) = {"
v
B
v
v
v
v
v
v
v
v
v
v
v
v
B
v
v
l
l
l
l
s
l
l
v
v
v
v
v
O
"}
(144,1,1) = {"
v
B
v
v
v
v
v
v
v
v
v
v
v
v
B
v
v
l
s
l
e
k
l
s
v
l
l
v
v
O
"}
(145,1,1) = {"
v
B
v
v
v
v
v
v
v
v
v
v
v
v
B
v
v
l
l
v
v
v
v
v
v
l
j
v
v
O
"}
(146,1,1) = {"
v
B
v
v
v
v
v
v
v
v
v
v
v
v
B
v
v
s
l
l
l
l
s
l
v
s
l
v
v
O
"}
(147,1,1) = {"
v
B
v
v
v
v
v
v
v
v
v
v
v
v
B
v
v
l
l
s
l
l
l
l
v
l
l
v
v
O
"}
(148,1,1) = {"
v
B
B
B
B
B
B
B
B
B
B
B
B
B
B
v
v
l
l
l
l
s
l
l
v
v
v
v
v
O
"}
(149,1,1) = {"
v
v
v
v
v
v
v
v
v
v
v
v
v
v
v
v
v
v
l
l
v
v
v
v
v
v
k
l
v
O
"}
(150,1,1) = {"
v
v
v
v
v
v
v
v
v
v
v
v
v
v
v
v
v
v
s
l
l
l
l
s
l
v
l
s
v
O
"}
(151,1,1) = {"
v
v
v
v
v
v
v
v
v
v
v
v
v
v
v
v
v
v
l
l
s
l
l
l
l
v
l
l
v
O
"}
(152,1,1) = {"
v
v
v
v
v
v
v
v
v
v
l
l
v
v
v
v
v
v
k
l
l
e
k
l
s
v
l
l
v
O
"}
(153,1,1) = {"
v
l
l
v
v
v
v
v
v
k
l
l
l
l
l
s
l
v
l
s
s
l
k
l
l
v
l
l
v
O
"}
(154,1,1) = {"
v
s
l
l
l
l
s
l
v
l
s
l
s
l
l
l
l
v
l
l
l
l
s
l
j
v
l
s
v
O
"}
(155,1,1) = {"
v
l
l
s
l
l
l
l
v
l
l
s
l
e
k
l
s
v
l
l
l
l
l
s
l
v
l
l
v
O
"}
(156,1,1) = {"
v
l
s
l
e
k
l
s
v
l
l
s
s
l
k
l
l
v
l
l
s
l
l
l
l
v
l
l
v
O
"}
(157,1,1) = {"
v
l
s
s
l
k
l
l
v
l
l
l
l
l
s
l
j
v
l
s
l
e
k
l
s
v
l
l
v
O
"}
(158,1,1) = {"
v
l
l
l
l
s
l
j
v
l
s
l
l
l
l
s
l
v
l
l
v
v
v
v
v
v
l
j
v
O
"}
(159,1,1) = {"
s
s
l
l
l
l
s
l
v
l
l
l
s
l
l
l
l
v
l
l
l
l
l
s
l
v
s
l
v
O
"}
(160,1,1) = {"
l
l
l
s
l
l
l
l
v
l
l
s
l
e
k
l
s
v
l
l
s
l
l
l
l
v
l
l
v
O
"}
(161,1,1) = {"
u
l
s
l
e
k
l
s
v
l
l
l
v
v
v
v
v
v
l
j
l
l
s
l
l
v
v
v
v
O
"}
(162,1,1) = {"
k
l
l
v
v
v
v
v
v
l
j
l
l
l
l
s
l
v
s
l
l
v
l
l
l
v
v
v
v
O
"}
(163,1,1) = {"
l
s
l
l
l
l
s
l
v
s
l
l
s
l
l
l
l
v
l
l
j
v
l
s
l
v
v
v
v
O
"}
(164,1,1) = {"
l
l
l
s
l
l
l
l
v
l
l
l
l
l
s
l
l
v
v
v
l
v
l
l
l
v
v
v
v
O
"}
(165,1,1) = {"
l
l
l
l
l
s
l
l
v
v
v
v
v
u
l
l
s
l
l
l
l
v
l
l
s
v
v
v
v
O
"}
(166,1,1) = {"
u
l
l
s
u
l
l
s
l
s
l
l
l
k
l
s
l
e
k
l
s
v
l
l
l
v
v
v
v
O
"}
(167,1,1) = {"
k
l
s
l
k
l
s
l
u
l
l
s
l
s
l
l
v
v
v
v
v
v
l
j
l
v
v
v
v
O
"}
(168,1,1) = {"
s
l
l
v
l
l
s
s
k
l
s
l
e
l
s
l
l
l
l
s
l
v
s
l
l
v
v
v
v
O
"}
(169,1,1) = {"
l
s
l
l
l
l
l
l
s
l
l
v
v
u
l
l
s
l
l
l
l
v
l
l
s
v
v
v
v
O
"}
(170,1,1) = {"
u
l
l
s
l
s
l
l
l
k
k
q
l
k
l
s
l
l
l
k
l
s
l
e
k
l
s
v
v
O
"}
(171,1,1) = {"
k
l
s
l
u
l
l
s
l
q
k
k
l
s
l
l
v
s
l
s
l
l
v
v
v
v
v
v
v
O
"}
(172,1,1) = {"
s
l
l
v
k
l
s
l
l
l
l
l
s
l
k
k
q
l
e
l
s
l
l
l
l
s
l
v
v
O
"}
(173,1,1) = {"
l
k
k
q
s
l
l
v
l
s
l
l
l
l
q
k
k
v
v
u
l
l
s
l
l
l
l
v
v
O
"}
(174,1,1) = {"
l
q
k
k
l
s
l
l
s
l
e
k
l
l
l
l
l
q
l
k
l
s
l
e
k
l
s
v
v
O
"}
(175,1,1) = {"
l
l
l
l
u
l
l
s
l
l
s
l
l
l
s
l
l
k
l
s
l
l
v
v
v
v
v
v
v
O
"}
(176,1,1) = {"
l
s
l
l
k
l
s
l
e
k
l
s
l
s
l
e
k
l
s
l
k
k
q
l
l
k
s
v
v
O
"}
(177,1,1) = {"
s
l
e
k
s
l
l
v
v
v
u
l
l
s
l
l
l
l
l
l
q
k
k
l
l
l
k
v
v
O
"}
(178,1,1) = {"
l
l
l
s
l
k
k
q
l
l
k
l
s
l
e
k
l
k
l
l
l
l
l
s
l
v
l
v
v
O
"}
(179,1,1) = {"
s
l
l
l
l
q
k
k
l
l
s
l
s
l
l
v
v
l
l
l
s
l
l
l
l
v
l
v
v
O
"}
(180,1,1) = {"
l
e
k
l
l
l
l
l
s
l
l
k
l
s
l
l
l
s
l
s
l
e
k
l
s
v
l
v
v
O
"}
(181,1,1) = {"
v
v
v
v
l
s
l
l
l
l
l
q
u
l
l
s
l
l
l
s
l
l
l
l
v
l
l
v
v
O
"}
(182,1,1) = {"
q
l
l
k
s
l
e
k
s
l
l
l
k
l
s
l
e
l
s
l
e
k
l
s
v
l
l
v
v
O
"}
(183,1,1) = {"
k
l
l
l
k
s
l
s
l
s
l
s
l
l
s
s
l
l
s
l
l
v
v
v
v
v
v
v
v
O
"}
(184,1,1) = {"
l
s
l
v
l
k
k
q
u
l
s
l
l
l
l
l
l
k
l
s
l
l
l
l
s
l
v
v
v
O
"}
(185,1,1) = {"
l
l
l
v
l
l
l
l
k
l
s
l
l
s
l
l
l
q
u
l
l
s
l
l
l
l
v
v
v
O
"}
(186,1,1) = {"
k
l
s
v
l
l
l
s
l
l
s
u
u
l
l
s
l
l
k
l
s
l
e
k
l
s
v
v
v
O
"}
(187,1,1) = {"
q
k
k
l
l
k
l
s
l
l
l
k
k
l
s
l
e
q
l
k
l
s
l
e
k
l
s
v
v
O
"}
(188,1,1) = {"
l
l
l
s
l
s
l
l
l
s
l
s
s
l
l
v
v
k
l
s
l
l
v
v
v
v
v
v
v
O
"}
(189,1,1) = {"
s
l
l
l
l
l
s
l
u
l
l
l
l
s
l
l
l
l
s
l
k
k
q
l
l
k
s
v
v
O
"}
(190,1,1) = {"
l
e
k
l
s
u
l
l
k
l
s
l
u
l
l
s
l
l
l
l
q
k
k
l
l
l
k
v
v
O
"}
(191,1,1) = {"
k
l
s
l
e
k
l
s
s
l
l
l
k
l
s
l
e
k
l
l
l
l
l
s
l
v
l
v
v
O
"}
(192,1,1) = {"
s
l
l
v
v
s
l
l
l
s
l
l
s
l
l
v
v
l
l
l
s
l
l
l
l
v
l
v
v
O
"}
(193,1,1) = {"
l
k
k
q
l
l
k
k
u
l
l
s
l
k
k
q
l
s
l
s
l
e
k
l
s
v
l
v
v
O
"}
(194,1,1) = {"
l
q
k
k
l
l
q
k
k
l
s
l
l
q
k
k
l
l
l
s
l
l
l
l
v
l
l
v
v
O
"}
(195,1,1) = {"
l
l
l
l
s
l
l
l
s
l
l
v
l
l
l
l
s
l
s
l
e
k
l
s
v
l
l
v
v
O
"}
(196,1,1) = {"
l
s
l
l
l
l
s
l
l
k
k
q
l
s
l
l
l
l
s
l
l
v
v
v
v
v
v
v
v
O
"}
(197,1,1) = {"
s
l
e
k
l
s
l
e
l
q
k
k
s
l
e
k
l
k
l
s
l
l
l
l
s
l
v
v
v
O
"}
(198,1,1) = {"
l
l
l
s
l
v
s
l
l
l
l
l
s
l
v
l
k
q
u
l
l
s
l
l
l
l
v
v
v
O
"}
(199,1,1) = {"
s
l
l
l
l
v
l
l
l
s
l
l
l
l
v
l
l
l
k
l
s
l
e
k
l
s
v
v
v
O
"}
(200,1,1) = {"
O
O
O
O
O
O
O
O
O
O
O
O
O
O
O
O
O
O
O
O
O
O
O
O
O
O
O
O
O
O
"}
