//MAP CONVERTED BY dmm2tgm.py THIS HEADER COMMENT PREVENTS RECONVERSION, DO NOT REMOVE
"a" = (
/obj/machinery/atmospherics/pipe/smart/simple/scrubbers/visible{
	dir = 4
	},
/turf/closed/wall,
/area/space)
"e" = (
/turf/closed/wall,
/area/space)
"h" = (
/obj/structure/closet/secure_closet/security/engine,
/obj/machinery/airalarm/directional/east,
/obj/machinery/requests_console/directional/south{
	department = "Security";
	name = "Security Requests Console"
	},
/obj/effect/mapping_helpers/requests_console/information,
/obj/effect/mapping_helpers/requests_console/assistance,
/obj/machinery/firealarm/directional/south{
	pixel_x = 26
	},
/obj/effect/turf_decal/tile/red/anticorner/contrasted,
/turf/open/floor/iron,
/area/space)
"j" = (
/obj/structure/cable,
/obj/machinery/atmospherics/pipe/smart/manifold4w/scrubbers/hidden/layer2,
/turf/open/floor/iron,
/area/space)
"k" = (
/obj/machinery/camera/autoname{
	dir = 5
	},
/obj/structure/cable,
/obj/machinery/atmospherics/components/unary/vent_scrubber/on/layer2{
	dir = 1
	},
/obj/machinery/power/apc/auto_name/directional/south,
/obj/effect/turf_decal/tile/red/half/contrasted,
/obj/machinery/light/small/directional/south,
/turf/open/floor/iron,
/area/space)
"s" = (
/obj/structure/chair{
	dir = 4
	},
/obj/machinery/newscaster/directional/south,
/obj/item/radio/intercom/directional/west,
/obj/effect/turf_decal/tile/red/anticorner/contrasted{
	dir = 8
	},
/obj/effect/landmark/start/engineering_guard,
/turf/open/floor/iron,
/area/space)
"u" = (
/obj/structure/table,
/obj/item/paper_bin{
	pixel_x = -1;
	pixel_y = 5
	},
/obj/item/pen,
/obj/machinery/button/door/directional/east{
	id = "Engineering";
	name = "Engineering Lockdown";
	pixel_y = 16;
	req_access = list("engineering")
	},
/obj/machinery/button/door/directional/east{
	id = "atmos";
	name = "Atmospherics Lockdown";
	pixel_y = 24;
	req_access = list("atmospherics")
	},
/obj/effect/turf_decal/tile/red/half/contrasted{
	dir = 4
	},
/obj/machinery/light/small/directional/east,
/obj/machinery/computer/security/telescreen/engine/directional/east,
/turf/open/floor/iron,
/area/space)
"x" = (
/obj/structure/filingcabinet,
/obj/machinery/computer/security/telescreen/minisat/directional/east,
/obj/effect/turf_decal/tile/red/half/contrasted{
	dir = 4
	},
/turf/open/floor/iron,
/area/space)
"y" = (
/obj/structure/table,
/obj/machinery/recharger{
	pixel_y = 4
	},
/obj/structure/reagent_dispensers/wall/peppertank/directional/east,
/obj/effect/turf_decal/tile/red/anticorner/contrasted{
	dir = 4
	},
/turf/open/floor/iron,
/area/space)
"z" = (
/turf/closed/wall/r_wall,
/area/space)
"A" = (
/obj/structure/chair/office{
	dir = 1
	},
/obj/structure/cable,
/obj/machinery/atmospherics/components/unary/vent_pump/on/layer4{
	dir = 8
	},
/obj/machinery/atmospherics/pipe/smart/manifold4w/scrubbers/hidden/layer2,
/obj/effect/landmark/start/engineering_guard,
/turf/open/floor/iron,
/area/space)
"L" = (
/obj/machinery/computer/records/security,
/obj/effect/turf_decal/tile/red/half/contrasted{
	dir = 1
	},
/turf/open/floor/iron,
/area/space)
"N" = (
/obj/machinery/atmospherics/pipe/smart/simple/scrubbers/visible{
	dir = 10
	},
/turf/closed/wall/r_wall,
/area/space)
"O" = (
/obj/structure/table,
/obj/item/screwdriver{
	pixel_y = 10
	},
/obj/item/geiger_counter{
	pixel_x = 7;
	pixel_y = 3
	},
/obj/item/radio/off{
	pixel_x = -5;
	pixel_y = 2
	},
/obj/effect/turf_decal/tile/red/anticorner/contrasted{
	dir = 1
	},
/turf/open/floor/iron,
/area/space)
"Q" = (
/obj/machinery/atmospherics/pipe/smart/simple/scrubbers/visible{
	dir = 4
	},
/turf/closed/wall/r_wall,
/area/space)
"R" = (
/obj/machinery/door/airlock/security/glass{
	name = "Engineering Security Post"
	},
/obj/machinery/door/firedoor,
/obj/structure/cable,
/obj/machinery/atmospherics/pipe/smart/manifold4w/supply/hidden/layer4,
/obj/machinery/atmospherics/pipe/smart/manifold4w/scrubbers/hidden/layer2,
/obj/effect/turf_decal/tile/red/fourcorners,
/obj/effect/mapping_helpers/airlock/access/any/engineering/engie_guard,
/turf/open/floor/iron,
/area/space)
"S" = (
/obj/structure/cable,
/obj/machinery/atmospherics/pipe/smart/manifold4w/supply/hidden/layer4,
/obj/machinery/atmospherics/pipe/smart/manifold4w/scrubbers/hidden/layer2,
/obj/effect/turf_decal/tile/red/half/contrasted{
	dir = 8
	},
/turf/open/floor/iron,
/area/space)
"V" = (
/obj/effect/spawner/structure/window/reinforced,
/obj/structure/cable,
/turf/open/floor/plating,
/area/space)
"Z" = (
/obj/structure/chair{
	dir = 4
	},
/obj/effect/turf_decal/tile/red/half/contrasted{
	dir = 8
	},
/turf/open/floor/iron,
/area/space)

(1,1,1) = {"
V
V
R
V
e
a
"}
(2,1,1) = {"
V
O
S
Z
s
a
"}
(3,1,1) = {"
V
L
A
j
k
Q
"}
(4,1,1) = {"
V
y
u
x
h
N
"}
(5,1,1) = {"
z
z
z
z
z
z
"}
