//MAP CONVERTED BY dmm2tgm.py THIS HEADER COMMENT PREVENTS RECONVERSION, DO NOT REMOVE
"a" = (
/obj/structure/rack,
/obj/effect/turf_decal/tile/blue/half/contrasted{
	dir = 4
	},
/obj/effect/spawner/random/armory/barrier_grenades,
/turf/open/floor/iron/dark,
/area/station/security/armory)
"b" = (
/obj/structure/rack,
/obj/effect/turf_decal/tile/red/half/contrasted{
	dir = 8
	},
/obj/effect/spawner/random/armory/e_gun,
/turf/open/floor/iron/dark,
/area/station/security/armory)
"e" = (
/obj/effect/turf_decal/bot,
/mob/living/simple_animal/bot/secbot/beepsky/armsky,
/turf/open/floor/iron/dark,
/area/station/security/armory)
"f" = (
/obj/effect/turf_decal/trimline/red/filled/corner{
	dir = 1
	},
/obj/machinery/atmospherics/pipe/smart/manifold4w/scrubbers/hidden/layer2,
/obj/machinery/atmospherics/pipe/smart/manifold4w/supply/hidden/layer4,
/obj/structure/cable,
/turf/open/floor/iron/dark,
/area/station/security/armory)
"g" = (
/obj/effect/turf_decal/trimline/neutral/filled/corner{
	dir = 8
	},
/obj/item/radio/intercom/directional/north,
/obj/machinery/atmospherics/components/unary/vent_scrubber/on/layer2,
/turf/open/floor/iron/dark,
/area/station/security/armory)
"h" = (
/obj/structure/rack,
/obj/item/gun/energy/ionrifle,
/obj/item/gun/energy/temperature/security,
/obj/item/clothing/suit/hooded/ablative,
/obj/effect/turf_decal/tile/red/half/contrasted{
	dir = 8
	},
/turf/open/floor/iron/dark,
/area/station/security/armory)
"k" = (
/turf/open/floor/iron/dark,
/area/station/security/armory)
"o" = (
/obj/structure/cable,
/obj/machinery/power/apc/auto_name/directional/south,
/turf/open/floor/iron/dark,
/area/station/security/armory)
"r" = (
/obj/structure/rack,
/obj/machinery/firealarm/directional/east,
/obj/effect/turf_decal/tile/red/half/contrasted{
	dir = 8
	},
/obj/effect/spawner/armory_spawn/smg,
/turf/open/floor/iron/dark,
/area/station/security/armory)
"s" = (
/obj/effect/turf_decal/trimline/red/filled/corner,
/turf/open/floor/iron/dark,
/area/station/security/armory)
"u" = (
/obj/structure/rack,
/obj/item/clothing/glasses/hud/security/sunglasses/gars{
	pixel_x = 3;
	pixel_y = -2
	},
/obj/item/clothing/glasses/hud/security/sunglasses/gars{
	pixel_x = 3;
	pixel_y = 2
	},
/obj/item/clothing/glasses/hud/security/sunglasses{
	pixel_x = -3;
	pixel_y = -2
	},
/obj/item/clothing/glasses/hud/security/sunglasses{
	pixel_x = -3;
	pixel_y = 2
	},
/obj/machinery/airalarm/directional/west,
/obj/machinery/camera/motion/directional/west{
	c_tag = "Armory - Internal"
	},
/obj/effect/turf_decal/tile/blue/anticorner/contrasted,
/turf/open/floor/iron/dark,
/area/station/security/armory)
"x" = (
/obj/effect/turf_decal/trimline/neutral/filled/corner{
	dir = 4
	},
/obj/structure/cable,
/obj/machinery/atmospherics/components/unary/vent_pump/on/layer4{
	dir = 4
	},
/turf/open/floor/iron/dark,
/area/station/security/armory)
"y" = (
/obj/structure/closet/secure_closet{
	name = "contraband locker";
	req_access = list("armory")
	},
/obj/effect/spawner/random/maintenance/three,
/obj/effect/spawner/random/contraband/armory,
/obj/effect/turf_decal/tile/red/half/contrasted{
	dir = 8
	},
/turf/open/floor/iron/dark,
/area/station/security/armory)
"A" = (
/obj/effect/turf_decal/tile/blue/half/contrasted{
	dir = 4
	},
/obj/structure/closet/secure_closet/armory_kiboko,
/obj/item/ammo_box/c980grenade/riot,
/obj/item/ammo_box/c980grenade/smoke,
/turf/open/floor/iron/dark,
/area/station/security/armory)
"B" = (
/obj/structure/rack,
/obj/effect/turf_decal/tile/blue/half/contrasted{
	dir = 4
	},
/obj/effect/spawner/random/armory/disablers,
/obj/effect/mapping_helpers/requests_console/supplies,
/obj/effect/mapping_helpers/requests_console/assistance,
/obj/machinery/requests_console/directional/west{
	department = "Security";
	name = "Security Requests Console"
	},
/turf/open/floor/iron/dark,
/area/station/security/armory)
"D" = (
/obj/effect/turf_decal/trimline/red/filled/corner{
	dir = 1
	},
/obj/machinery/atmospherics/pipe/smart/manifold4w/scrubbers/hidden/layer2,
/turf/open/floor/iron/dark,
/area/station/security/armory)
"E" = (
/obj/effect/turf_decal/tile/red/half/contrasted{
	dir = 8
	},
/obj/structure/rack,
/obj/item/storage/box/rubbershot{
	pixel_x = -3;
	pixel_y = 3
	},
/obj/item/storage/box/rubbershot,
/obj/item/storage/box/rubbershot{
	pixel_x = 3;
	pixel_y = -3
	},
/turf/open/floor/iron/dark,
/area/station/security/armory)
"K" = (
/obj/effect/turf_decal/trimline/neutral/filled/corner{
	dir = 8
	},
/obj/machinery/atmospherics/pipe/smart/manifold4w/scrubbers/hidden/layer2,
/turf/open/floor/iron/dark,
/area/station/security/armory)
"L" = (
/obj/structure/rack,
/obj/effect/turf_decal/tile/red/half/contrasted{
	dir = 8
	},
/obj/machinery/light/directional/east,
/obj/effect/spawner/armory_spawn/shotguns,
/obj/machinery/light_switch/directional/east,
/turf/open/floor/iron/dark,
/area/station/security/armory)
"M" = (
/turf/closed/wall/r_wall,
/area/station/security/armory)
"V" = (
/obj/effect/turf_decal/trimline/neutral/filled/corner{
	dir = 4
	},
/turf/open/floor/iron/dark,
/area/station/security/armory)
"X" = (
/obj/structure/rack,
/obj/item/gun/energy/e_gun/dragnet,
/obj/item/gun/energy/e_gun/dragnet,
/obj/effect/turf_decal/tile/blue/half/contrasted{
	dir = 4
	},
/obj/machinery/light/small/directional/west,
/turf/open/floor/iron/dark,
/area/station/security/armory)

(1,1,1) = {"
A
X
a
B
u
e
o
"}
(2,1,1) = {"
k
s
V
s
V
s
x
"}
(3,1,1) = {"
M
g
D
K
D
K
f
"}
(4,1,1) = {"
M
y
b
h
r
L
E
"}
