//MAP CONVERTED BY dmm2tgm.py THIS HEADER COMMENT PREVENTS RECONVERSION, DO NOT REMOVE
"a" = (
/obj/structure/window/reinforced/spawner/directional/north,
/obj/structure/rack/wooden,
/obj/item/dyespray{
	pixel_x = -6
	},
/obj/item/dyespray,
/obj/item/dyespray{
	pixel_x = 6
	},
/obj/structure/curtain/cloth/fancy/mechanical{
	id = "barbershopcurtains";
	name = "Barber Shop Drapes"
	},
/turf/open/floor/iron/dark,
/area/station/service/barber)
"b" = (
/obj/effect/turf_decal/siding/dark{
	dir = 1
	},
/obj/machinery/atmospherics/pipe/smart/manifold4w/scrubbers/hidden/layer2,
/obj/structure/cable,
/obj/machinery/atmospherics/pipe/smart/manifold4w/supply/hidden/layer4,
/turf/open/floor/wood/tile,
/area/station/service/barber)
"e" = (
/obj/structure/chair/comfy/barber_chair,
/obj/effect/turf_decal/siding/dark{
	dir = 4
	},
/obj/structure/cable,
/obj/effect/landmark/start/assistant,
/turf/open/floor/wood/tile,
/area/station/service/barber)
"f" = (
/obj/effect/turf_decal/siding/dark{
	dir = 1
	},
/obj/machinery/newscaster/directional/west,
/obj/item/kirbyplants/random,
/turf/open/floor/iron/vaporwave,
/area/station/service/barber)
"g" = (
/obj/effect/turf_decal/siding/dark{
	dir = 1
	},
/turf/open/floor/iron/vaporwave,
/area/station/service/barber)
"h" = (
/obj/structure/closet/secure_closet/barber,
/obj/effect/turf_decal/siding/dark{
	dir = 4
	},
/obj/effect/turf_decal/bot,
/obj/item/mop,
/obj/item/reagent_containers/cup/bucket,
/obj/effect/spawner/random/trash/soap,
/obj/structure/extinguisher_cabinet/directional/east,
/obj/machinery/light/directional/south{
	dir = 4
	},
/turf/open/floor/wood/tile,
/area/station/service/barber)
"i" = (
/obj/structure/table/rolling,
/obj/item/hhmirror{
	pixel_x = 5;
	pixel_y = 9
	},
/obj/item/hairbrush/comb,
/obj/item/razor{
	pixel_x = -7;
	pixel_y = 3
	},
/obj/item/scissors{
	pixel_x = 2;
	pixel_y = 3
	},
/obj/item/straight_razor{
	pixel_x = 9;
	pixel_y = 2
	},
/obj/effect/turf_decal/siding/dark{
	dir = 6
	},
/obj/machinery/airalarm/directional/south,
/obj/machinery/power/apc/auto_name/directional/east,
/obj/structure/cable,
/turf/open/floor/wood/tile,
/area/station/service/barber)
"j" = (
/obj/structure/rack/wooden,
/obj/item/dyespray{
	pixel_x = -6;
	pixel_y = 11
	},
/obj/item/dyespray{
	pixel_x = 5;
	pixel_y = 11
	},
/obj/item/reagent_containers/spray/quantum_hair_dye{
	pixel_x = 11
	},
/obj/item/reagent_containers/spray/barbers_aid{
	pixel_x = -3;
	pixel_y = -2
	},
/obj/item/reagent_containers/spray/baldium{
	pixel_x = -10;
	pixel_y = -2
	},
/obj/item/reagent_containers/spray/super_barbers_aid{
	pixel_x = 4;
	pixel_y = -2
	},
/obj/effect/turf_decal/siding/dark,
/obj/machinery/computer/security/telescreen/entertainment/directional/south,
/obj/machinery/light/directional/south,
/turf/open/floor/wood/tile,
/area/station/service/barber)
"k" = (
/obj/machinery/atmospherics/pipe/smart/manifold4w/scrubbers/hidden/layer2,
/obj/machinery/navbeacon{
	codes_txt = "patrol;next_patrol=8.1-Aft-to-Escape";
	location = "Barber's Salon"
	},
/obj/structure/cable,
/turf/open/floor/iron/vaporwave,
/area/station/service/barber)
"l" = (
/obj/machinery/atmospherics/pipe/smart/manifold4w/scrubbers/hidden/layer2,
/obj/structure/cable,
/obj/machinery/atmospherics/components/unary/vent_pump/on/layer4,
/turf/open/floor/iron/vaporwave,
/area/station/service/barber)
"m" = (
/obj/machinery/atmospherics/pipe/smart/manifold4w/scrubbers/hidden/layer2,
/obj/structure/cable,
/turf/open/floor/iron/vaporwave,
/area/station/service/barber)
"n" = (
/obj/effect/turf_decal/siding/dark{
	dir = 9
	},
/obj/structure/window/spawner/directional/north,
/obj/structure/sink/directional/north{
	dir = 4;
	pixel_y = -7;
	pixel_x = -14
	},
/obj/structure/mirror/directional/west,
/turf/open/floor/wood/tile,
/area/station/service/barber)
"p" = (
/obj/effect/turf_decal/tile/neutral{
	dir = 8
	},
/turf/open/floor/iron,
/area/station/hallway/primary/port)
"q" = (
/obj/effect/turf_decal/tile/purple/opposingcorners{
	dir = 4
	},
/obj/effect/turf_decal/siding/dark{
	dir = 8
	},
/obj/item/kirbyplants/random,
/obj/structure/window/spawner/directional/west,
/turf/open/floor/iron/white,
/area/station/service/barber)
"s" = (
/obj/structure/sign/barber/directional/west,
/obj/structure/chair/sofa/corp/left{
	desc = "Looks like someone threw it out. Covered in donut crumbs.";
	dir = 4;
	name = "couch"
	},
/obj/item/newspaper{
	pixel_x = 3;
	pixel_y = -8
	},
/obj/machinery/digital_clock/directional/west,
/turf/open/floor/iron/vaporwave,
/area/station/service/barber)
"u" = (
/obj/effect/turf_decal/siding/dark{
	dir = 10
	},
/obj/machinery/atmospherics/pipe/smart/manifold4w/supply/hidden/layer4,
/turf/open/floor/wood/tile,
/area/station/service/barber)
"v" = (
/obj/structure/chair/sofa/corp/right{
	dir = 4
	},
/obj/item/radio/intercom/directional/west,
/obj/effect/landmark/start/assistant,
/obj/machinery/light/directional/west,
/turf/open/floor/iron/vaporwave,
/area/station/service/barber)
"x" = (
/obj/structure/table/reinforced/rglass,
/obj/structure/mirror/directional/south,
/obj/effect/turf_decal/siding/dark{
	dir = 10
	},
/obj/structure/sign/poster/official/random/directional/west,
/obj/item/fur_dyer,
/obj/item/lipstick/quantum,
/turf/open/floor/wood/tile,
/area/station/service/barber)
"y" = (
/obj/effect/turf_decal/tile/purple/opposingcorners{
	dir = 4
	},
/obj/structure/table/reinforced/rglass,
/obj/item/hairbrush{
	pixel_x = -1;
	pixel_y = 4
	},
/obj/item/clothing/gloves/latex,
/turf/open/floor/iron/white,
/area/station/service/barber)
"z" = (
/obj/effect/turf_decal/siding/dark{
	dir = 5
	},
/obj/structure/window/spawner/directional/north,
/obj/effect/landmark/start/barber,
/obj/machinery/atmospherics/pipe/smart/manifold4w/supply/hidden/layer4,
/turf/open/floor/wood/tile,
/area/station/service/barber)
"A" = (
/obj/structure/mirror/directional/east,
/obj/structure/bed/pod{
	pixel_y = 1
	},
/obj/item/reagent_containers/medigel/sterilizine{
	pixel_x = 7;
	pixel_y = 11
	},
/obj/item/reagent_containers/medigel/libital{
	desc = "A medicinal massage oil that warms up and relaxes the skin and muscles, great at both treating backpains, cramps and bruises.";
	name = "Relaxing massage oil";
	pixel_x = -7;
	pixel_y = 10
	},
/obj/item/reagent_containers/medigel/aiuri{
	desc = "A medicinal massage oil containing aiuri, normally gives a nice cooling effect on the bodypart where it's applied whilst also healing minor burns.";
	name = "Cooling massage oil";
	pixel_y = 10
	},
/obj/machinery/dryer{
	pixel_y = 23
	},
/obj/effect/turf_decal/tile/purple/opposingcorners{
	dir = 4
	},
/turf/open/floor/iron/white,
/area/station/service/barber)
"B" = (
/obj/machinery/atmospherics/components/unary/vent_scrubber/on/layer2{
	dir = 1
	},
/obj/structure/cable,
/turf/open/floor/wood/tile,
/area/station/service/barber)
"C" = (
/obj/machinery/vending/barbervend,
/obj/effect/turf_decal/siding/dark{
	dir = 1
	},
/obj/effect/turf_decal/siding/dark{
	dir = 5
	},
/obj/effect/turf_decal/bot,
/obj/machinery/requests_console/auto_name/directional/east,
/obj/effect/mapping_helpers/requests_console/assistance,
/obj/effect/mapping_helpers/requests_console/supplies,
/obj/effect/mapping_helpers/requests_console/information,
/obj/structure/window/spawner/directional/north,
/turf/open/floor/wood/tile,
/area/station/service/barber)
"D" = (
/turf/template_noop,
/area/template_noop)
"E" = (
/obj/effect/turf_decal/siding/dark,
/obj/structure/cable,
/obj/machinery/atmospherics/pipe/smart/manifold4w/supply/hidden/layer4,
/obj/item/kirbyplants/random,
/obj/machinery/light_switch/directional/south{
	pixel_x = 5
	},
/turf/open/floor/wood/tile,
/area/station/service/barber)
"F" = (
/obj/machinery/atmospherics/pipe/smart/manifold4w/scrubbers/hidden/layer2,
/obj/structure/cable,
/obj/machinery/light_switch/directional/east,
/obj/effect/turf_decal/siding/dark{
	dir = 1
	},
/turf/open/floor/iron/vaporwave,
/area/station/service/barber)
"H" = (
/obj/effect/turf_decal/siding/dark{
	dir = 9
	},
/obj/structure/window/spawner/directional/north,
/obj/machinery/atmospherics/pipe/smart/manifold4w/supply/hidden/layer4,
/turf/open/floor/wood/tile,
/area/station/service/barber)
"I" = (
/obj/structure/chair/comfy/barber_chair,
/obj/effect/turf_decal/siding/dark{
	dir = 8
	},
/obj/machinery/firealarm/directional/west,
/obj/machinery/camera/autoname/directional/west,
/obj/machinery/dryer{
	dir = 4;
	pixel_x = -6;
	pixel_y = -6
	},
/turf/open/floor/wood/tile,
/area/station/service/barber)
"L" = (
/obj/effect/turf_decal/tile/purple/opposingcorners{
	dir = 4
	},
/obj/machinery/atmospherics/components/unary/vent_pump/on/layer4,
/turf/open/floor/iron/white,
/area/station/service/barber)
"M" = (
/obj/structure/sign/barber/directional/south,
/turf/open/floor/iron,
/area/station/hallway/primary/port)
"N" = (
/obj/structure/reagent_dispensers/water_cooler,
/turf/open/floor/iron/vaporwave,
/area/station/service/barber)
"O" = (
/obj/structure/mirror/directional/south,
/obj/structure/table/reinforced/rglass,
/obj/effect/turf_decal/siding/dark{
	dir = 6
	},
/obj/item/tattoo_kit{
	pixel_y = 4
	},
/turf/open/floor/wood/tile,
/area/station/service/barber)
"P" = (
/obj/effect/turf_decal/siding/dark{
	dir = 1
	},
/obj/machinery/atmospherics/pipe/smart/manifold4w/supply/hidden/layer4,
/obj/machinery/door/window/survival_pod/left/directional/north,
/turf/open/floor/wood/tile,
/area/station/service/barber)
"Q" = (
/obj/structure/cable,
/obj/machinery/atmospherics/pipe/smart/manifold4w/scrubbers/hidden/layer2,
/obj/machinery/door/firedoor,
/obj/effect/landmark/navigate_destination/autoname,
/obj/machinery/door/airlock/service/glass{
	name = "Barbershop"
	},
/obj/structure/curtain/cloth/fancy/mechanical{
	id = "barbershopcurtains";
	name = "Barber Shop Drapes"
	},
/turf/open/floor/iron/dark,
/area/station/service/barber)
"R" = (
/obj/machinery/button/curtain{
	pixel_x = -6;
	pixel_y = 6;
	id = "barbershopcurtains"
	},
/turf/closed/wall,
/area/station/service/barber)
"S" = (
/obj/effect/turf_decal/tile/purple/opposingcorners{
	dir = 4
	},
/obj/structure/chair/office/light{
	dir = 4;
	pixel_y = 3
	},
/obj/effect/landmark/start/barber,
/obj/machinery/light/directional/south{
	dir = 1
	},
/turf/open/floor/iron/white,
/area/station/service/barber)
"T" = (
/obj/machinery/holopad,
/obj/machinery/atmospherics/pipe/smart/manifold4w/supply/hidden/layer4,
/obj/structure/cable,
/turf/open/floor/wood/tile,
/area/station/service/barber)
"V" = (
/obj/machinery/atmospherics/pipe/smart/manifold4w/supply/hidden/layer4,
/obj/machinery/door/airlock/maintenance,
/obj/effect/turf_decal/siding/wood{
	dir = 7
	},
/obj/effect/mapping_helpers/airlock/access/any/service/maintenance,
/turf/open/floor/iron/dark,
/area/station/service/barber)
"W" = (
/obj/effect/turf_decal/tile/purple/opposingcorners{
	dir = 4
	},
/obj/effect/turf_decal/siding/dark{
	dir = 8
	},
/obj/structure/closet,
/obj/structure/window/spawner/directional/west,
/turf/open/floor/iron/white,
/area/station/service/barber)
"Y" = (
/turf/closed/wall,
/area/station/service/barber)
"Z" = (
/obj/effect/turf_decal/siding/dark{
	dir = 8
	},
/obj/structure/cable,
/turf/open/floor/wood/tile,
/area/station/service/barber)

(1,1,1) = {"
D
Y
Y
Y
Y
Y
Y
Y
Y
"}
(2,1,1) = {"
p
a
f
s
v
n
I
x
Y
"}
(3,1,1) = {"
p
a
g
k
l
b
B
j
Y
"}
(4,1,1) = {"
D
Q
F
m
N
z
e
O
Y
"}
(5,1,1) = {"
M
Y
Y
W
q
H
Z
u
V
"}
(6,1,1) = {"
D
D
Y
S
L
P
T
E
R
"}
(7,1,1) = {"
D
D
Y
A
y
C
h
i
Y
"}
(8,1,1) = {"
D
Y
Y
Y
Y
Y
Y
Y
Y
"}
