//MAP CONVERTED BY dmm2tgm.py THIS HEADER COMMENT PREVENTS RECONVERSION, DO NOT REMOVE
"a" = (
/obj/effect/spawner/structure/window/reinforced,
/turf/open/floor/plating,
/area/station/security/checkpoint/supply)
"b" = (
/obj/effect/turf_decal/tile/brown/fourcorners,
/obj/machinery/door/airlock/security/glass{
	name = "Security Post - Cargo"
	},
/obj/effect/mapping_helpers/airlock/access/any/supply/customs,
/turf/open/floor/iron/dark,
/area/station/security/checkpoint/supply)
"d" = (
/turf/template_noop,
/area/template_noop)
"h" = (
/obj/structure/disposalpipe/segment{
	dir = 4
	},
/obj/machinery/atmospherics/components/unary/vent_scrubber/on/layer2{
	dir = 8
	},
/turf/open/floor/iron/dark,
/area/station/security/checkpoint/supply)
"i" = (
/obj/effect/turf_decal/tile/red/half/contrasted,
/obj/machinery/atmospherics/components/unary/vent_pump/on/layer4{
	dir = 8
	},
/turf/open/floor/iron/dark,
/area/station/security/checkpoint/supply)
"j" = (
/obj/effect/turf_decal/tile/red/half/contrasted{
	dir = 8
	},
/obj/machinery/camera/directional/west,
/obj/machinery/atmospherics/pipe/smart/manifold4w/supply/hidden/layer4,
/obj/machinery/atmospherics/pipe/smart/manifold4w/scrubbers/hidden/layer2,
/obj/structure/cable,
/turf/open/floor/iron/dark,
/area/station/security/checkpoint/supply)
"k" = (
/obj/effect/turf_decal/tile/red/half/contrasted{
	dir = 4
	},
/obj/structure/table/reinforced,
/obj/item/binoculars,
/obj/machinery/airalarm/directional/east,
/obj/machinery/light/small/directional/east,
/obj/structure/disposalpipe/segment{
	dir = 4
	},
/turf/open/floor/iron/dark,
/area/station/security/checkpoint/supply)
"m" = (
/obj/effect/turf_decal/tile/red/half/contrasted{
	dir = 4
	},
/obj/structure/chair/office/light{
	dir = 1
	},
/obj/effect/landmark/start/customs_agent,
/turf/open/floor/iron/dark,
/area/station/security/checkpoint/supply)
"q" = (
/obj/effect/turf_decal/tile/red/half/contrasted{
	dir = 8
	},
/obj/structure/disposalpipe/segment{
	dir = 4
	},
/obj/machinery/atmospherics/pipe/smart/manifold4w/supply/hidden/layer4,
/obj/machinery/atmospherics/pipe/smart/manifold4w/scrubbers/hidden/layer2,
/obj/structure/cable,
/obj/structure/tank_holder/extinguisher{
	pixel_x = -9
	},
/turf/open/floor/iron/dark,
/area/station/security/checkpoint/supply)
"r" = (
/obj/effect/turf_decal/tile/red/anticorner/contrasted{
	dir = 4
	},
/obj/machinery/computer/security,
/turf/open/floor/iron/dark,
/area/station/security/checkpoint/supply)
"s" = (
/obj/effect/turf_decal/tile/red/anticorner/contrasted,
/obj/item/paper_bin/carbon,
/obj/item/pen/red/security,
/obj/structure/table/reinforced,
/turf/open/floor/iron/dark,
/area/station/security/checkpoint/supply)
"t" = (
/obj/effect/turf_decal/tile/red/half/contrasted{
	dir = 4
	},
/obj/structure/table/reinforced,
/obj/item/book/manual/wiki/security_space_law{
	pixel_x = 9
	},
/obj/item/pen/red{
	pixel_y = 7;
	pixel_x = 9
	},
/obj/machinery/recharger,
/obj/effect/mapping_helpers/requests_console/assistance,
/obj/effect/mapping_helpers/requests_console/supplies,
/obj/machinery/requests_console/auto_name/directional/east,
/turf/open/floor/iron/dark,
/area/station/security/checkpoint/supply)
"v" = (
/turf/open/floor/iron/dark,
/area/station/security/checkpoint/supply)
"y" = (
/obj/effect/turf_decal/tile/red/anticorner/contrasted{
	dir = 8
	},
/obj/machinery/computer/records/security{
	dir = 1
	},
/obj/machinery/light/small/directional/west,
/obj/machinery/firealarm/directional/west,
/obj/machinery/atmospherics/pipe/smart/manifold4w/supply/hidden/layer4,
/obj/machinery/power/apc/auto_name/directional/south,
/obj/structure/cable,
/turf/open/floor/iron/dark,
/area/station/security/checkpoint/supply)
"B" = (
/obj/effect/turf_decal/tile/red/half/contrasted{
	dir = 1
	},
/obj/machinery/computer/security/mining,
/obj/structure/reagent_dispensers/wall/peppertank/directional/north,
/obj/machinery/light/small/directional/north{
	pixel_x = -11
	},
/turf/open/floor/iron/dark,
/area/station/security/checkpoint/supply)
"D" = (
/obj/machinery/door/airlock/security/glass{
	name = "Security Post - Cargo"
	},
/obj/machinery/atmospherics/pipe/smart/manifold4w/supply/hidden/layer4,
/obj/machinery/atmospherics/pipe/smart/manifold4w/scrubbers/hidden/layer2,
/obj/structure/cable,
/obj/effect/mapping_helpers/airlock/access/any/supply/customs,
/turf/open/floor/plating,
/area/station/security/checkpoint/supply)
"I" = (
/obj/structure/disposalpipe/segment{
	dir = 4
	},
/obj/effect/spawner/structure/window/reinforced,
/turf/open/floor/plating,
/area/station/security/checkpoint/supply)
"J" = (
/turf/closed/wall,
/area/station/security/checkpoint/supply)
"M" = (
/obj/structure/chair/office/light{
	dir = 1
	},
/obj/effect/landmark/start/customs_agent,
/turf/open/floor/iron/dark,
/area/station/security/checkpoint/supply)
"P" = (
/obj/effect/turf_decal/tile/red/half/contrasted{
	dir = 8
	},
/obj/structure/chair/office/light,
/obj/machinery/atmospherics/pipe/smart/manifold4w/supply/hidden/layer4,
/obj/structure/cable,
/turf/open/floor/iron/dark,
/area/station/security/checkpoint/supply)
"Q" = (
/obj/structure/disposalpipe/segment{
	dir = 4
	},
/turf/closed/wall,
/area/station/security/checkpoint/supply)
"U" = (
/obj/effect/turf_decal/tile/red/fourcorners,
/obj/structure/closet/secure_closet/security/cargo,
/turf/open/floor/iron/dark,
/area/station/security/checkpoint/supply)
"Y" = (
/obj/effect/turf_decal/tile/red/anticorner/contrasted{
	dir = 1
	},
/obj/machinery/atmospherics/pipe/smart/manifold4w/supply/hidden/layer4,
/obj/machinery/atmospherics/pipe/smart/manifold4w/scrubbers/hidden/layer2,
/obj/structure/cable,
/turf/open/floor/iron/dark,
/area/station/security/checkpoint/supply)

(1,1,1) = {"
J
J
D
J
I
J
J
J
"}
(2,1,1) = {"
a
U
Y
j
q
P
y
J
"}
(3,1,1) = {"
J
J
B
M
h
v
i
b
"}
(4,1,1) = {"
d
a
r
m
k
t
s
a
"}
(5,1,1) = {"
d
J
a
a
Q
J
a
a
"}
