//MAP CONVERTED BY dmm2tgm.py THIS HEADER COMMENT PREVENTS RECONVERSION, DO NOT REMOVE
"a" = (
/obj/machinery/atmospherics/pipe/smart/manifold4w/supply/hidden/layer4,
/obj/machinery/atmospherics/pipe/smart/manifold4w/scrubbers/hidden/layer2,
/obj/structure/cable,
/obj/effect/landmark/start/depsec/science,
/obj/effect/turf_decal/tile/red/opposingcorners,
/turf/open/floor/iron,
/area/station/security/checkpoint/science)
"b" = (
/obj/machinery/atmospherics/components/unary/vent_pump/on/layer4{
	dir = 1
	},
/obj/structure/chair/office{
	dir = 4
	},
/obj/effect/turf_decal/siding/red{
	dir = 4
	},
/obj/effect/landmark/start/depsec/science,
/obj/effect/turf_decal/tile/red/opposingcorners,
/turf/open/floor/iron,
/area/station/security/checkpoint/science)
"d" = (
/obj/structure/table/reinforced,
/obj/machinery/recharger,
/obj/structure/cable,
/obj/machinery/camera/directional/east{
	c_tag = "Security Post - Research Division";
	network = list("ss13","rd")
	},
/obj/machinery/light/small/directional/east,
/turf/open/floor/iron/dark,
/area/station/security/checkpoint/science)
"e" = (
/obj/machinery/computer/mecha{
	dir = 8
	},
/turf/open/floor/iron/dark,
/area/station/security/checkpoint/science)
"g" = (
/obj/item/radio/intercom/directional/west,
/obj/structure/closet/secure_closet/security/science,
/obj/machinery/light/small/directional/west,
/turf/open/floor/iron/dark,
/area/station/security/checkpoint/science)
"h" = (
/obj/machinery/atmospherics/pipe/smart/manifold4w/supply/hidden/layer4,
/obj/structure/cable,
/obj/effect/turf_decal/siding/red{
	dir = 4
	},
/obj/effect/landmark/start/depsec/science,
/obj/effect/turf_decal/tile/red/opposingcorners,
/turf/open/floor/iron,
/area/station/security/checkpoint/science)
"k" = (
/obj/effect/spawner/structure/window/reinforced,
/obj/structure/cable,
/turf/open/floor/plating,
/area/station/science/lab)
"o" = (
/obj/effect/spawner/structure/window/reinforced,
/obj/structure/cable,
/turf/open/floor/plating,
/area/station/security/checkpoint/science)
"q" = (
/obj/machinery/atmospherics/components/unary/vent_scrubber/on/layer2{
	dir = 1
	},
/obj/structure/cable,
/obj/effect/landmark/start/depsec/science,
/obj/effect/turf_decal/tile/red/opposingcorners,
/turf/open/floor/iron,
/area/station/security/checkpoint/science)
"s" = (
/turf/closed/wall/r_wall,
/area/station/command/heads_quarters/rd)
"u" = (
/obj/item/kirbyplants/random,
/obj/machinery/power/apc/auto_name/directional/north,
/obj/machinery/light/small/directional/east,
/obj/structure/cable,
/obj/machinery/airalarm/directional/east,
/obj/effect/turf_decal/siding/red,
/obj/effect/turf_decal/tile/red/opposingcorners,
/turf/open/floor/iron,
/area/station/security/checkpoint/science)
"x" = (
/obj/structure/rack,
/obj/item/restraints/handcuffs,
/obj/machinery/light/small/directional/west,
/obj/machinery/light_switch/directional/west{
	pixel_y = -4
	},
/obj/machinery/button/door/directional/west{
	id = "rdrnd";
	name = "Research and Development Containment Control";
	pixel_y = 6;
	req_access = list("rd")
	},
/obj/effect/turf_decal/tile/red/opposingcorners,
/turf/open/floor/iron,
/area/station/security/checkpoint/science)
"y" = (
/turf/closed/wall,
/area/station/command/heads_quarters/rd)
"z" = (
/obj/effect/turf_decal/siding/red{
	dir = 6
	},
/obj/effect/landmark/start/depsec/science,
/obj/effect/turf_decal/tile/red/opposingcorners,
/turf/open/floor/iron,
/area/station/security/checkpoint/science)
"A" = (
/turf/closed/wall,
/area/station/science/lab)
"D" = (
/obj/structure/table/reinforced,
/obj/item/folder/red,
/obj/structure/cable,
/obj/machinery/requests_console/directional/south{
	department = "Security";
	name = "Security Requests Console"
	},
/obj/effect/mapping_helpers/requests_console/information,
/obj/effect/mapping_helpers/requests_console/assistance,
/turf/open/floor/iron/dark,
/area/station/security/checkpoint/science)
"E" = (
/obj/machinery/computer/records/security{
	dir = 8
	},
/obj/machinery/firealarm/directional/east,
/turf/open/floor/iron/dark,
/area/station/security/checkpoint/science)
"F" = (
/obj/structure/cable,
/obj/effect/turf_decal/siding/red,
/obj/effect/landmark/start/depsec/science,
/obj/effect/turf_decal/tile/red/opposingcorners,
/turf/open/floor/iron,
/area/station/security/checkpoint/science)
"H" = (
/obj/machinery/computer/security{
	dir = 8
	},
/obj/structure/reagent_dispensers/wall/peppertank/directional/east,
/turf/open/floor/iron/dark,
/area/station/security/checkpoint/science)
"L" = (
/obj/effect/spawner/structure/window/reinforced,
/obj/structure/cable,
/turf/open/floor/plating,
/area/station/science/research)
"M" = (
/obj/effect/landmark/start/depsec/science,
/obj/effect/turf_decal/tile/red/opposingcorners,
/turf/open/floor/iron,
/area/station/security/checkpoint/science)
"N" = (
/turf/closed/wall,
/area/station/security/checkpoint/science)
"O" = (
/obj/structure/chair,
/obj/effect/landmark/start/depsec/science,
/obj/effect/turf_decal/tile/red/opposingcorners,
/turf/open/floor/iron,
/area/station/security/checkpoint/science)
"P" = (
/obj/structure/table/reinforced,
/obj/item/book/manual/wiki/security_space_law{
	pixel_x = 9;
	pixel_y = 4
	},
/obj/structure/cable,
/obj/item/radio{
	pixel_x = -6;
	pixel_y = -3
	},
/turf/open/floor/iron/dark,
/area/station/security/checkpoint/science)
"Q" = (
/obj/effect/turf_decal/siding/red,
/obj/effect/landmark/start/depsec/science,
/obj/effect/turf_decal/tile/red/opposingcorners,
/turf/open/floor/iron,
/area/station/security/checkpoint/science)
"U" = (
/turf/closed/wall,
/area/station/science/research)
"W" = (
/obj/structure/chair,
/obj/structure/cable,
/obj/effect/turf_decal/siding/red/corner,
/obj/effect/landmark/start/depsec/science,
/obj/effect/turf_decal/tile/red/opposingcorners,
/turf/open/floor/iron,
/area/station/security/checkpoint/science)
"Y" = (
/obj/machinery/door/firedoor,
/obj/machinery/door/airlock/security/glass{
	name = "Security Office"
	},
/obj/machinery/atmospherics/pipe/smart/manifold4w/supply/hidden/layer4,
/obj/machinery/atmospherics/pipe/smart/manifold4w/scrubbers/hidden/layer2,
/obj/structure/cable,
/obj/effect/turf_decal/tile/red/fourcorners,
/obj/effect/mapping_helpers/airlock/access/any/science/sci_guard,
/turf/open/floor/iron,
/area/station/security/checkpoint/science)

(1,1,1) = {"
A
N
Y
o
o
N
U
"}
(2,1,1) = {"
k
x
a
M
Q
g
L
"}
(3,1,1) = {"
k
O
a
q
F
P
L
"}
(4,1,1) = {"
k
W
h
b
z
D
U
"}
(5,1,1) = {"
A
u
E
H
e
d
L
"}
(6,1,1) = {"
y
y
y
y
y
y
s
"}
