//MAP CONVERTED BY dmm2tgm.py THIS HEADER COMMENT PREVENTS RECONVERSION, DO NOT REMOVE
"bb" = (
/turf/closed/wall/r_wall,
/area/station/command/teleporter)
"bK" = (
/obj/structure/extinguisher_cabinet/directional/east,
/obj/machinery/camera/directional/east{
	c_tag = "Command Hallway - Central"
	},
/obj/structure/cable,
/obj/effect/turf_decal/tile/neutral,
/turf/open/floor/iron,
/area/station/hallway/secondary/command)
"bM" = (
/obj/structure/cable,
/obj/machinery/atmospherics/pipe/smart/manifold4w/supply/hidden/layer4,
/obj/machinery/atmospherics/pipe/smart/manifold4w/scrubbers/hidden/layer2,
/obj/effect/turf_decal/tile/neutral/half/contrasted,
/obj/machinery/light/floor,
/turf/open/floor/iron,
/area/station/hallway/secondary/command)
"bR" = (
/obj/machinery/atmospherics/pipe/smart/manifold4w/supply/hidden/layer4,
/obj/machinery/atmospherics/pipe/smart/manifold4w/scrubbers/hidden/layer2,
/obj/item/banner{
	inspiration_available = 0
	},
/turf/open/floor/iron,
/area/station/hallway/secondary/command)
"ck" = (
/obj/structure/disposalpipe/segment{
	dir = 4
	},
/obj/effect/turf_decal/tile/neutral{
	dir = 4
	},
/obj/item/banner{
	inspiration_available = 0
	},
/turf/open/floor/iron,
/area/station/hallway/primary/central)
"da" = (
/obj/effect/turf_decal/plaque{
	icon_state = "L13"
	},
/obj/structure/cable,
/turf/open/floor/iron,
/area/station/hallway/primary/central)
"de" = (
/obj/structure/flora/bush/grassy,
/obj/structure/flora/bush/flowers_pp,
/obj/structure/curtain/cloth/fancy/mechanical{
	icon_state = "bounty-open";
	icon_type = "bounty";
	id = "nt_rep_priv";
	name = "curtain"
	},
/obj/structure/window/reinforced/fulltile,
/obj/structure/cable,
/turf/open/floor/grass,
/area/station/command/heads_quarters/nt_rep)
"dV" = (
/obj/structure/cable,
/obj/effect/turf_decal/siding/dark,
/obj/structure/chair/office,
/obj/machinery/atmospherics/pipe/smart/manifold4w/supply/hidden/layer4,
/obj/effect/landmark/start/nanotrasen_consultant,
/obj/effect/turf_decal/tile/dark_blue/opposingcorners,
/obj/machinery/holopad,
/turf/open/floor/iron/dark,
/area/station/command/heads_quarters/blueshield)
"et" = (
/obj/structure/cable,
/obj/effect/turf_decal/tile/neutral,
/turf/open/floor/iron,
/area/station/hallway/secondary/command)
"ez" = (
/obj/effect/turf_decal/tile/neutral/half/contrasted{
	dir = 1
	},
/obj/structure/cable,
/turf/open/floor/iron,
/area/station/hallway/primary/central)
"fe" = (
/obj/machinery/atmospherics/pipe/smart/manifold4w/supply/hidden/layer4,
/obj/machinery/atmospherics/pipe/smart/manifold4w/scrubbers/hidden/layer2,
/obj/effect/turf_decal/tile/neutral,
/turf/open/floor/iron,
/area/station/hallway/secondary/command)
"gn" = (
/obj/effect/turf_decal/delivery/red,
/obj/machinery/door/window/brigdoor/right/directional/east{
	req_access = list("captain");
	name = "Blueshield's Armory"
	},
/obj/structure/closet/secure_closet/blueshield,
/obj/item/taperecorder{
	name = "Captain's Log"
	},
/obj/item/dog_bone,
/obj/item/clothing/gloves/tackler/combat/insulated/blueshield,
/obj/machinery/light/small/blacklight/directional/west,
/obj/item/storage/medkit/combat_surgeon/stocked,
/obj/item/storage/medkit/regular,
/obj/item/storage/medkit/tactical/blueshield,
/turf/open/floor/iron/dark/textured,
/area/station/command/heads_quarters/blueshield)
"gr" = (
/obj/structure/disposalpipe/segment{
	dir = 10
	},
/obj/effect/turf_decal/tile/neutral/half/contrasted{
	dir = 1
	},
/turf/open/floor/iron,
/area/station/hallway/primary/central)
"iA" = (
/obj/effect/landmark/start/hangover,
/turf/open/floor/iron,
/area/station/hallway/secondary/command)
"jh" = (
/obj/machinery/light/warm/directional/north,
/obj/machinery/computer/records/medical,
/obj/effect/turf_decal/siding/dark,
/obj/machinery/vending/wallmed/directional/north,
/turf/open/floor/wood,
/area/station/command/heads_quarters/blueshield)
"lT" = (
/obj/structure/cable,
/obj/effect/turf_decal/siding/dark,
/obj/machinery/atmospherics/pipe/smart/manifold4w/supply/hidden/layer4,
/obj/effect/mapping_helpers/turn_off_lights_with_lightswitch,
/obj/effect/turf_decal/tile/dark_blue/opposingcorners,
/obj/effect/landmark/start/blueshield,
/turf/open/floor/iron/dark,
/area/station/command/heads_quarters/blueshield)
"mC" = (
/obj/structure/disposalpipe/segment{
	dir = 4
	},
/obj/effect/turf_decal/tile/neutral/half/contrasted{
	dir = 1
	},
/obj/structure/sign/nanotrasen/directional/north,
/turf/open/floor/iron,
/area/station/hallway/primary/central)
"mX" = (
/obj/structure/table/wood,
/obj/item/clipboard{
	pixel_x = -4;
	pixel_y = 3
	},
/obj/item/reagent_containers/cup/glass/mug/nanotrasen,
/turf/open/floor/carpet/green,
/area/station/command/heads_quarters/nt_rep)
"nt" = (
/obj/structure/cable,
/obj/effect/turf_decal/siding/dark,
/obj/machinery/atmospherics/components/unary/vent_pump/on/layer4{
	dir = 4
	},
/obj/effect/landmark/start/nanotrasen_consultant,
/turf/open/floor/wood,
/area/station/command/heads_quarters/nt_rep)
"nD" = (
/obj/effect/turf_decal/tile/neutral{
	dir = 1
	},
/obj/item/banner{
	inspiration_available = 0
	},
/turf/open/floor/iron,
/area/station/hallway/primary/central)
"nI" = (
/obj/effect/turf_decal/plaque{
	icon_state = "L1"
	},
/obj/structure/cable,
/turf/open/floor/iron,
/area/station/hallway/primary/central)
"nY" = (
/obj/structure/chair/sofa/corp/left{
	desc = "Looks like someone threw it out. Covered in donut crumbs.";
	dir = 4;
	name = "couch"
	},
/obj/machinery/light/warm/directional/west,
/obj/machinery/airalarm/directional/west,
/obj/effect/landmark/start/blueshield,
/turf/open/floor/carpet/green,
/area/station/command/heads_quarters/nt_rep)
"pl" = (
/obj/structure/chair/office{
	dir = 1
	},
/obj/effect/landmark/start/nanotrasen_consultant,
/turf/open/floor/carpet/green,
/area/station/command/heads_quarters/nt_rep)
"ql" = (
/obj/effect/spawner/structure/window/reinforced,
/obj/structure/cable,
/turf/open/floor/plating,
/area/station/command/gateway)
"qN" = (
/obj/effect/turf_decal/siding/dark{
	dir = 8
	},
/obj/structure/safe/abovetilefloor,
/obj/effect/spawner/random/dignitary/ntc,
/obj/effect/spawner/random/dignitary/ntc,
/obj/effect/spawner/random/dignitary/ntc,
/obj/item/paperwork{
	desc = "A densely compiled stack of Internal Affairs records, documenting various investigations, audits and disciplinary proceedings, extensively redacted under CENTCOM authority.";
	name = "internal affairs records"
	},
/turf/open/floor/wood,
/area/station/command/heads_quarters/nt_rep)
"sc" = (
/obj/machinery/newscaster/directional/south,
/obj/structure/cable,
/obj/effect/turf_decal/tile/neutral,
/turf/open/floor/iron,
/area/station/hallway/secondary/command)
"sr" = (
/obj/machinery/atmospherics/components/unary/vent_pump/on/layer4{
	dir = 8
	},
/turf/open/floor/iron,
/area/station/hallway/secondary/command)
"sB" = (
/obj/machinery/atmospherics/pipe/smart/manifold4w/supply/hidden/layer4,
/obj/machinery/atmospherics/pipe/smart/manifold4w/scrubbers/hidden/layer2,
/obj/effect/turf_decal/tile/neutral/half/contrasted,
/obj/structure/chair,
/obj/effect/landmark/start/blueshield,
/obj/machinery/light/floor,
/turf/open/floor/iron,
/area/station/hallway/secondary/command)
"ub" = (
/obj/structure/fluff/arc,
/turf/open/floor/iron,
/area/station/hallway/secondary/command)
"uS" = (
/obj/effect/spawner/structure/window/reinforced,
/obj/machinery/door/poddoor/shutters/preopen{
	id = "blueshield_priv"
	},
/obj/structure/cable,
/turf/open/floor/plating,
/area/station/command/heads_quarters/blueshield)
"vd" = (
/turf/template_noop,
/area/template_noop)
"vV" = (
/obj/machinery/atmospherics/pipe/smart/manifold4w/supply/hidden/layer4,
/obj/machinery/atmospherics/pipe/smart/manifold4w/scrubbers/hidden/layer2,
/turf/open/floor/iron,
/area/station/hallway/secondary/command)
"ww" = (
/obj/structure/table/wood,
/obj/item/radio/intercom/directional/east,
/obj/machinery/fax{
	fax_name = "Nanotrasen Consultant's Office";
	name = "Nanotrasen Consultant's Fax Machine"
	},
/obj/effect/turf_decal/siding/dark{
	dir = 1
	},
/turf/open/floor/wood,
/area/station/command/heads_quarters/nt_rep)
"yU" = (
/obj/structure/cable,
/obj/effect/turf_decal/siding/dark/corner{
	dir = 8
	},
/obj/effect/turf_decal/siding/dark{
	dir = 4
	},
/obj/machinery/atmospherics/pipe/smart/manifold4w/supply/hidden/layer4,
/obj/machinery/atmospherics/pipe/smart/manifold4w/scrubbers/hidden/layer2,
/turf/open/floor/wood,
/area/station/command/heads_quarters/nt_rep)
"zo" = (
/obj/structure/chair/sofa/corp/corner{
	desc = "Looks like someone threw it out. Covered in donut crumbs.";
	dir = 1;
	name = "couch"
	},
/obj/machinery/camera/directional/west{
	c_tag = "Consultant's Office";
	name = "command camera";
	dir = 5
	},
/obj/machinery/digital_clock/directional/south,
/obj/structure/secure_safe/directional/west,
/turf/open/floor/carpet/green,
/area/station/command/heads_quarters/nt_rep)
"zv" = (
/obj/structure/plaque/static_plaque/golden/commission/meta,
/turf/open/floor/iron,
/area/station/hallway/secondary/command)
"zw" = (
/obj/effect/turf_decal/tile/neutral{
	dir = 8
	},
/obj/machinery/atmospherics/pipe/smart/manifold4w/supply/hidden/layer4,
/obj/machinery/atmospherics/pipe/smart/manifold4w/scrubbers/hidden/layer2,
/turf/open/floor/iron,
/area/station/hallway/secondary/command)
"zP" = (
/turf/closed/wall/r_wall,
/area/station/command/heads_quarters/blueshield)
"zY" = (
/obj/structure/cable,
/obj/effect/turf_decal/tile/neutral{
	dir = 8
	},
/turf/open/floor/iron,
/area/station/hallway/secondary/command)
"Aq" = (
/obj/machinery/holopad,
/obj/structure/cable,
/obj/effect/spawner/random/engineering/tracking_beacon,
/turf/open/floor/iron,
/area/station/hallway/secondary/command)
"As" = (
/obj/effect/turf_decal/siding/dark/corner,
/obj/machinery/atmospherics/pipe/smart/manifold4w/supply/hidden/layer4,
/obj/machinery/atmospherics/pipe/smart/manifold4w/scrubbers/hidden/layer2,
/obj/effect/turf_decal/tile/dark_blue/opposingcorners,
/obj/effect/landmark/start/blueshield,
/obj/structure/cable,
/turf/open/floor/iron/dark,
/area/station/command/heads_quarters/blueshield)
"AI" = (
/turf/closed/wall/r_wall,
/area/station/command/heads_quarters/nt_rep)
"AP" = (
/obj/structure/table/wood,
/obj/item/modular_computer/laptop/preset/security{
	pixel_y = 5
	},
/obj/item/phone{
	pixel_x = 8;
	pixel_y = 6
	},
/obj/effect/spawner/random/entertainment/cigar,
/turf/open/floor/carpet/blue,
/area/station/command/heads_quarters/blueshield)
"Bx" = (
/obj/effect/turf_decal/siding/dark{
	dir = 4
	},
/obj/machinery/atmospherics/pipe/smart/manifold4w/scrubbers/hidden/layer2,
/obj/effect/turf_decal/tile/dark_blue/opposingcorners,
/obj/effect/landmark/start/blueshield,
/obj/structure/cable,
/turf/open/floor/iron/dark,
/area/station/command/heads_quarters/blueshield)
"BL" = (
/obj/structure/cable,
/obj/effect/spawner/structure/window/reinforced,
/turf/open/floor/plating,
/area/station/hallway/secondary/command)
"Cf" = (
/obj/structure/flora/bush/grassy,
/obj/structure/flora/bush/flowers_br,
/obj/structure/curtain/cloth/fancy/mechanical{
	icon_state = "bounty-open";
	icon_type = "bounty";
	id = "nt_rep_priv";
	name = "curtain"
	},
/obj/structure/window/reinforced/fulltile,
/obj/structure/cable,
/turf/open/floor/grass,
/area/station/command/heads_quarters/nt_rep)
"Co" = (
/obj/structure/cable,
/obj/effect/turf_decal/siding/dark/corner,
/obj/machinery/door/firedoor,
/obj/machinery/atmospherics/pipe/smart/manifold4w/supply/hidden/layer4,
/obj/machinery/atmospherics/pipe/smart/manifold4w/scrubbers/hidden/layer2,
/obj/effect/mapping_helpers/airlock/unres/delayed,
/obj/effect/mapping_helpers/airlock/access/any/cent_com/rep_or_captain,
/obj/effect/landmark/navigate_destination/autoname,
/obj/machinery/door/airlock/corporate{
	id_tag = "consultantdoor";
	name = "Consultant's Office"
	},
/obj/machinery/door/poddoor/shutters/preopen{
	id = "nt_rep_priv";
	name = "Privacy Shutters"
	},
/turf/open/floor/wood,
/area/station/command/heads_quarters/nt_rep)
"CC" = (
/obj/machinery/power/apc/auto_name/directional/east,
/obj/structure/cable,
/obj/effect/turf_decal/siding/dark,
/obj/machinery/atmospherics/components/unary/vent_pump/on/layer4{
	dir = 8
	},
/obj/structure/bed/dogbed{
	name = "Walter's Dogbed"
	},
/obj/item/toy/figure/syndie{
	pixel_x = 9;
	pixel_y = -2;
	name = "\improper chewed up Redsuit action figure"
	},
/mob/living/basic/pet/dog/dobermann/walter,
/obj/effect/turf_decal/tile/dark_blue/opposingcorners,
/obj/machinery/camera/directional/west{
	c_tag = "Blueshield's Office";
	name = "command camera";
	dir = 6
	},
/turf/open/floor/iron/dark,
/area/station/command/heads_quarters/blueshield)
"CT" = (
/obj/effect/turf_decal/siding/dark{
	dir = 8
	},
/obj/effect/turf_decal/siding/dark/corner{
	dir = 4
	},
/obj/machinery/atmospherics/pipe/smart/manifold4w/scrubbers/hidden/layer2,
/obj/effect/mapping_helpers/turn_off_lights_with_lightswitch,
/obj/effect/landmark/start/nanotrasen_consultant,
/turf/open/floor/wood,
/area/station/command/heads_quarters/nt_rep)
"CZ" = (
/obj/structure/noticeboard/directional/north,
/obj/structure/disposalpipe/segment{
	dir = 4
	},
/obj/effect/turf_decal/tile/neutral/half/contrasted{
	dir = 1
	},
/turf/open/floor/iron,
/area/station/hallway/primary/central)
"Db" = (
/obj/machinery/newscaster/directional/south,
/obj/structure/cable,
/obj/effect/turf_decal/tile/neutral{
	dir = 8
	},
/turf/open/floor/iron,
/area/station/hallway/secondary/command)
"DC" = (
/obj/machinery/airalarm/directional/east,
/obj/machinery/computer/records/security,
/obj/effect/turf_decal/siding/dark,
/obj/structure/reagent_dispensers/wall/peppertank/directional/north,
/turf/open/floor/wood,
/area/station/command/heads_quarters/blueshield)
"DG" = (
/obj/effect/turf_decal/tile/neutral/half/contrasted{
	dir = 1
	},
/turf/open/floor/iron,
/area/station/hallway/primary/central)
"Eb" = (
/turf/open/floor/iron,
/area/station/hallway/secondary/command)
"EO" = (
/obj/machinery/holopad,
/obj/effect/landmark/start/nanotrasen_consultant,
/turf/open/floor/carpet/green,
/area/station/command/heads_quarters/nt_rep)
"Fb" = (
/obj/structure/cable,
/obj/machinery/power/apc/auto_name/directional/west,
/obj/effect/turf_decal/siding/dark,
/obj/machinery/photocopier/prebuilt,
/turf/open/floor/wood,
/area/station/command/heads_quarters/nt_rep)
"GR" = (
/obj/structure/chair/comfy/black{
	dir = 1
	},
/obj/machinery/light/warm/directional/south,
/obj/effect/landmark/start/blueshield,
/turf/open/floor/carpet/blue,
/area/station/command/heads_quarters/blueshield)
"Hb" = (
/obj/structure/flora/bush/grassy,
/obj/structure/flora/bush/flowers_yw,
/obj/structure/curtain/cloth/fancy/mechanical{
	icon_state = "bounty-open";
	icon_type = "bounty";
	id = "nt_rep_priv";
	name = "curtain"
	},
/obj/structure/window/reinforced/fulltile,
/obj/structure/cable,
/turf/open/floor/grass,
/area/station/command/heads_quarters/nt_rep)
"He" = (
/obj/machinery/status_display/evac/directional/north,
/turf/template_noop,
/area/template_noop)
"Hn" = (
/obj/machinery/door/firedoor,
/obj/structure/cable,
/obj/machinery/atmospherics/pipe/smart/manifold4w/supply/hidden/layer4,
/obj/machinery/atmospherics/pipe/smart/manifold4w/scrubbers/hidden/layer2,
/obj/effect/mapping_helpers/airlock/access/any/cent_com/rep_or_captain,
/obj/effect/landmark/navigate_destination/autoname,
/obj/machinery/door/airlock/corporate{
	id_tag = "BSdoor";
	name = "Blueshield's Office"
	},
/obj/machinery/door/poddoor/shutters/preopen{
	id = "blueshield_priv"
	},
/obj/machinery/button/door/directional/east{
	pixel_y = -6;
	id = "nt_rep_priv";
	name = "Office Shutters Control";
	req_access = list("captain");
	pixel_x = -30
	},
/turf/open/floor/iron/dark/smooth_edge{
	dir = 1
	},
/area/station/command/heads_quarters/blueshield)
"HI" = (
/obj/effect/landmark/event_spawn,
/turf/open/floor/iron,
/area/station/hallway/secondary/command)
"HM" = (
/obj/machinery/atmospherics/pipe/smart/manifold4w/supply/hidden/layer4,
/obj/machinery/atmospherics/pipe/smart/manifold4w/scrubbers/hidden/layer2,
/obj/effect/turf_decal/tile/neutral/half/contrasted,
/obj/structure/sign/nanotrasen/directional/south,
/turf/open/floor/iron,
/area/station/hallway/secondary/command)
"HN" = (
/obj/structure/filingcabinet/medical{
	pixel_x = -10
	},
/obj/structure/filingcabinet/employment,
/obj/structure/filingcabinet/security{
	pixel_x = 10
	},
/turf/open/floor/wood,
/area/station/command/heads_quarters/nt_rep)
"IL" = (
/turf/closed/wall/r_wall,
/area/station/command/gateway)
"IT" = (
/obj/structure/cable,
/obj/effect/landmark/start/hangover,
/turf/open/floor/iron,
/area/station/hallway/secondary/command)
"Kg" = (
/obj/machinery/modular_computer/preset/command{
	dir = 8
	},
/obj/effect/mapping_helpers/requests_console/information,
/obj/effect/mapping_helpers/requests_console/supplies,
/obj/effect/mapping_helpers/requests_console/assistance,
/obj/effect/mapping_helpers/requests_console/announcement,
/obj/effect/turf_decal/bot,
/obj/machinery/requests_console/auto_name/directional/east,
/obj/structure/secure_safe/directional/south,
/turf/open/floor/carpet/blue,
/area/station/command/heads_quarters/blueshield)
"KV" = (
/obj/machinery/vending/boozeomat,
/obj/machinery/computer/security/telescreen/entertainment/directional/north,
/turf/open/floor/wood,
/area/station/command/heads_quarters/nt_rep)
"Ll" = (
/obj/item/banner{
	inspiration_available = 0
	},
/turf/open/floor/iron,
/area/station/hallway/secondary/command)
"Lv" = (
/obj/effect/turf_decal/delivery/red,
/obj/structure/window/reinforced/spawner/directional/east,
/obj/structure/sign/calendar/directional/west,
/obj/machinery/suit_storage_unit/blueshield,
/turf/open/floor/iron/dark/textured,
/area/station/command/heads_quarters/blueshield)
"Mf" = (
/obj/structure/window/reinforced/spawner/directional/north,
/obj/effect/turf_decal/delivery/red,
/obj/structure/window/reinforced/spawner/directional/east,
/obj/structure/closet/secure_closet/tac{
	req_access = list("captain")
	},
/obj/item/gun_maintenance_supplies,
/obj/item/clothing/suit/armor/riot,
/obj/item/clothing/head/helmet/toggleable/riot{
	pixel_y = 6
	},
/obj/item/screwdriver,
/obj/item/storage/toolbox/ammobox/wt550m9,
/obj/item/shield/riot,
/obj/item/mod/module/pepper_shoulders,
/turf/open/floor/iron/dark/textured,
/area/station/command/heads_quarters/blueshield)
"Mh" = (
/obj/machinery/modular_computer/preset/command{
	dir = 8
	},
/obj/machinery/requests_console/auto_name/directional/east,
/obj/effect/mapping_helpers/requests_console/assistance,
/obj/effect/mapping_helpers/requests_console/supplies,
/obj/effect/mapping_helpers/requests_console/information,
/obj/effect/mapping_helpers/requests_console/announcement,
/obj/machinery/firealarm/directional/north,
/obj/effect/turf_decal/bot,
/turf/open/floor/carpet/green,
/area/station/command/heads_quarters/nt_rep)
"MC" = (
/obj/structure/table/wood,
/obj/item/paper_bin{
	pixel_y = 4;
	pixel_x = -5
	},
/obj/item/stamp/granted{
	pixel_y = 12;
	pixel_x = 8
	},
/obj/item/stamp/denied{
	pixel_x = 8;
	pixel_y = 6
	},
/obj/item/stamp/centcom{
	pixel_x = 8
	},
/obj/machinery/light/warm/directional/east,
/obj/item/pen/fourcolor{
	pixel_x = -5;
	pixel_y = 5
	},
/obj/item/pen/fountain{
	pixel_x = -5;
	pixel_y = 5
	},
/obj/machinery/button/door/directional/east{
	pixel_y = 10;
	id = "nt_rep_priv";
	name = "Office Shutters Control";
	req_access = list("cent_general")
	},
/obj/machinery/button/curtain{
	id = "nt_rep_priv";
	name = "curtain control";
	pixel_x = 35;
	pixel_y = 10;
	req_access = list("cent_general");
	dir = 4
	},
/turf/open/floor/carpet/green,
/area/station/command/heads_quarters/nt_rep)
"MG" = (
/obj/structure/chair/sofa/corp/right{
	desc = "Looks like someone threw it out. Covered in donut crumbs.";
	dir = 1;
	name = "couch"
	},
/obj/effect/landmark/start/nanotrasen_consultant,
/turf/open/floor/carpet/green,
/area/station/command/heads_quarters/nt_rep)
"MT" = (
/obj/machinery/door/window/brigdoor/right/directional/south{
	name = "Consultant's Desk";
	req_access = list("cent_general"))
	},
/obj/machinery/door/window/left/directional/north{
	name = "Reception Window"
	},
/obj/structure/table/reinforced,
/obj/machinery/door/firedoor,
/obj/machinery/door/poddoor/shutters/preopen{
	id = "nt_rep_priv";
	name = "Privacy Shutters"
	},
/obj/item/phone{
	desc = "Supposedly a direct line to Nanotrasen Central Command. It's not even plugged in.";
	pixel_x = 10;
	pixel_y = 3
	},
/obj/machinery/door/window/left/directional/north,
/turf/open/floor/wood,
/area/station/command/heads_quarters/nt_rep)
"NL" = (
/obj/effect/turf_decal/tile/neutral{
	dir = 1
	},
/turf/open/floor/iron,
/area/station/hallway/primary/central)
"Oo" = (
/turf/closed/wall/r_wall,
/area/station/hallway/secondary/command)
"Pj" = (
/obj/structure/lattice,
/turf/open/space/basic,
/area/space/nearstation)
"Pn" = (
/obj/structure/disposalpipe/segment{
	dir = 4
	},
/obj/effect/turf_decal/tile/neutral/half/contrasted{
	dir = 1
	},
/obj/effect/turf_decal/tile/neutral{
	dir = 4
	},
/obj/structure/cable,
/turf/open/floor/iron,
/area/station/hallway/primary/central)
"Rd" = (
/obj/structure/cable,
/obj/effect/turf_decal/siding/dark{
	dir = 4
	},
/obj/machinery/atmospherics/pipe/smart/manifold4w/supply/hidden/layer4,
/obj/machinery/atmospherics/pipe/smart/manifold4w/scrubbers/hidden/layer2,
/turf/open/floor/wood,
/area/station/command/heads_quarters/nt_rep)
"Tv" = (
/obj/structure/cable,
/obj/effect/turf_decal/tile/neutral,
/obj/structure/reagent_dispensers/water_cooler,
/turf/open/floor/iron,
/area/station/hallway/secondary/command)
"Ur" = (
/obj/structure/cable,
/obj/machinery/atmospherics/pipe/smart/manifold4w/supply/hidden/layer4,
/obj/effect/landmark/start/hangover,
/obj/machinery/atmospherics/pipe/smart/manifold4w/scrubbers/hidden/layer2,
/turf/open/floor/iron,
/area/station/hallway/secondary/command)
"UZ" = (
/obj/machinery/photocopier/prebuilt,
/obj/machinery/light_switch/directional/north{
	pixel_x = -7
	},
/obj/machinery/digital_clock/directional/north{
	pixel_y = 37
	},
/obj/effect/turf_decal/tile/dark_blue/opposingcorners,
/obj/effect/turf_decal/bot,
/turf/open/floor/iron/dark,
/area/station/command/heads_quarters/blueshield)
"Vm" = (
/obj/structure/table/wood,
/obj/item/paper_bin{
	pixel_y = 4;
	pixel_x = -5
	},
/obj/machinery/recharger{
	pixel_x = 7;
	pixel_y = 6
	},
/obj/item/pen/fourcolor{
	pixel_x = -5;
	pixel_y = 5
	},
/turf/open/floor/carpet/blue,
/area/station/command/heads_quarters/blueshield)
"Vw" = (
/obj/machinery/computer/crew{
	dir = 2
	},
/obj/effect/turf_decal/siding/dark{
	dir = 10
	},
/obj/machinery/firealarm/directional/north,
/turf/open/floor/wood,
/area/station/command/heads_quarters/blueshield)
"Vy" = (
/obj/structure/disposalpipe/segment{
	dir = 4
	},
/obj/effect/turf_decal/tile/neutral/half/contrasted{
	dir = 1
	},
/turf/open/floor/iron,
/area/station/hallway/primary/central)
"VL" = (
/obj/effect/spawner/structure/window/reinforced,
/obj/structure/cable,
/turf/open/floor/plating,
/area/station/command/teleporter)
"VT" = (
/obj/effect/turf_decal/siding/dark{
	dir = 4
	},
/obj/machinery/camera/directional/west{
	c_tag = "Blueshield's Office";
	name = "command camera";
	dir = 5
	},
/obj/machinery/atmospherics/components/unary/vent_scrubber/on/layer2{
	dir = 1
	},
/obj/effect/turf_decal/tile/dark_blue/opposingcorners,
/obj/effect/landmark/start/blueshield,
/obj/structure/cable,
/turf/open/floor/iron/dark,
/area/station/command/heads_quarters/blueshield)
"WA" = (
/obj/structure/closet/secure_closet/nanotrasen_consultant,
/obj/item/clothing/accessory/medal/gold/ordom,
/obj/item/clothing/accessory/medal/silver/bureaucracy,
/obj/item/hand_labeler,
/obj/item/clothing/accessory/pocketprotector,
/turf/open/floor/wood,
/area/station/command/heads_quarters/nt_rep)
"WG" = (
/obj/effect/turf_decal/tile/neutral{
	dir = 8
	},
/obj/structure/cable,
/obj/machinery/atmospherics/pipe/smart/manifold4w/supply/hidden/layer4,
/obj/machinery/atmospherics/pipe/smart/manifold4w/scrubbers/hidden/layer2,
/turf/open/floor/iron,
/area/station/hallway/secondary/command)
"WI" = (
/obj/effect/spawner/structure/window/reinforced,
/obj/structure/cable,
/turf/open/floor/plating,
/area/station/hallway/secondary/command)
"XO" = (
/obj/structure/cable,
/obj/machinery/atmospherics/pipe/smart/manifold4w/supply/hidden/layer4,
/obj/machinery/atmospherics/pipe/smart/manifold4w/scrubbers/hidden/layer2,
/obj/effect/turf_decal/tile/dark_blue/opposingcorners,
/turf/open/floor/iron/dark,
/area/station/command/heads_quarters/blueshield)
"Yk" = (
/obj/structure/safe/abovetilefloor,
/obj/item/reagent_containers/cup/glass/trophy{
	desc = "You did good in the worst way possible.";
	name = "Redshield 1st prize";
	pixel_y = 9;
	pixel_x = -2
	},
/obj/item/paperwork/captain{
	pixel_x = -3;
	pixel_y = 4;
	name = "Asset Protection case records";
	desc = "A messily compiled stack of DAP records, containing incident reports, asset recovery briefings and classified paramilitary activities, with substantial portions censored and redacted. You probably shouldn't be reading this, unless you yearn for a one-way trip to Space Guantanamo."
	},
/obj/item/toy/plush/skyrat/fox/mia{
	desc = "A cute, marketable version of one of the DAP's mascots, Vigilant the fox. She has a blue collar with a shield-shaped tag that reads DAP. Holding her makes you feel protected.";
	name = "Vigilant plushie"
	},
/obj/item/storage/medkit/regular,
/obj/effect/spawner/random/dignitary/blueshield,
/obj/effect/spawner/random/dignitary/blueshield,
/obj/effect/spawner/random/dignitary/blueshield,
/obj/structure/cable,
/turf/open/floor/carpet/blue,
/area/station/command/heads_quarters/blueshield)
"YB" = (
/obj/structure/cable,
/obj/machinery/atmospherics/components/unary/vent_scrubber/on/layer2{
	dir = 1
	},
/obj/effect/turf_decal/tile/neutral{
	dir = 8
	},
/turf/open/floor/iron,
/area/station/hallway/secondary/command)
"YO" = (
/obj/machinery/light/warm/directional/north,
/obj/machinery/computer/station_goal,
/obj/machinery/light_switch/directional/north{
	pixel_x = 6
	},
/turf/open/floor/wood,
/area/station/command/heads_quarters/nt_rep)
"Zp" = (
/obj/structure/cable,
/obj/effect/turf_decal/tile/neutral{
	dir = 8
	},
/obj/machinery/modular_computer/preset/time_clock/directional/west,
/turf/open/floor/iron,
/area/station/hallway/secondary/command)
"ZN" = (
/obj/effect/turf_decal/siding/dark{
	dir = 1
	},
/obj/machinery/atmospherics/components/unary/vent_scrubber/on/layer2{
	dir = 8
	},
/obj/effect/landmark/start/nanotrasen_consultant,
/turf/open/floor/wood,
/area/station/command/heads_quarters/nt_rep)
"ZP" = (
/obj/structure/table/wood,
/obj/item/radio/intercom/directional/east,
/obj/machinery/fax{
	name = "Blueshield's Fax Machine";
	fax_name = "Blueshield's Office"
	},
/turf/open/floor/carpet/blue,
/area/station/command/heads_quarters/blueshield)
"ZQ" = (
/obj/effect/turf_decal/tile/neutral{
	dir = 4
	},
/obj/structure/disposalpipe/segment{
	dir = 4
	},
/turf/open/floor/iron,
/area/station/hallway/primary/central)
"ZU" = (
/obj/structure/cable,
/turf/open/floor/iron,
/area/station/hallway/secondary/command)

(1,1,1) = {"
Db
bb
bb
VL
bb
bb
bb
bb
bb
bb
He
vd
"}
(2,1,1) = {"
zY
WI
Pj
Pj
AI
KV
Fb
nY
zo
AI
ck
vd
"}
(3,1,1) = {"
YB
Oo
BL
BL
AI
YO
nt
mX
MG
Hb
ZQ
vd
"}
(4,1,1) = {"
zY
Zp
zY
WG
Co
Rd
yU
CT
qN
de
Pn
nI
"}
(5,1,1) = {"
ZU
Eb
Eb
sB
MT
pl
EO
ZN
WA
Cf
CZ
vd
"}
(6,1,1) = {"
IT
HI
Ll
fe
AI
Mh
MC
ww
HN
AI
Vy
vd
"}
(7,1,1) = {"
Aq
zv
ub
HM
AI
AI
AI
AI
AI
AI
mC
vd
"}
(8,1,1) = {"
Ur
vV
bR
zw
zP
UZ
Mf
gn
Lv
zP
gr
vd
"}
(9,1,1) = {"
ZU
sr
iA
bM
Hn
XO
As
Bx
VT
uS
DG
vd
"}
(10,1,1) = {"
et
bK
et
Tv
zP
Vw
lT
Vm
Yk
uS
ez
da
"}
(11,1,1) = {"
et
Oo
WI
WI
zP
jh
dV
AP
GR
uS
NL
vd
"}
(12,1,1) = {"
et
WI
Pj
Pj
zP
DC
CC
ZP
Kg
zP
nD
vd
"}
(13,1,1) = {"
sc
IL
IL
ql
IL
IL
IL
IL
IL
IL
He
vd
"}
