//MAP CONVERTED BY dmm2tgm.py THIS HEADER COMMENT PREVENTS RECONVERSION, DO NOT REMOVE
"a" = (
/turf/closed/wall,
/area/station/security/checkpoint/medical)
"c" = (
/obj/item/radio/intercom/directional/west,
/obj/machinery/computer/records/security{
	dir = 4
	},
/obj/machinery/button/door/directional/west{
	id = "MedbayFoyer";
	name = "Medbay Doors Control";
	normaldoorcontrol = 1;
	pixel_y = -9
	},
/obj/effect/turf_decal/tile/red/fourcorners,
/turf/open/floor/iron/dark,
/area/station/security/checkpoint/medical)
"h" = (
/obj/effect/turf_decal/trimline/red/filled/line{
	dir = 9
	},
/obj/machinery/power/apc/auto_name/directional/west,
/obj/structure/cable,
/obj/machinery/atmospherics/components/unary/vent_pump/on/layer4,
/obj/effect/landmark/start/orderly,
/turf/open/floor/iron/dark,
/area/station/security/checkpoint/medical)
"m" = (
/obj/item/pen,
/obj/structure/table/reinforced,
/obj/structure/reagent_dispensers/wall/peppertank/directional/east,
/obj/item/folder/red,
/obj/item/book/manual/wiki/security_space_law{
	pixel_x = 3;
	pixel_y = 4
	},
/obj/machinery/newscaster/directional/north,
/obj/item/screwdriver{
	pixel_y = 10
	},
/obj/item/radio/off,
/obj/effect/turf_decal/tile/red/fourcorners,
/turf/open/floor/iron/dark,
/area/station/security/checkpoint/medical)
"n" = (
/obj/effect/turf_decal/trimline/red/filled/line{
	dir = 1
	},
/obj/machinery/holopad,
/turf/open/floor/iron/dark,
/area/station/security/checkpoint/medical)
"q" = (
/obj/machinery/door/firedoor,
/obj/machinery/door/airlock/security/glass{
	name = "Medbay Security Post"
	},
/obj/structure/cable,
/obj/machinery/atmospherics/pipe/smart/manifold4w/supply/hidden/layer4,
/obj/machinery/atmospherics/pipe/smart/manifold4w/scrubbers/hidden/layer2,
/obj/effect/turf_decal/tile/red/fourcorners,
/obj/effect/mapping_helpers/airlock/access/any/medical/orderly,
/turf/open/floor/iron/dark,
/area/station/security/checkpoint/medical)
"r" = (
/obj/machinery/button/door/directional/east{
	id = "medsecprivacy";
	name = "Privacy Shutters Control"
	},
/obj/effect/turf_decal/trimline/red/filled/line{
	dir = 5
	},
/turf/open/floor/iron/dark,
/area/station/security/checkpoint/medical)
"t" = (
/obj/effect/spawner/structure/window/reinforced,
/obj/structure/cable,
/obj/machinery/door/poddoor/preopen{
	id = "medsecprivacy";
	name = "Privacy Shutter"
	},
/turf/open/floor/plating,
/area/station/security/checkpoint/medical)
"y" = (
/obj/machinery/atmospherics/components/unary/vent_scrubber/on/layer2{
	dir = 1
	},
/obj/effect/turf_decal/trimline/red/filled/line{
	dir = 4
	},
/turf/open/floor/iron/dark,
/area/station/security/checkpoint/medical)
"z" = (
/obj/machinery/airalarm/directional/west,
/obj/structure/closet/secure_closet/security/med,
/obj/effect/turf_decal/tile/red/fourcorners,
/turf/open/floor/iron/dark,
/area/station/security/checkpoint/medical)
"D" = (
/obj/effect/turf_decal/trimline/red/filled/corner{
	dir = 8
	},
/obj/structure/cable,
/obj/machinery/atmospherics/pipe/smart/manifold4w/scrubbers/hidden/layer2,
/turf/open/floor/iron/dark,
/area/station/security/checkpoint/medical)
"H" = (
/obj/effect/turf_decal/trimline/red/filled/line{
	dir = 8
	},
/turf/open/floor/iron/dark,
/area/station/security/checkpoint/medical)
"J" = (
/obj/machinery/light_switch/directional/west{
	pixel_x = -20
	},
/obj/machinery/computer/records/medical{
	dir = 4
	},
/obj/effect/turf_decal/tile/red/fourcorners,
/obj/machinery/light/small/directional/west,
/obj/machinery/computer/security/telescreen/med_sec/directional/west,
/turf/open/floor/iron/dark,
/area/station/security/checkpoint/medical)
"K" = (
/obj/effect/turf_decal/trimline/red/filled/line{
	dir = 10
	},
/obj/structure/cable,
/obj/machinery/atmospherics/pipe/smart/manifold4w/supply/hidden/layer4,
/obj/machinery/atmospherics/pipe/smart/manifold4w/scrubbers/hidden/layer2,
/turf/open/floor/iron/dark,
/area/station/security/checkpoint/medical)
"P" = (
/obj/machinery/recharger{
	pixel_y = 4
	},
/obj/machinery/camera/directional/north{
	c_tag = "Security Post - Medbay";
	network = list("ss13","medbay")
	},
/obj/effect/turf_decal/tile/red/fourcorners,
/obj/machinery/light/small/directional/north,
/obj/structure/table/reinforced,
/obj/machinery/requests_console/directional/north{
	department = "Security";
	name = "Security Requests Console"
	},
/obj/effect/mapping_helpers/requests_console/assistance,
/obj/effect/mapping_helpers/requests_console/supplies,
/turf/open/floor/iron/dark,
/area/station/security/checkpoint/medical)
"T" = (
/obj/machinery/door/poddoor/preopen{
	id = "medsecprivacy";
	name = "Privacy Shutter"
	},
/obj/structure/table/reinforced,
/obj/machinery/door/firedoor,
/obj/machinery/door/window/brigdoor/left/directional/north{
	req_access = list("security")
	},
/obj/structure/desk_bell{
	pixel_x = -3;
	pixel_y = 2
	},
/turf/open/floor/plating,
/area/station/security/checkpoint/medical)
"U" = (
/obj/structure/chair/office{
	dir = 8
	},
/obj/effect/turf_decal/trimline/red/filled/line{
	dir = 10
	},
/obj/effect/landmark/start/orderly,
/turf/open/floor/iron/dark,
/area/station/security/checkpoint/medical)
"W" = (
/obj/effect/turf_decal/trimline/red/filled/line{
	dir = 6
	},
/turf/open/floor/iron/dark,
/area/station/security/checkpoint/medical)
"X" = (
/obj/machinery/atmospherics/pipe/smart/manifold4w/scrubbers/hidden/layer2,
/obj/effect/turf_decal/trimline/red/filled/line{
	dir = 4
	},
/obj/structure/cable,
/turf/open/floor/iron/dark,
/area/station/security/checkpoint/medical)
"Z" = (
/obj/machinery/door/poddoor/preopen{
	id = "medsecprivacy";
	name = "Privacy Shutter"
	},
/obj/structure/table/reinforced,
/obj/machinery/door/firedoor,
/obj/machinery/door/window/brigdoor/right/directional/north{
	req_access = list("brig_entrance")
	},
/obj/item/folder/red{
	pixel_x = 4;
	pixel_y = 2
	},
/obj/item/paper,
/obj/item/pen,
/turf/open/floor/plating,
/area/station/security/checkpoint/medical)

(1,1,1) = {"
a
a
a
q
a
a
a
"}
(2,1,1) = {"
a
z
h
K
J
c
a
"}
(3,1,1) = {"
a
P
n
D
H
U
T
"}
(4,1,1) = {"
a
m
r
X
y
W
Z
"}
(5,1,1) = {"
a
a
a
t
t
t
a
"}
