"al" = (/obj/structure/cable,/obj/effect/turf_decal/trimline/brown/filled/line{dir = 8},/turf/open/floor/iron,/area/station/construction/storage_wing)
"bP" = (/obj/effect/turf_decal/trimline/brown/filled/corner{dir = 8},/obj/structure/cable,/obj/machinery/atmospherics/components/unary/vent_pump/on/layer4{dir = 4},/turf/open/floor/iron,/area/station/construction/storage_wing)
"cu" = (/obj/effect/decal/cleanable/dirt,/obj/effect/turf_decal/siding/wood,/turf/open/floor/stone,/area/station/cargo/blacksmith)
"dx" = (/obj/effect/decal/cleanable/dirt,/obj/structure/cable,/obj/structure/disposalpipe/segment{dir = 4},/turf/open/floor/iron,/area/station/cargo/warehouse)
"eI" = (/obj/effect/turf_decal/loading_area,/turf/open/floor/iron,/area/station/construction/storage_wing)
"fD" = (/obj/effect/decal/cleanable/dirt,/obj/structure/cable,/obj/machinery/atmospherics/components/unary/vent_scrubber/on/layer2{dir = 1},/turf/open/floor/stone,/area/station/cargo/blacksmith)
"hc" = (/obj/effect/decal/cleanable/dirt,/obj/structure/cable,/obj/structure/disposalpipe/segment{dir = 4},/obj/effect/landmark/event_spawn,/obj/machinery/atmospherics/components/unary/vent_scrubber/on/layer2{dir = 1},/turf/open/floor/iron,/area/station/cargo/warehouse)
"hC" = (/obj/effect/decal/cleanable/dirt,/obj/structure/chair{dir = 4},/obj/effect/turf_decal/siding/wood{dir = 4},/obj/effect/landmark/start/blacksmith,/turf/open/floor/stone,/area/station/cargo/blacksmith)
"hP" = (/obj/effect/decal/cleanable/dirt,/obj/machinery/computer/mech_bay_power_console{dir = 4},/obj/machinery/light/small/directional/west,/turf/open/floor/iron,/area/station/cargo/warehouse)
"ii" = (/obj/structure/cable,/obj/structure/disposalpipe/segment{dir = 9},/obj/effect/decal/cleanable/dirt,/obj/effect/mapping_helpers/turn_off_lights_with_lightswitch,/turf/open/floor/iron,/area/station/cargo/warehouse)
"iI" = (/obj/effect/decal/cleanable/dirt,/obj/effect/spawner/random/structure/crate,/obj/effect/spawner/random/maintenance,/turf/open/floor/iron,/area/station/cargo/warehouse)
"ji" = (/obj/effect/decal/cleanable/dirt,/obj/structure/cable,/obj/structure/reagent_anvil,/obj/effect/turf_decal/siding/wood{dir = 8},/obj/machinery/light/directional/west,/turf/open/floor/stone,/area/station/cargo/blacksmith)
"km" = (/obj/effect/decal/cleanable/dirt,/obj/structure/table,/obj/machinery/microwave{pixel_y = 6},/obj/machinery/light_switch/directional/west{pixel_y = -8},/obj/machinery/button/door/directional/west{id = "qm_warehouse"; name = "Warehouse Door Control"; req_access = list("cargo")},/turf/open/floor/iron,/area/station/cargo/warehouse)
"lz" = (/obj/effect/decal/cleanable/dirt,/obj/structure/cable,/obj/effect/spawner/random/structure/crate,/obj/item/electronics/apc,/turf/open/floor/iron,/area/station/cargo/warehouse)
"lR" = (/obj/effect/decal/cleanable/dirt,/obj/structure/extinguisher_cabinet/directional/west,/obj/machinery/suit_storage_unit/industrial/loader,/turf/open/floor/iron,/area/station/cargo/warehouse)
"rx" = (/obj/structure/cable,/obj/machinery/door/firedoor,/turf/open/floor/iron,/area/station/construction/storage_wing)
"sl" = (/obj/effect/turf_decal/trimline/brown/filled/line{dir = 8},/obj/structure/cable,/turf/open/floor/iron,/area/station/construction/storage_wing)
"tF" = (/obj/structure/cable,/obj/effect/landmark/start/hangover,/turf/open/floor/iron,/area/station/construction/storage_wing)
"uz" = (/obj/machinery/atmospherics/pipe/smart/manifold4w/supply/hidden/layer4,/obj/machinery/atmospherics/pipe/smart/manifold4w/scrubbers/hidden/layer2,/obj/effect/decal/cleanable/dirt,/turf/open/floor/stone,/area/station/cargo/blacksmith)
"uG" = (/turf/closed/wall,/area/station/cargo/blacksmith)
"uU" = (/obj/structure/cable,/obj/machinery/status_display/evac/directional/west,/turf/open/floor/iron,/area/station/construction/storage_wing)
"xp" = (/obj/effect/decal/cleanable/dirt,/turf/closed/wall,/area/station/cargo/blacksmith)
"xz" = (/obj/effect/decal/cleanable/dirt,/obj/effect/turf_decal/siding/wood{dir = 4},/turf/open/floor/stone,/area/station/cargo/blacksmith)
"xS" = (/obj/effect/decal/cleanable/dirt,/obj/machinery/atmospherics/components/unary/vent_pump/on/layer4,/obj/structure/reagent_dispensers/fueltank,/obj/effect/turf_decal/siding/wood{dir = 9},/obj/structure/sign/poster/random/directional/north,/obj/machinery/camera/autoname/directional/west,/turf/open/floor/stone,/area/station/cargo/blacksmith)
"Ap" = (/obj/effect/decal/cleanable/dirt,/obj/structure/rack,/obj/effect/spawner/random/maintenance,/obj/item/airlock_painter/decal,/obj/machinery/power/apc/auto_name/directional/east,/obj/structure/cable,/obj/effect/spawner/random/maintenance,/obj/effect/spawner/random/maintenance,/obj/effect/spawner/random/trash/janitor_supplies,/turf/open/floor/iron,/area/station/cargo/warehouse)
"AW" = (/obj/machinery/door/poddoor/shutters{dir = 8; id = "qm_warehouse"; name = "Warehouse Shutters"},/obj/effect/turf_decal/caution/stand_clear,/obj/machinery/atmospherics/pipe/smart/manifold4w/supply/hidden/layer4,/obj/machinery/atmospherics/pipe/smart/manifold4w/scrubbers/hidden/layer2,/turf/open/floor/iron,/area/station/cargo/warehouse)
"Bu" = (/obj/effect/decal/cleanable/dirt,/obj/structure/disposalpipe/segment,/turf/open/floor/iron,/area/station/cargo/warehouse)
"BS" = (/obj/effect/decal/cleanable/dirt,/obj/effect/landmark/start/cargo_technician,/obj/machinery/atmospherics/pipe/smart/manifold4w/supply/hidden/layer4,/obj/machinery/atmospherics/pipe/smart/manifold4w/scrubbers/hidden/layer2,/obj/structure/disposalpipe/segment,/turf/open/floor/iron,/area/station/cargo/warehouse)
"CG" = (/obj/effect/decal/cleanable/dirt,/obj/machinery/atmospherics/pipe/smart/manifold4w/supply/hidden/layer4,/obj/machinery/atmospherics/pipe/smart/manifold4w/scrubbers/hidden/layer2,/obj/effect/spawner/random/maintenance,/turf/open/floor/iron,/area/station/cargo/warehouse)
"Dg" = (/obj/structure/sign/departments/cargo,/turf/closed/wall,/area/station/cargo/blacksmith)
"HR" = (/obj/effect/decal/cleanable/dirt,/obj/effect/spawner/random/maintenance{pixel_y = 5},/obj/structure/table,/obj/item/stack/sheet/iron/fifty{pixel_x = -7},/obj/item/stack/sheet/glass/fifty{pixel_x = 7},/obj/effect/turf_decal/siding/wood{dir = 6},/turf/open/floor/stone,/area/station/cargo/blacksmith)
"II" = (/obj/effect/decal/cleanable/dirt,/obj/structure/cable,/obj/machinery/power/apc/auto_name/directional/south,/obj/structure/reagent_water_basin,/obj/effect/turf_decal/siding/wood{dir = 10},/obj/machinery/requests_console/directional/west{department = "Blacksmiths Workshop"; name = "Blacksmiths Requests console"},/turf/open/floor/stone,/area/station/cargo/blacksmith)
"Ka" = (/turf/closed/wall,/area/station/cargo/warehouse)
"Md" = (/obj/effect/turf_decal/trimline/brown/filled/line{dir = 9},/turf/open/floor/iron,/area/station/construction/storage_wing)
"Nq" = (/obj/machinery/firealarm/directional/north,/obj/effect/turf_decal/trimline/brown/filled/line{dir = 5},/turf/open/floor/iron,/area/station/construction/storage_wing)
"NN" = (/obj/effect/decal/cleanable/dirt,/obj/machinery/atmospherics/pipe/smart/manifold4w/supply/hidden/layer4,/obj/machinery/atmospherics/pipe/smart/manifold4w/scrubbers/hidden/layer2,/turf/open/floor/iron,/area/station/cargo/warehouse)
"NQ" = (/obj/machinery/door/firedoor,/obj/structure/table/reinforced,/obj/machinery/door/window{dir = 8; name = "Blacksmith Desk"; req_access = list("cargo")},/obj/structure/window/spawner/directional/north,/turf/open/floor/stone,/area/station/cargo/blacksmith)
"PC" = (/obj/structure/table/reinforced,/obj/machinery/door/window{dir = 1; name = "Blacksmith Desk"; req_access = list("cargo")},/turf/open/floor/stone,/area/station/cargo/blacksmith)
"Qi" = (/obj/effect/decal/cleanable/dirt,/obj/structure/reagent_dispensers/watertank,/obj/machinery/light/small/directional/north,/obj/effect/turf_decal/siding/wood{dir = 1},/obj/machinery/airalarm/directional/north,/turf/open/floor/stone,/area/station/cargo/blacksmith)
"Qt" = (/obj/effect/decal/cleanable/dirt,/obj/structure/cable,/obj/effect/spawner/random/structure/crate,/obj/effect/spawner/random/maintenance,/turf/open/floor/iron,/area/station/cargo/warehouse)
"Qu" = (/obj/machinery/atmospherics/pipe/smart/manifold4w/supply/hidden/layer4,/obj/machinery/atmospherics/pipe/smart/manifold4w/scrubbers/hidden/layer2,/obj/effect/decal/cleanable/dirt,/obj/effect/mapping_helpers/airlock/access/any/supply/blacksmith,/obj/machinery/door/airlock/mining{name = "Blacksmith Workshop"},/turf/open/floor/stone,/area/station/cargo/blacksmith)
"Qw" = (/obj/effect/decal/cleanable/dirt,/obj/effect/landmark/start/blacksmith,/turf/open/floor/stone,/area/station/cargo/blacksmith)
"QD" = (/obj/effect/decal/cleanable/dirt,/obj/structure/reagent_forge,/obj/effect/turf_decal/siding/wood{dir = 4},/turf/open/floor/stone,/area/station/cargo/blacksmith)
"TA" = (/obj/structure/cable,/obj/machinery/firealarm/directional/west,/obj/effect/turf_decal/trimline/brown/filled/corner{dir = 1},/turf/open/floor/iron,/area/station/construction/storage_wing)
"Ud" = (/obj/machinery/door/firedoor,/obj/effect/mapping_helpers/airlock/access/any/supply/blacksmith,/obj/machinery/door/airlock/mining{name = "Blacksmith Workshop"},/turf/open/floor/stone,/area/station/cargo/blacksmith)
"Vn" = (/obj/effect/decal/cleanable/dirt,/obj/vehicle/sealed/mecha/working/ripley/cargo,/turf/open/floor/plating,/area/station/cargo/warehouse)
"Vq" = (/obj/effect/decal/cleanable/dirt,/obj/effect/landmark/blobstart,/obj/effect/spawner/random/structure/crate,/turf/open/floor/iron,/area/station/cargo/warehouse)
"Ww" = (/obj/effect/turf_decal/siding/wood{dir = 1},/turf/open/floor/stone,/area/station/cargo/blacksmith)
"WV" = (/obj/machinery/door/poddoor/shutters{dir = 8; id = "qm_warehouse"; name = "Warehouse Shutters"},/obj/structure/cable,/obj/effect/turf_decal/caution/stand_clear,/obj/structure/disposalpipe/segment{dir = 4},/turf/open/floor/iron,/area/station/cargo/warehouse)
"Xk" = (/obj/machinery/door/firedoor,/obj/structure/table/reinforced,/obj/machinery/door/window{dir = 8; name = "Blacksmith Desk"; req_access = list("cargo")},/turf/open/floor/stone,/area/station/cargo/blacksmith)
"Xq" = (/obj/machinery/mech_bay_recharge_port,/obj/structure/sign/poster/official/safety_report/directional/south,/turf/open/floor/plating,/area/station/cargo/warehouse)
"XQ" = (/obj/machinery/door/airlock/maintenance,/obj/effect/mapping_helpers/broken_floor,/obj/effect/mapping_helpers/airlock/access/all/supply/general,/obj/structure/disposalpipe/segment,/turf/open/floor/plating,/area/station/maintenance/port/fore)
"XR" = (/obj/effect/decal/cleanable/dirt,/obj/structure/table,/obj/item/reagent_containers/cup/glass/waterbottle/large{pixel_x = 5; pixel_y = 20},/obj/item/reagent_containers/cup/glass/waterbottle{pixel_x = 7; pixel_y = 6},/obj/item/plate{pixel_x = -9},/obj/item/reagent_containers/cup/glass/waterbottle{pixel_x = 7},/obj/effect/spawner/random/food_or_drink/donkpockets{pixel_x = -9; pixel_y = 3},/obj/machinery/airalarm/directional/north,/turf/open/floor/iron,/area/station/cargo/warehouse)
"Yb" = (/obj/effect/decal/cleanable/dirt,/obj/structure/cable,/obj/effect/turf_decal/siding/wood{dir = 8},/obj/machinery/light_switch/directional/west{pixel_y = -8},/turf/open/floor/stone,/area/station/cargo/blacksmith)
"Yn" = (/obj/effect/decal/cleanable/dirt,/obj/machinery/atmospherics/pipe/smart/manifold4w/scrubbers/hidden/layer2,/obj/effect/landmark/event_spawn,/turf/open/floor/stone,/area/station/cargo/blacksmith)
"YJ" = (/turf/closed/wall,/area/station/maintenance/port/fore)
"Zr" = (/obj/effect/decal/cleanable/dirt,/obj/structure/cable,/turf/closed/wall,/area/station/cargo/blacksmith)

(1,1,1) = {"
YJYJYJXQYJYJuGuGuGbP
KakmXRBuxpxSQiWwUdsl
AWNNCGBSQuuzYnxzNQsl
WVdxhciiZrYbfDhCXkal
KalRVqlzxpjiQwQDuGTA
KahPiIQtxpIIcuHRuGuU
KaXqVnApuGuGPCuGuGrx
KaKaKaKaKaMdeINqDgtF
"}
