//MAP CONVERTED BY dmm2tgm.py THIS HEADER COMMENT PREVENTS RECONVERSION, DO NOT REMOVE
"a" = (
/obj/effect/spawner/structure/window/reinforced,
/obj/machinery/door/poddoor/shutters/preopen{
	id = "nt_rep_priv";
	name = "Privacy Shutters"
	},
/obj/structure/cable,
/turf/open/floor/plating,
/area/station/command/heads_quarters/nt_rep)
"b" = (
/obj/effect/turf_decal/siding/wood/corner{
	dir = 4
	},
/turf/open/floor/wood,
/area/station/command/heads_quarters/nt_rep)
"d" = (
/turf/closed/wall/r_wall,
/area/station/maintenance/port)
"e" = (
/obj/effect/turf_decal/siding/wood{
	dir = 4
	},
/obj/effect/turf_decal/siding/wood{
	dir = 1
	},
/turf/open/floor/carpet/green,
/area/station/command/heads_quarters/nt_rep)
"f" = (
/obj/item/table_clock{
	pixel_y = 5
	},
/obj/structure/table/wood/fancy/green,
/turf/open/floor/wood,
/area/station/command/heads_quarters/nt_rep)
"g" = (
/obj/item/statuebust,
/obj/structure/table/wood/fancy/green,
/turf/open/floor/wood,
/area/station/command/heads_quarters/nt_rep)
"h" = (
/obj/structure/filingcabinet/medical{
	pixel_x = -10;
	icon_state = "employmentcabinet"
	},
/obj/structure/filingcabinet/employment,
/obj/structure/filingcabinet/security{
	pixel_x = 10;
	icon_state = "employmentcabinet"
	},
/turf/open/floor/wood,
/area/station/command/heads_quarters/nt_rep)
"i" = (
/obj/machinery/fax{
	fax_name = "Nanotrasen Consultant's Office";
	name = "Nanotrasen Consultant's Fax Machine"
	},
/obj/structure/table/wood,
/turf/open/floor/wood,
/area/station/command/heads_quarters/nt_rep)
"j" = (
/obj/structure/chair/office/tactical{
	dir = 1
	},
/obj/effect/landmark/start/nanotrasen_consultant,
/obj/structure/sign/flag/nanotrasen/directional/south,
/turf/open/floor/carpet/green,
/area/station/command/heads_quarters/nt_rep)
"k" = (
/obj/machinery/atmospherics/pipe/smart/manifold4w/scrubbers/hidden/layer2,
/obj/effect/turf_decal/siding/wood,
/turf/open/floor/wood,
/area/station/command/heads_quarters/nt_rep)
"l" = (
/obj/structure/cable,
/obj/machinery/holopad,
/obj/effect/turf_decal/bot,
/turf/open/floor/iron/dark/textured_large,
/area/station/command/heads_quarters/nt_rep)
"p" = (
/obj/effect/turf_decal/tile/neutral{
	dir = 8
	},
/turf/open/floor/iron,
/area/station/hallway/primary/port)
"q" = (
/turf/closed/wall,
/area/station/command/heads_quarters/nt_rep)
"s" = (
/obj/machinery/atmospherics/components/unary/vent_scrubber/on/layer2{
	dir = 4
	},
/obj/machinery/light/directional/west,
/obj/structure/bed/dogbed{
	name = "CMO's bed"
	},
/mob/living/basic/mothroach{
	name = "CMO";
	desc = "Prefers to chew on carpet, watch the Consultant, and be regularly patted."
	},
/obj/effect/turf_decal/siding/wood/corner,
/turf/open/floor/wood,
/area/station/command/heads_quarters/nt_rep)
"t" = (
/obj/structure/chair/comfy/black,
/obj/effect/turf_decal/siding/wood{
	dir = 1
	},
/turf/open/floor/wood,
/area/station/command/heads_quarters/nt_rep)
"u" = (
/obj/machinery/atmospherics/pipe/smart/manifold4w/supply/hidden/layer4,
/turf/open/floor/wood,
/area/station/command/heads_quarters/nt_rep)
"v" = (
/obj/machinery/camera/directional/west{
	c_tag = "NT Consultant's Office";
	name = "command camera"
	},
/obj/structure/cable,
/obj/machinery/power/apc/auto_name/directional/west,
/obj/effect/turf_decal/siding/wood{
	dir = 4
	},
/turf/open/floor/wood,
/area/station/command/heads_quarters/nt_rep)
"w" = (
/obj/effect/turf_decal/tile/neutral{
	dir = 8
	},
/obj/item/banner{
	inspiration_available = 0
	},
/turf/open/floor/iron,
/area/station/hallway/primary/port)
"x" = (
/obj/machinery/modular_computer/preset/command{
	dir = 4
	},
/obj/structure/sign/calendar/directional/west,
/obj/machinery/requests_console/directional/south{
	name = "Nanotrasen Consultant's Requests Console";
	department = "Nanotrasen Consultant"
	},
/turf/open/floor/carpet/green,
/area/station/command/heads_quarters/nt_rep)
"y" = (
/obj/machinery/firealarm/directional/east,
/obj/item/bedsheet/centcom/double,
/obj/structure/bed/double,
/turf/open/floor/carpet/green,
/area/station/command/heads_quarters/nt_rep)
"z" = (
/obj/effect/turf_decal/siding/wood/corner{
	dir = 1
	},
/turf/open/floor/wood,
/area/station/command/heads_quarters/nt_rep)
"A" = (
/obj/structure/closet/secure_closet/personal/cabinet,
/obj/item/clothing/under/rank/centcom/officer,
/obj/item/clothing/under/rank/centcom/officer_skirt,
/obj/item/clothing/under/rank/centcom/intern,
/obj/item/clothing/under/rank/centcom/commander,
/obj/item/clothing/under/rank/centcom/centcom_skirt,
/obj/item/clothing/head/hats/centcom_cap,
/obj/item/clothing/suit/hooded/wintercoat/centcom/nt_consultant,
/obj/item/clothing/head/hats/centhat,
/obj/item/radio/headset/heads/nanotrasen_consultant/alt,
/obj/item/clothing/glasses/sunglasses,
/obj/item/clothing/suit/armor/centcom_formal/nt_consultant,
/obj/item/clothing/suit/armor/centcom_formal,
/obj/machinery/light/small/blacklight/directional/north,
/turf/open/floor/carpet/green,
/area/station/command/heads_quarters/nt_rep)
"B" = (
/obj/structure/table/wood,
/obj/effect/turf_decal/siding/wood{
	dir = 1
	},
/turf/open/floor/carpet/green,
/area/station/command/heads_quarters/nt_rep)
"C" = (
/obj/structure/cable,
/obj/machinery/atmospherics/pipe/smart/manifold4w/scrubbers/hidden/layer2,
/obj/machinery/light_switch/directional/east,
/obj/effect/turf_decal/siding/wood/corner{
	dir = 8
	},
/turf/open/floor/wood,
/area/station/command/heads_quarters/nt_rep)
"D" = (
/turf/template_noop,
/area/template_noop)
"E" = (
/obj/machinery/airalarm/directional/south,
/obj/machinery/atmospherics/components/unary/vent_pump/on/layer4{
	dir = 8
	},
/obj/machinery/light/directional/south,
/turf/open/floor/wood,
/area/station/command/heads_quarters/nt_rep)
"F" = (
/obj/structure/cable,
/obj/machinery/atmospherics/pipe/smart/manifold4w/scrubbers/hidden/layer2,
/obj/machinery/status_display/ai/directional/east,
/turf/open/floor/wood,
/area/station/command/heads_quarters/nt_rep)
"H" = (
/obj/machinery/vending/boozeomat/all_access,
/turf/closed/wall/r_wall,
/area/station/command/heads_quarters/nt_rep)
"I" = (
/obj/effect/turf_decal/siding/wood{
	dir = 1
	},
/obj/structure/table/wood,
/obj/item/stamp/centcom{
	pixel_x = -8;
	pixel_y = 8
	},
/obj/item/stamp/denied{
	pixel_x = -8;
	pixel_y = 4
	},
/obj/item/stamp{
	pixel_x = -8
	},
/obj/item/paper_bin{
	pixel_y = 4;
	pixel_x = 4
	},
/obj/item/pen/fountain{
	pixel_x = 4;
	pixel_y = 4
	},
/obj/machinery/button/door/directional/east{
	id = "nt_rep_priv";
	name = "Privacy Shutters Control";
	pixel_x = -24
	},
/obj/machinery/light/directional/west,
/turf/open/floor/carpet/green,
/area/station/command/heads_quarters/nt_rep)
"L" = (
/turf/open/floor/carpet/green,
/area/station/command/heads_quarters/nt_rep)
"M" = (
/obj/machinery/time_clock/directional/south,
/turf/open/floor/iron,
/area/station/hallway/primary/port)
"N" = (
/obj/structure/cable,
/obj/effect/turf_decal/siding/wood{
	dir = 8
	},
/turf/open/floor/wood,
/area/station/command/heads_quarters/nt_rep)
"O" = (
/obj/item/radio/intercom/directional/south,
/obj/effect/turf_decal/siding/wood{
	dir = 4
	},
/turf/open/floor/carpet/green,
/area/station/command/heads_quarters/nt_rep)
"P" = (
/obj/effect/mapping_helpers/airlock/access/all/cent_com/rep_door,
/obj/machinery/door/firedoor,
/obj/effect/turf_decal/siding/wood,
/obj/machinery/door/airlock/corporate{
	name = "Nanotrasen Consultant's Quarters"
	},
/turf/open/floor/carpet/green,
/area/station/command/heads_quarters/nt_rep)
"Q" = (
/obj/machinery/door/airlock/corporate{
	name = "Nanotrasen Consultant's Office"
	},
/obj/structure/cable,
/obj/machinery/atmospherics/pipe/smart/manifold4w/scrubbers/hidden/layer2,
/obj/effect/mapping_helpers/airlock/access/all/cent_com/rep_door,
/obj/machinery/door/firedoor,
/obj/effect/landmark/navigate_destination/autoname,
/obj/effect/mapping_helpers/airlock/unres,
/obj/effect/turf_decal/siding/wood,
/turf/open/floor/iron/dark/textured_large,
/area/station/command/heads_quarters/nt_rep)
"S" = (
/obj/structure/closet/secure_closet/nanotrasen_consultant,
/obj/item/clothing/accessory/medal/silver/bureaucracy,
/obj/item/clothing/accessory/medal/gold/nanotrasen_consultant,
/obj/item/clothing/accessory/medal/gold/ordom,
/obj/item/storage/briefcase/central_command,
/turf/open/floor/carpet/green,
/area/station/command/heads_quarters/nt_rep)
"T" = (
/turf/open/floor/wood,
/area/station/command/heads_quarters/nt_rep)
"V" = (
/obj/machinery/atmospherics/pipe/smart/manifold4w/supply/hidden/layer4,
/obj/effect/mapping_helpers/airlock/access/all/cent_com/rep_door,
/obj/machinery/door/airlock/maintenance,
/obj/machinery/door/firedoor,
/obj/effect/turf_decal/siding/wood{
	dir = 1
	},
/turf/open/floor/iron/dark/textured_large,
/area/station/maintenance/port)
"Y" = (
/turf/closed/wall/r_wall,
/area/station/command/heads_quarters/nt_rep)
"Z" = (
/obj/machinery/photocopier,
/turf/open/floor/wood,
/area/station/command/heads_quarters/nt_rep)

(1,1,1) = {"
D
d
d
d
d
d
d
d
d
"}
(2,1,1) = {"
w
a
f
s
v
b
I
x
d
"}
(3,1,1) = {"
p
a
g
k
l
t
B
j
d
"}
(4,1,1) = {"
D
Q
F
C
N
z
e
O
d
"}
(5,1,1) = {"
M
Y
Y
Y
Y
H
Z
u
V
"}
(6,1,1) = {"
D
D
Y
S
L
P
T
E
d
"}
(7,1,1) = {"
D
D
Y
A
y
Y
h
i
d
"}
(8,1,1) = {"
D
q
Y
Y
d
d
d
d
d
"}
