"a" = (/turf/closed/wall,/area/station/maintenance/starboard/lesser)
"b" = (/obj/effect/turf_decal/siding/wood{dir = 6},/obj/structure/rack,/obj/item/stack/sheet/iron/fifty{pixel_x = -7},/obj/item/stack/sheet/glass/fifty{pixel_x = 7},/obj/machinery/light_switch/directional/east,/turf/open/floor/stone,/area/station/cargo/blacksmith)
"j" = (/obj/machinery/light/warm/directional/east,/obj/effect/turf_decal/siding/wood{dir = 4},/obj/effect/decal/cleanable/dirt,/turf/open/floor/stone,/area/station/cargo/blacksmith)
"k" = (/obj/structure/cable,/obj/effect/decal/cleanable/dirt,/turf/open/floor/stone,/area/station/cargo/blacksmith)
"q" = (/obj/effect/turf_decal/siding/wood{dir = 1},/obj/effect/decal/cleanable/dirt,/turf/open/floor/stone,/area/station/cargo/blacksmith)
"t" = (/turf/closed/wall,/area/station/cargo/blacksmith)
"v" = (/obj/machinery/atmospherics/components/unary/vent_pump/on/layer4{dir = 1},/turf/open/floor/stone,/area/station/cargo/blacksmith)
"y" = (/obj/machinery/atmospherics/pipe/smart/manifold4w/scrubbers/hidden/layer2,/obj/effect/turf_decal/siding/wood{dir = 8},/obj/structure/reagent_anvil,/obj/machinery/power/apc/auto_name/directional/west,/obj/structure/cable,/turf/open/floor/stone,/area/station/cargo/blacksmith)
"B" = (/obj/machinery/atmospherics/pipe/smart/manifold4w/supply/hidden/layer4,/obj/structure/cable,/obj/machinery/atmospherics/pipe/smart/manifold4w/scrubbers/hidden/layer2,/obj/machinery/door/firedoor,/obj/effect/mapping_helpers/airlock/access/any/supply/blacksmith,/obj/machinery/door/airlock/mining{name = "Blacksmith Workshop"},/turf/open/floor/stone,/area/station/cargo/blacksmith)
"C" = (/obj/effect/turf_decal/siding/wood{dir = 4},/obj/structure/reagent_water_basin,/obj/machinery/airalarm/directional/east,/turf/open/floor/stone,/area/station/cargo/blacksmith)
"E" = (/obj/machinery/atmospherics/pipe/smart/manifold4w/supply/hidden/layer4,/obj/machinery/atmospherics/pipe/smart/manifold4w/scrubbers/hidden/layer2,/obj/effect/landmark/start/hangover,/obj/structure/cable,/obj/effect/decal/cleanable/dirt,/turf/open/floor/stone,/area/station/cargo/blacksmith)
"F" = (/obj/machinery/door/airlock/maintenance_hatch{name = "Delivery Office Maintenance"},/obj/effect/mapping_helpers/airlock/access/any/supply/blacksmith,/turf/open/floor/stone,/area/station/cargo/blacksmith)
"H" = (/obj/effect/spawner/structure/window/reinforced,/turf/open/floor/plating,/area/station/cargo/blacksmith)
"K" = (/obj/structure/table/reinforced,/obj/machinery/door/firedoor,/obj/machinery/door/window{dir = 1; name = "Blacksmith Desk"; req_access = list("cargo")},/turf/open/floor/stone,/area/station/cargo/blacksmith)
"P" = (/obj/effect/turf_decal/siding/wood,/obj/effect/landmark/start/blacksmith,/obj/effect/decal/cleanable/dirt,/turf/open/floor/stone,/area/station/cargo/blacksmith)
"T" = (/obj/structure/disposalpipe/segment,/obj/effect/spawner/structure/window/reinforced,/turf/open/floor/plating,/area/station/cargo/blacksmith)
"X" = (/obj/structure/sign/poster/official/jim_nortons/directional/north,/obj/effect/turf_decal/siding/wood{dir = 9},/obj/structure/reagent_forge,/turf/open/floor/stone,/area/station/cargo/blacksmith)
"Y" = (/obj/machinery/atmospherics/components/unary/vent_scrubber/on/layer2,/obj/machinery/camera/directional/north{c_tag = "Vacant Commissary"},/obj/effect/turf_decal/siding/wood{dir = 1},/obj/machinery/requests_console/directional/west{department = "Blacksmiths Workshop"; name = "Blacksmiths Requests console"; pixel_x = 2; pixel_y = 29},/obj/effect/landmark/start/blacksmith,/obj/effect/decal/cleanable/dirt,/turf/open/floor/stone,/area/station/cargo/blacksmith)
"Z" = (/obj/machinery/disposal/bin,/obj/structure/disposalpipe/trunk,/obj/effect/turf_decal/siding/wood{dir = 10},/obj/effect/decal/cleanable/dirt,/turf/open/floor/stone,/area/station/cargo/blacksmith)

(1,1,1) = {"
aaaaa
tXYqF
tyECa
Bkvja
tZPba
tTKHa
"}
