//MAP CONVERTED BY dmm2tgm.py THIS HEADER COMMENT PREVENTS RECONVERSION, DO NOT REMOVE
"a" = (
/obj/structure/window/reinforced/survival_pod,
/obj/structure/window/reinforced/survival_pod{
	dir = 8
	},
/obj/machinery/photocopier/gratis,
/obj/structure/window/reinforced/survival_pod/spawner/directional/east{
	dir = 6
	},
/obj/structure/window/reinforced/survival_pod/spawner/directional/south{
	dir = 10
	},
/turf/open/floor/mineral/plastitanium,
/area/template_noop)
"c" = (
/obj/structure/window/reinforced/survival_pod{
	dir = 1
	},
/obj/structure/window/reinforced/survival_pod{
	dir = 4
	},
/obj/machinery/computer/records/medical/syndie,
/obj/structure/window/reinforced/survival_pod/spawner/directional/east{
	dir = 5
	},
/turf/open/floor/mineral/plastitanium,
/area/template_noop)
"m" = (
/obj/structure/window/reinforced/survival_pod{
	dir = 1
	},
/obj/structure/window/reinforced/survival_pod{
	dir = 8
	},
/obj/machinery/computer/message_monitor,
/obj/structure/window/reinforced/survival_pod/spawner/directional/east{
	dir = 9
	},
/turf/open/floor/mineral/plastitanium,
/area/template_noop)
"t" = (
/obj/machinery/door/window/survival_pod,
/turf/open/floor/mineral/plastitanium/red,
/area/template_noop)
"y" = (
/obj/effect/turf_decal/skyrat_decals/ds2/right,
/obj/structure/window/reinforced/survival_pod{
	dir = 4
	},
/obj/structure/table/reinforced,
/obj/machinery/fax{
	allow_exotic_faxes = 1;
	syndicate_network = 1;
	name = "Menacing Fax Machine";
	color = "#FF0000";
	fax_name = "Unknown Syndicate Fax - PLP"
	},
/turf/open/floor/mineral/plastitanium/red,
/area/template_noop)
"C" = (
/obj/effect/turf_decal/skyrat_decals/ds2/middle,
/obj/structure/chair/office/tactical{
	dir = 1
	},
/turf/open/floor/mineral/plastitanium/red,
/area/template_noop)
"F" = (
/obj/structure/window/reinforced/survival_pod,
/obj/structure/window/reinforced/survival_pod{
	dir = 4
	},
/obj/structure/filingcabinet/chestdrawer,
/obj/structure/window/reinforced/survival_pod/spawner/directional/east{
	dir = 6
	},
/obj/structure/window/reinforced/survival_pod/spawner/directional/south{
	dir = 10
	},
/turf/open/floor/mineral/plastitanium,
/area/template_noop)
"Q" = (
/obj/effect/turf_decal/skyrat_decals/ds2/left,
/obj/structure/window/reinforced/survival_pod{
	dir = 8
	},
/obj/structure/table/reinforced,
/obj/item/paper_bin{
	pixel_x = -5;
	pixel_y = 6
	},
/obj/item/stamp/chameleon{
	pixel_x = 7;
	pixel_y = 12
	},
/obj/item/pen/fourcolor{
	pixel_x = -5;
	pixel_y = 7
	},
/obj/item/paper/monitorkey,
/obj/item/paper/crumpled/plap{
	pixel_x = 7
	},
/turf/open/floor/mineral/plastitanium/red,
/area/template_noop)
"W" = (
/obj/structure/window/reinforced/survival_pod{
	dir = 1
	},
/obj/machinery/computer/camera_advanced/syndie,
/turf/open/floor/mineral/plastitanium/red,
/area/template_noop)

(1,1,1) = {"
m
Q
a
"}
(2,1,1) = {"
W
C
t
"}
(3,1,1) = {"
c
y
F
"}
