"a" = (/obj/structure/window/reinforced/survival_pod/spawner/directional/east,/obj/structure/window/reinforced/survival_pod/spawner/directional/north,/turf/open/floor/pod/dark,/area/misc/survivalpod)
"e" = (/obj/machinery/door/window/survival_pod/left/directional/west,/turf/open/floor/pod/light,/area/misc/survivalpod)
"l" = (/obj/machinery/door/window/survival_pod/left/directional/north,/turf/open/floor/pod/light,/area/misc/survivalpod)
"m" = (/obj/structure/window/reinforced/survival_pod/spawner/directional/east,/obj/structure/window/reinforced/survival_pod/spawner/directional/south,/turf/open/floor/pod/dark,/area/misc/survivalpod)
"v" = (/obj/structure/window/reinforced/survival_pod/spawner/directional/south,/obj/structure/window/reinforced/survival_pod/spawner/directional/west,/turf/open/floor/pod/dark,/area/misc/survivalpod)
"G" = (/obj/machinery/door/window/survival_pod/left/directional/south,/turf/open/floor/pod/light,/area/misc/survivalpod)
"L" = (/obj/structure/window/reinforced/survival_pod/spawner/directional/north,/obj/structure/window/reinforced/survival_pod/spawner/directional/west,/turf/open/floor/pod/dark,/area/misc/survivalpod)
"Q" = (/obj/machinery/door/window/survival_pod/left/directional/east,/turf/open/floor/pod/light,/area/misc/survivalpod)
"S" = (/obj/machinery/light/floor,/turf/open/floor/pod/light,/area/misc/survivalpod)

(1,1,1) = {"
Lla
eSQ
vGm
"}
