//MAP CONVERTED BY dmm2tgm.py THIS HEADER COMMENT PREVENTS RECONVERSION, DO NOT REMOVE
"a" = (
/obj/structure/window/reinforced/survival_pod/spawner/directional/south,
/obj/effect/turf_decal/siding/wood,
/turf/open/floor/wood/large,
/area/misc/survivalpod)
"b" = (
/obj/machinery/shower/directional/south,
/obj/structure/drain,
/obj/effect/turf_decal/siding/end{
	dir = 8
	},
/turf/open/floor/plastic,
/area/misc/survivalpod)
"c" = (
/obj/structure/window/reinforced/survival_pod/spawner/directional/south,
/obj/structure/grille,
/obj/structure/window/reinforced/survival_pod/spawner/directional/north,
/obj/structure/window/reinforced/survival_pod/spawner/directional/east,
/obj/machinery/door/poddoor/shutters/preopen{
	id = "sauna_shutters"
	},
/turf/open/floor/pod/dark,
/area/misc/survivalpod)
"d" = (
/obj/structure/window/reinforced/survival_pod/spawner/directional/south,
/obj/effect/turf_decal/siding/wood,
/obj/effect/spawner/liquids_spawner{
	reagent_list = list(/datum/reagent/water=250)
	},
/turf/open/floor/iron/pool/cobble/corner{
	dir = 4
	},
/area/misc/survivalpod)
"e" = (
/obj/structure/window/reinforced/survival_pod/spawner/directional/south,
/obj/structure/grille,
/obj/structure/window/reinforced/survival_pod/spawner/directional/north,
/obj/machinery/door/poddoor/shutters/preopen{
	id = "sauna_shutters"
	},
/turf/open/floor/pod/dark,
/area/misc/survivalpod)
"f" = (
/obj/structure/grille,
/obj/structure/window/reinforced/survival_pod/spawner/directional/south,
/obj/structure/window/reinforced/survival_pod/spawner/directional/west,
/obj/structure/window/reinforced/survival_pod/spawner/directional/east,
/turf/open/floor/pod/dark,
/area/misc/survivalpod)
"g" = (
/obj/effect/spawner/liquids_spawner{
	reagent_list = list(/datum/reagent/water=250)
	},
/turf/open/floor/iron/pool/cobble/corner,
/area/misc/survivalpod)
"h" = (
/obj/structure/chair/sofa/corp/right{
	dir = 1
	},
/turf/open/floor/pod/dark,
/area/misc/survivalpod)
"i" = (
/obj/machinery/light/directional/west,
/turf/open/floor/pod/dark,
/area/misc/survivalpod)
"k" = (
/turf/open/floor/wood/large,
/area/misc/survivalpod)
"l" = (
/obj/machinery/shower/directional/south,
/obj/structure/drain,
/obj/effect/turf_decal/siding/end{
	dir = 4
	},
/turf/open/floor/plastic,
/area/misc/survivalpod)
"m" = (
/obj/effect/turf_decal/siding/wood{
	dir = 10
	},
/obj/machinery/button/door/directional/west{
	id = "sauna_shutters"
	},
/turf/open/floor/wood/large,
/area/misc/survivalpod)
"n" = (
/obj/effect/turf_decal/siding/wood{
	dir = 9
	},
/obj/structure/sauna_oven,
/obj/structure/sink/directional/east,
/turf/open/floor/wood/large,
/area/misc/survivalpod)
"o" = (
/obj/machinery/door/airlock/survival_pod/glass,
/obj/structure/fans/tiny,
/turf/open/floor/pod/dark,
/area/misc/survivalpod)
"p" = (
/obj/structure/drain/big,
/turf/open/floor/pod/dark,
/area/misc/survivalpod)
"r" = (
/obj/structure/grille,
/obj/structure/window/reinforced/survival_pod/spawner/directional/south,
/obj/structure/window/reinforced/survival_pod/spawner/directional/west,
/obj/structure/window/reinforced/survival_pod/spawner/directional/east,
/obj/machinery/door/poddoor/shutters/preopen{
	dir = 8;
	id = "sauna_shutters"
	},
/turf/open/floor/pod/dark,
/area/misc/survivalpod)
"s" = (
/obj/effect/turf_decal/siding/wood{
	dir = 4
	},
/obj/structure/chair/sofa/bench{
	dir = 8
	},
/turf/open/floor/wood/large,
/area/misc/survivalpod)
"u" = (
/obj/effect/turf_decal/siding/wood{
	dir = 1
	},
/obj/structure/chair/sofa/bench,
/turf/open/floor/wood/large,
/area/misc/survivalpod)
"y" = (
/obj/effect/turf_decal/siding/wood{
	dir = 5
	},
/obj/structure/chair/sofa/bench/corner,
/turf/open/floor/wood/large,
/area/misc/survivalpod)
"z" = (
/turf/open/floor/pod/dark,
/area/misc/survivalpod)
"B" = (
/obj/machinery/light/directional/east,
/turf/open/floor/pod/dark,
/area/misc/survivalpod)
"C" = (
/obj/structure/grille,
/obj/structure/window/reinforced/survival_pod/spawner/directional/north,
/obj/structure/window/reinforced/survival_pod/spawner/directional/west,
/obj/structure/window/reinforced/survival_pod/spawner/directional/east,
/turf/open/floor/pod/dark,
/area/misc/survivalpod)
"D" = (
/obj/effect/turf_decal/siding/wood{
	dir = 1
	},
/obj/structure/chair/sofa/bench/right,
/turf/open/floor/wood/large,
/area/misc/survivalpod)
"E" = (
/obj/structure/fans/tiny,
/turf/open/floor/wood/stairs,
/area/misc/survivalpod)
"F" = (
/turf/closed/wall/mineral/titanium/survival/nodiagonal,
/area/misc/survivalpod)
"G" = (
/obj/effect/turf_decal/siding/wood{
	dir = 8
	},
/turf/open/floor/wood/large,
/area/misc/survivalpod)
"I" = (
/obj/structure/table/reinforced/plastitaniumglass,
/turf/open/floor/pod/dark,
/area/misc/survivalpod)
"L" = (
/obj/structure/chair/sofa/corp/corner{
	dir = 1
	},
/turf/open/floor/pod/dark,
/area/misc/survivalpod)
"N" = (
/obj/machinery/light/directional/north,
/obj/effect/turf_decal/siding/wood{
	dir = 1
	},
/obj/structure/chair/sofa/bench,
/turf/open/floor/wood/large,
/area/misc/survivalpod)
"O" = (
/obj/structure/window/reinforced/survival_pod/spawner/directional/south,
/obj/effect/turf_decal/siding/wood{
	dir = 6
	},
/obj/structure/chair/sofa/bench/left{
	dir = 8
	},
/turf/open/floor/wood/large,
/area/misc/survivalpod)
"P" = (
/obj/structure/chair/sofa/corp{
	dir = 1
	},
/turf/open/floor/pod/dark,
/area/misc/survivalpod)
"Q" = (
/obj/effect/spawner/liquids_spawner{
	reagent_list = list(/datum/reagent/water=250)
	},
/turf/open/floor/iron/pool/cobble/corner{
	dir = 1
	},
/area/misc/survivalpod)
"R" = (
/obj/structure/closet/secure_closet/personal,
/obj/item/towel,
/turf/open/floor/pod/dark,
/area/misc/survivalpod)
"S" = (
/obj/structure/chair/sofa/corp/left{
	dir = 4
	},
/turf/open/floor/pod/dark,
/area/misc/survivalpod)
"V" = (
/obj/machinery/light/directional/north,
/obj/effect/turf_decal/siding/wood{
	dir = 1
	},
/obj/structure/table/wood,
/obj/item/stack/sheet/mineral/wood/fifty{
	pixel_x = 5;
	pixel_y = 3
	},
/obj/item/reagent_containers/cup/bucket/wooden{
	pixel_x = -9
	},
/turf/open/floor/wood/large,
/area/misc/survivalpod)
"W" = (
/obj/structure/grille,
/obj/structure/window/reinforced/survival_pod/spawner/directional/north,
/obj/structure/window/reinforced/survival_pod/spawner/directional/west,
/obj/structure/window/reinforced/survival_pod/spawner/directional/east,
/obj/machinery/door/poddoor/shutters/preopen{
	dir = 8;
	id = "sauna_shutters"
	},
/turf/open/floor/pod/dark,
/area/misc/survivalpod)
"Y" = (
/obj/structure/window/reinforced/survival_pod/spawner/directional/south,
/obj/structure/grille,
/obj/structure/window/reinforced/survival_pod/spawner/directional/north,
/obj/structure/window/reinforced/survival_pod/spawner/directional/west,
/obj/machinery/door/poddoor/shutters/preopen{
	id = "sauna_shutters"
	},
/turf/open/floor/pod/dark,
/area/misc/survivalpod)
"Z" = (
/obj/structure/window/reinforced/survival_pod/spawner/directional/south,
/obj/effect/turf_decal/siding/wood,
/obj/effect/spawner/liquids_spawner{
	reagent_list = list(/datum/reagent/water=250)
	},
/turf/open/floor/iron/pool/cobble/corner{
	dir = 8
	},
/area/misc/survivalpod)

(1,1,1) = {"
F
F
W
r
F
F
F
F
F
F
"}
(2,1,1) = {"
F
n
G
G
m
E
i
S
L
F
"}
(3,1,1) = {"
F
V
k
k
a
b
z
I
P
Y
"}
(4,1,1) = {"
F
D
k
k
a
l
z
I
h
e
"}
(5,1,1) = {"
F
u
k
k
a
R
z
z
z
c
"}
(6,1,1) = {"
F
u
k
Q
Z
R
z
z
z
F
"}
(7,1,1) = {"
F
u
k
g
d
R
z
p
z
F
"}
(8,1,1) = {"
F
N
k
k
a
R
z
z
z
o
"}
(9,1,1) = {"
F
y
s
s
O
R
B
z
z
F
"}
(10,1,1) = {"
F
F
C
f
F
F
F
F
F
F
"}
