//MAP CONVERTED BY dmm2tgm.py THIS HEADER COMMENT PREVENTS RECONVERSION, DO NOT REMOVE
"a" = (
/obj/machinery/door/window/survival_pod/left/directional/south,
/turf/open/floor/pod/light,
/area/misc/survivalpod)
"d" = (
/obj/machinery/light/floor,
/turf/open/floor/pod/light,
/area/misc/survivalpod)
"k" = (
/obj/machinery/door/window/survival_pod/left/directional/north,
/turf/open/floor/pod/light,
/area/misc/survivalpod)
"l" = (
/obj/effect/turf_decal/siding/dark_green{
	dir = 10
	},
/obj/structure/window/reinforced/survival_pod/spawner/directional/east,
/obj/structure/window/reinforced/survival_pod/spawner/directional/north,
/obj/machinery/hydroponics/constructable,
/turf/open/floor/pod/dark,
/area/misc/survivalpod)
"q" = (
/obj/machinery/door/window/survival_pod/left/directional/east,
/turf/open/floor/pod/light,
/area/misc/survivalpod)
"r" = (
/obj/effect/turf_decal/siding/dark_green{
	dir = 9
	},
/obj/structure/window/reinforced/survival_pod/spawner/directional/east,
/obj/structure/window/reinforced/survival_pod/spawner/directional/south,
/obj/machinery/hydroponics/constructable,
/turf/open/floor/pod/dark,
/area/misc/survivalpod)
"t" = (
/obj/effect/turf_decal/siding/dark_green{
	dir = 5
	},
/obj/structure/window/reinforced/survival_pod/spawner/directional/west,
/obj/structure/window/reinforced/survival_pod/spawner/directional/south,
/obj/machinery/hydroponics/constructable,
/turf/open/floor/pod/dark,
/area/misc/survivalpod)
"E" = (
/obj/effect/turf_decal/siding/dark_green{
	dir = 6
	},
/obj/structure/window/reinforced/survival_pod/spawner/directional/west,
/obj/structure/window/reinforced/survival_pod/spawner/directional/north,
/obj/machinery/hydroponics/constructable,
/turf/open/floor/pod/dark,
/area/misc/survivalpod)
"T" = (
/obj/machinery/door/window/survival_pod/left/directional/west,
/turf/open/floor/pod/light,
/area/misc/survivalpod)

(1,1,1) = {"
E
T
t
"}
(2,1,1) = {"
k
d
a
"}
(3,1,1) = {"
l
q
r
"}
