"j" = (/obj/structure/window/reinforced/survival_pod/spawner/directional/west,/obj/structure/window/reinforced/survival_pod/spawner/directional/south,/obj/machinery/atmospherics/pipe/smart/manifold/cyan,/turf/open/floor/pod/dark,/area/misc/survivalpod)
"k" = (/obj/machinery/atmospherics/components/unary/passive_vent{dir = 8},/turf/open/floor/pod/light,/area/misc/survivalpod)
"v" = (/obj/machinery/light/floor,/obj/machinery/atmospherics/components/unary/portables_connector{dir = 8},/obj/item/tank/internals/emergency_oxygen/double,/obj/machinery/portable_atmospherics/pump,/turf/open/floor/pod/light,/area/misc/survivalpod)
"x" = (/obj/structure/window/reinforced/survival_pod/spawner/directional/west,/obj/machinery/atmospherics/components/trinary/filter/atmos/flipped/o2{dir = 1},/turf/open/floor/pod/dark,/area/misc/survivalpod)
"z" = (/obj/structure/fans/tiny,/obj/effect/turf_decal/vg_decals/atmos/oxygen,/turf/open/floor/pod/light,/area/misc/survivalpod)
"C" = (/obj/structure/window/reinforced/survival_pod/spawner/directional/east,/obj/structure/window/reinforced/survival_pod/spawner/directional/south,/obj/machinery/atmospherics/pipe/smart/manifold/cyan,/turf/open/floor/pod/dark,/area/misc/survivalpod)
"U" = (/obj/structure/window/reinforced/survival_pod/spawner/directional/west,/obj/structure/window/reinforced/survival_pod/spawner/directional/north,/obj/machinery/atmospherics/pipe/smart/manifold/cyan,/turf/open/floor/pod/dark,/area/misc/survivalpod)
"Z" = (/obj/structure/window/reinforced/survival_pod/spawner/directional/east,/obj/structure/window/reinforced/survival_pod/spawner/directional/north,/obj/machinery/atmospherics/components/binary/pump/on/cyan{dir = 8},/turf/open/floor/pod/dark,/area/misc/survivalpod)

(1,1,1) = {"
UZk
xvz
jCk
"}
