//MAP CONVERTED BY dmm2tgm.py THIS HEADER COMMENT PREVENTS RECONVERSION, DO NOT REMOVE
"a" = (
/obj/machinery/door/window/survival_pod/left/directional/east,
/turf/open/floor/pod/light,
/area/misc/survivalpod)
"c" = (
/obj/effect/turf_decal/siding/dark_green{
	dir = 6
	},
/obj/structure/window/reinforced/survival_pod/spawner/directional/west,
/obj/structure/window/reinforced/survival_pod/spawner/directional/north,
/obj/machinery/seed_extractor,
/turf/open/floor/pod/dark,
/area/misc/survivalpod)
"d" = (
/obj/effect/turf_decal/siding/dark_green{
	dir = 10
	},
/obj/structure/window/reinforced/survival_pod/spawner/directional/east,
/obj/structure/window/reinforced/survival_pod/spawner/directional/north,
/obj/machinery/vending/hydroseeds{
	onstation = 0
	},
/turf/open/floor/pod/dark,
/area/misc/survivalpod)
"h" = (
/obj/machinery/door/window/survival_pod/left/directional/south,
/turf/open/floor/pod/light,
/area/misc/survivalpod)
"j" = (
/obj/machinery/door/window/survival_pod/left/directional/west,
/turf/open/floor/pod/light,
/area/misc/survivalpod)
"B" = (
/obj/effect/turf_decal/siding/dark_green{
	dir = 5
	},
/obj/structure/window/reinforced/survival_pod/spawner/directional/west,
/obj/structure/window/reinforced/survival_pod/spawner/directional/south,
/obj/machinery/biogenerator,
/turf/open/floor/pod/dark,
/area/misc/survivalpod)
"K" = (
/obj/machinery/light/floor,
/obj/item/cultivator,
/obj/item/shovel/spade,
/obj/item/secateurs,
/obj/item/plant_analyzer,
/obj/item/reagent_containers/cup/bucket/wooden,
/obj/item/storage/bag/plants,
/obj/item/reagent_containers/cup/bottle/nutrient/ez,
/obj/item/survivalcapsule/trays,
/turf/open/floor/pod/light,
/area/misc/survivalpod)
"P" = (
/obj/effect/turf_decal/siding/dark_green{
	dir = 9
	},
/obj/structure/window/reinforced/survival_pod/spawner/directional/east,
/obj/structure/window/reinforced/survival_pod/spawner/directional/south,
/obj/machinery/smartfridge,
/turf/open/floor/pod/dark,
/area/misc/survivalpod)
"X" = (
/obj/machinery/door/window/survival_pod/left/directional/north,
/turf/open/floor/pod/light,
/area/misc/survivalpod)

(1,1,1) = {"
c
j
B
"}
(2,1,1) = {"
X
K
h
"}
(3,1,1) = {"
d
a
P
"}
