"d" = (/obj/machinery/door/window/survival_pod/left/directional/east,/turf/open/floor/pod/light,/area/misc/survivalpod)
"j" = (/obj/effect/turf_decal/siding/dark_green{dir = 5},/obj/structure/window/reinforced/survival_pod/spawner/directional/west,/obj/structure/window/reinforced/survival_pod/spawner/directional/south,/obj/machinery/hydroponics/constructable,/turf/open/floor/pod/dark,/area/misc/survivalpod)
"k" = (/obj/effect/turf_decal/siding/dark_green{dir = 9},/obj/structure/window/reinforced/survival_pod/spawner/directional/east,/obj/structure/window/reinforced/survival_pod/spawner/directional/south,/obj/machinery/hydroponics/constructable,/turf/open/floor/pod/dark,/area/misc/survivalpod)
"l" = (/obj/machinery/door/window/survival_pod/left/directional/west,/turf/open/floor/pod/light,/area/misc/survivalpod)
"v" = (/obj/machinery/light/floor,/turf/open/floor/pod/light,/area/misc/survivalpod)
"x" = (/obj/effect/turf_decal/siding/dark_green{dir = 10},/obj/structure/window/reinforced/survival_pod/spawner/directional/east,/obj/structure/window/reinforced/survival_pod/spawner/directional/north,/obj/machinery/hydroponics/constructable,/turf/open/floor/pod/dark,/area/misc/survivalpod)
"C" = (/obj/machinery/door/window/survival_pod/left/directional/north,/turf/open/floor/pod/light,/area/misc/survivalpod)
"N" = (/obj/machinery/door/window/survival_pod/left/directional/south,/turf/open/floor/pod/light,/area/misc/survivalpod)
"U" = (/obj/effect/turf_decal/siding/dark_green{dir = 6},/obj/structure/window/reinforced/survival_pod/spawner/directional/west,/obj/structure/window/reinforced/survival_pod/spawner/directional/north,/obj/machinery/hydroponics/constructable,/turf/open/floor/pod/dark,/area/misc/survivalpod)

(1,1,1) = {"
UCx
lvd
jNk
"}
