"a" = (/obj/machinery/door/window/survival_pod/left/directional/south,/turf/open/floor/pod/light,/area/misc/survivalpod)
"f" = (/obj/structure/window/reinforced/survival_pod/spawner/directional/west,/turf/open/floor/pod/dark,/area/misc/survivalpod)
"g" = (/turf/open/floor/pod/light,/area/misc/survivalpod)
"l" = (/obj/structure/window/reinforced/survival_pod/spawner/directional/south,/turf/open/floor/pod/dark,/area/misc/survivalpod)
"m" = (/obj/machinery/door/window/survival_pod/left/directional/west,/turf/open/floor/pod/light,/area/misc/survivalpod)
"n" = (/obj/structure/window/reinforced/survival_pod/spawner/directional/east,/obj/structure/window/reinforced/survival_pod/spawner/directional/south,/turf/open/floor/pod/dark,/area/misc/survivalpod)
"r" = (/obj/structure/window/reinforced/survival_pod/spawner/directional/south,/obj/structure/window/reinforced/survival_pod/spawner/directional/west,/turf/open/floor/pod/dark,/area/misc/survivalpod)
"s" = (/obj/machinery/door/window/survival_pod/left/directional/east,/turf/open/floor/pod/light,/area/misc/survivalpod)
"u" = (/turf/open/floor/pod/dark,/area/misc/survivalpod)
"x" = (/obj/structure/window/reinforced/survival_pod/spawner/directional/east,/obj/structure/window/reinforced/survival_pod/spawner/directional/north,/turf/open/floor/pod/dark,/area/misc/survivalpod)
"y" = (/obj/structure/window/reinforced/survival_pod/spawner/directional/east,/turf/open/floor/pod/dark,/area/misc/survivalpod)
"B" = (/obj/machinery/door/window/survival_pod/left/directional/north,/turf/open/floor/pod/light,/area/misc/survivalpod)
"C" = (/obj/machinery/light/floor,/turf/open/floor/pod/light,/area/misc/survivalpod)
"F" = (/obj/structure/window/reinforced/survival_pod/spawner/directional/north,/obj/structure/window/reinforced/survival_pod/spawner/directional/west,/turf/open/floor/pod/dark,/area/misc/survivalpod)
"M" = (/obj/structure/window/reinforced/survival_pod/spawner/directional/north,/turf/open/floor/pod/dark,/area/misc/survivalpod)

(1,1,1) = {"
FBMMBx
mCggCs
fguugy
fguugy
mCggCs
rallan
"}
