"a" = (/obj/machinery/door/window/survival_pod/left/directional/south,/turf/open/floor/pod/light,/area/misc/survivalpod)
"c" = (/obj/structure/window/reinforced/survival_pod/spawner/directional/south,/obj/structure/window/reinforced/survival_pod/spawner/directional/east,/obj/machinery/smartfridge/food,/obj/effect/turf_decal/siding/thinplating_new/light{dir = 9},/turf/open/floor/pod/dark,/area/misc/survivalpod)
"f" = (/obj/structure/window/reinforced/survival_pod/spawner/directional/west,/obj/structure/window/reinforced/survival_pod/spawner/directional/south,/obj/structure/table/reinforced/plastitaniumglass,/obj/effect/turf_decal/siding/thinplating_new/light{dir = 5},/obj/machinery/biogenerator/foodricator,/turf/open/floor/pod/dark,/area/misc/survivalpod)
"h" = (/obj/structure/window/reinforced/survival_pod/spawner/directional/west,/obj/structure/window/reinforced/survival_pod/spawner/directional/north,/obj/structure/table/reinforced/plastitaniumglass,/obj/effect/turf_decal/siding/thinplating_new/light{dir = 6},/obj/machinery/chem_dispenser/frontier_appliance,/turf/open/floor/pod/dark,/area/misc/survivalpod)
"q" = (/obj/machinery/door/window/survival_pod/left/directional/north,/turf/open/floor/pod/light,/area/misc/survivalpod)
"r" = (/obj/structure/window/reinforced/survival_pod/spawner/directional/north,/obj/structure/table/reinforced/plastitaniumglass,/obj/effect/turf_decal/siding/thinplating_new/light{dir = 10},/obj/machinery/griddle/frontier_tabletop,/turf/open/floor/pod/dark,/area/misc/survivalpod)
"v" = (/obj/structure/window/reinforced/survival_pod/spawner/directional/north,/obj/effect/turf_decal/siding/thinplating_new/light{dir = 6},/obj/machinery/oven/range_frontier,/turf/open/floor/pod/dark,/area/misc/survivalpod)
"w" = (/obj/machinery/door/window/survival_pod/left/directional/west,/turf/open/floor/pod/light,/area/misc/survivalpod)
"D" = (/obj/structure/window/reinforced/survival_pod/spawner/directional/south,/obj/effect/turf_decal/siding/thinplating_new/light{dir = 5},/obj/machinery/chem_master/condimaster,/turf/open/floor/pod/dark,/area/misc/survivalpod)
"F" = (/obj/machinery/door/window/survival_pod/left/directional/east,/turf/open/floor/pod/light,/area/misc/survivalpod)
"G" = (/obj/machinery/light/floor,/turf/open/floor/pod/light,/area/misc/survivalpod)
"L" = (/obj/structure/window/reinforced/survival_pod/spawner/directional/south,/obj/structure/table/reinforced/plastitaniumglass,/obj/effect/turf_decal/siding/thinplating_new/light{dir = 9},/obj/machinery/reagentgrinder,/turf/open/floor/pod/dark,/area/misc/survivalpod)
"P" = (/obj/structure/window/reinforced/survival_pod/spawner/directional/north,/obj/structure/window/reinforced/survival_pod/spawner/directional/east,/obj/structure/table/reinforced/plastitaniumglass,/obj/effect/turf_decal/siding/thinplating_new/light{dir = 10},/obj/machinery/microwave/frontier_printed,/turf/open/floor/pod/dark,/area/misc/survivalpod)
"Q" = (/turf/open/floor/pod/light,/area/misc/survivalpod)

(1,1,1) = {"
hqrvqP
wGQQGF
faLDac
"}
