"a" = (/obj/machinery/door/window/survival_pod/left/directional/south,/turf/open/floor/pod/light,/area/misc/survivalpod)
"i" = (/obj/effect/turf_decal/siding/dark_green{dir = 5},/obj/structure/window/reinforced/survival_pod/spawner/directional/west,/obj/structure/window/reinforced/survival_pod/spawner/directional/south,/obj/machinery/biogenerator,/turf/open/floor/pod/dark,/area/misc/survivalpod)
"k" = (/obj/machinery/door/window/survival_pod/left/directional/east,/turf/open/floor/pod/light,/area/misc/survivalpod)
"o" = (/obj/machinery/door/window/survival_pod/left/directional/west,/turf/open/floor/pod/light,/area/misc/survivalpod)
"q" = (/obj/machinery/light/floor,/obj/item/cultivator,/obj/item/shovel/spade,/obj/item/secateurs,/obj/item/plant_analyzer,/obj/item/reagent_containers/cup/bucket/wooden,/obj/item/storage/bag/plants,/obj/item/reagent_containers/cup/bottle/nutrient/ez,/obj/item/survivalcapsule/trays/datum/map_template/shelter/trays,/turf/open/floor/pod/light,/area/misc/survivalpod)
"F" = (/obj/effect/turf_decal/siding/dark_green{dir = 9},/obj/structure/window/reinforced/survival_pod/spawner/directional/east,/obj/structure/window/reinforced/survival_pod/spawner/directional/south,/obj/machinery/smartfridge,/turf/open/floor/pod/dark,/area/misc/survivalpod)
"P" = (/obj/effect/turf_decal/siding/dark_green{dir = 6},/obj/structure/window/reinforced/survival_pod/spawner/directional/west,/obj/structure/window/reinforced/survival_pod/spawner/directional/north,/obj/machinery/seed_extractor,/turf/open/floor/pod/dark,/area/misc/survivalpod)
"Q" = (/obj/machinery/door/window/survival_pod/left/directional/north,/turf/open/floor/pod/light,/area/misc/survivalpod)
"U" = (/obj/effect/turf_decal/siding/dark_green{dir = 10},/obj/structure/window/reinforced/survival_pod/spawner/directional/east,/obj/structure/window/reinforced/survival_pod/spawner/directional/north,/obj/machinery/vending/hydroseeds{onstation = 0},/turf/open/floor/pod/dark,/area/misc/survivalpod)

(1,1,1) = {"
PQU
oqk
iaF
"}
