"a" = (/obj/structure/fans/tiny,/turf/open/floor/pod/dark,/area/misc/survivalpod)

(1,1,1) = {"
a
"}
