//MAP CONVERTED BY dmm2tgm.py THIS HEADER COMMENT PREVENTS RECONVERSION, DO NOT REMOVE
"a" = (
/obj/effect/turf_decal/siding/wood{
	dir = 4
	},
/obj/structure/chair/sofa/bench{
	dir = 8
	},
/turf/open/floor/wood/large,
/area/misc/survivalpod)
"d" = (
/turf/open/floor/pod/dark,
/area/misc/survivalpod)
"e" = (
/obj/machinery/door/airlock/survival_pod/glass,
/obj/structure/fans/tiny,
/turf/open/floor/pod/dark,
/area/misc/survivalpod)
"f" = (
/obj/structure/table/reinforced/plastitaniumglass,
/turf/open/floor/pod/dark,
/area/misc/survivalpod)
"h" = (
/obj/effect/turf_decal/siding/wood{
	dir = 5
	},
/obj/structure/chair/sofa/bench/corner,
/turf/open/floor/wood/large,
/area/misc/survivalpod)
"i" = (
/obj/structure/chair/sofa/corp/left{
	dir = 4
	},
/turf/open/floor/pod/dark,
/area/misc/survivalpod)
"j" = (
/obj/effect/spawner/liquids_spawner{
	reagent_list = list(/datum/reagent/water=250)
	},
/turf/open/floor/iron/pool/cobble/corner,
/area/misc/survivalpod)
"k" = (
/obj/structure/chair/sofa/corp{
	dir = 1
	},
/turf/open/floor/pod/dark,
/area/misc/survivalpod)
"l" = (
/obj/structure/window/reinforced/survival_pod/spawner/directional/south,
/obj/effect/turf_decal/siding/wood{
	dir = 6
	},
/obj/structure/chair/sofa/bench/left{
	dir = 8
	},
/turf/open/floor/wood/large,
/area/misc/survivalpod)
"m" = (
/obj/structure/window/reinforced/survival_pod/spawner/directional/south,
/obj/structure/grille,
/obj/structure/window/reinforced/survival_pod/spawner/directional/north,
/obj/structure/window/reinforced/survival_pod/spawner/directional/east,
/obj/machinery/door/poddoor/shutters/preopen{
	id = "sauna_shutters"
	},
/turf/open/floor/pod/dark,
/area/misc/survivalpod)
"n" = (
/obj/effect/turf_decal/siding/wood{
	dir = 1
	},
/obj/structure/chair/sofa/bench,
/turf/open/floor/wood/large,
/area/misc/survivalpod)
"q" = (
/obj/structure/drain/big,
/turf/open/floor/pod/dark,
/area/misc/survivalpod)
"r" = (
/obj/structure/window/reinforced/survival_pod/spawner/directional/south,
/obj/structure/grille,
/obj/structure/window/reinforced/survival_pod/spawner/directional/north,
/obj/structure/window/reinforced/survival_pod/spawner/directional/west,
/obj/machinery/door/poddoor/shutters/preopen{
	id = "sauna_shutters"
	},
/turf/open/floor/pod/dark,
/area/misc/survivalpod)
"t" = (
/turf/closed/wall/mineral/titanium/survival/nodiagonal,
/area/misc/survivalpod)
"v" = (
/obj/structure/grille,
/obj/structure/window/reinforced/survival_pod/spawner/directional/south,
/obj/structure/window/reinforced/survival_pod/spawner/directional/west,
/obj/structure/window/reinforced/survival_pod/spawner/directional/east,
/obj/machinery/door/poddoor/shutters/preopen{
	dir = 4;
	id = "sauna_shutters"
	},
/turf/open/floor/pod/dark,
/area/misc/survivalpod)
"w" = (
/obj/structure/chair/sofa/corp/right{
	dir = 1
	},
/turf/open/floor/pod/dark,
/area/misc/survivalpod)
"x" = (
/obj/machinery/light/directional/west,
/turf/open/floor/pod/dark,
/area/misc/survivalpod)
"y" = (
/obj/machinery/shower/directional/south,
/obj/structure/drain,
/obj/effect/turf_decal/siding/end{
	dir = 4
	},
/turf/open/floor/plastic,
/area/misc/survivalpod)
"z" = (
/obj/structure/window/reinforced/survival_pod/spawner/directional/south,
/obj/effect/turf_decal/siding/wood,
/obj/effect/spawner/liquids_spawner{
	reagent_list = list(/datum/reagent/water=250)
	},
/turf/open/floor/iron/pool/cobble/corner{
	dir = 4
	},
/area/misc/survivalpod)
"A" = (
/obj/effect/turf_decal/siding/wood{
	dir = 9
	},
/obj/structure/sauna_oven,
/obj/structure/sink/directional/east,
/turf/open/floor/wood/large,
/area/misc/survivalpod)
"B" = (
/obj/structure/closet/secure_closet/personal,
/obj/item/towel,
/turf/open/floor/pod/dark,
/area/misc/survivalpod)
"D" = (
/obj/effect/spawner/liquids_spawner{
	reagent_list = list(/datum/reagent/water=250)
	},
/turf/open/floor/iron/pool/cobble/corner{
	dir = 1
	},
/area/misc/survivalpod)
"H" = (
/obj/machinery/light/directional/north,
/obj/effect/turf_decal/siding/wood{
	dir = 1
	},
/obj/structure/table/wood,
/obj/item/stack/sheet/mineral/wood/fifty{
	pixel_x = 5;
	pixel_y = 3
	},
/obj/item/reagent_containers/cup/bucket/wooden{
	pixel_x = -9
	},
/turf/open/floor/wood/large,
/area/misc/survivalpod)
"I" = (
/obj/machinery/light/directional/north,
/obj/effect/turf_decal/siding/wood{
	dir = 1
	},
/obj/structure/chair/sofa/bench,
/turf/open/floor/wood/large,
/area/misc/survivalpod)
"J" = (
/turf/open/floor/wood/large,
/area/misc/survivalpod)
"K" = (
/obj/structure/grille,
/obj/structure/window/reinforced/survival_pod/spawner/directional/north,
/obj/structure/window/reinforced/survival_pod/spawner/directional/west,
/obj/structure/window/reinforced/survival_pod/spawner/directional/east,
/obj/machinery/door/poddoor/shutters/preopen{
	dir = 4;
	id = "sauna_shutters"
	},
/turf/open/floor/pod/dark,
/area/misc/survivalpod)
"N" = (
/obj/machinery/light/directional/east,
/turf/open/floor/pod/dark,
/area/misc/survivalpod)
"O" = (
/obj/machinery/shower/directional/south,
/obj/structure/drain,
/obj/effect/turf_decal/siding/end{
	dir = 8
	},
/turf/open/floor/plastic,
/area/misc/survivalpod)
"P" = (
/obj/effect/turf_decal/siding/wood{
	dir = 8
	},
/turf/open/floor/wood/large,
/area/misc/survivalpod)
"Q" = (
/obj/structure/window/reinforced/survival_pod/spawner/directional/south,
/obj/effect/turf_decal/siding/wood,
/obj/effect/spawner/liquids_spawner{
	reagent_list = list(/datum/reagent/water=250)
	},
/turf/open/floor/iron/pool/cobble/corner{
	dir = 8
	},
/area/misc/survivalpod)
"R" = (
/obj/structure/grille,
/obj/structure/window/reinforced/survival_pod/spawner/directional/north,
/obj/structure/window/reinforced/survival_pod/spawner/directional/west,
/obj/structure/window/reinforced/survival_pod/spawner/directional/east,
/obj/machinery/door/poddoor/shutters/preopen{
	dir = 8;
	id = "sauna_shutters"
	},
/turf/open/floor/pod/dark,
/area/misc/survivalpod)
"S" = (
/obj/structure/grille,
/obj/structure/window/reinforced/survival_pod/spawner/directional/south,
/obj/structure/window/reinforced/survival_pod/spawner/directional/west,
/obj/structure/window/reinforced/survival_pod/spawner/directional/east,
/obj/machinery/door/poddoor/shutters/preopen{
	dir = 8;
	id = "sauna_shutters"
	},
/turf/open/floor/pod/dark,
/area/misc/survivalpod)
"T" = (
/obj/structure/window/reinforced/survival_pod/spawner/directional/south,
/obj/effect/turf_decal/siding/wood,
/turf/open/floor/wood/large,
/area/misc/survivalpod)
"U" = (
/obj/structure/chair/sofa/corp/corner{
	dir = 1
	},
/turf/open/floor/pod/dark,
/area/misc/survivalpod)
"V" = (
/obj/effect/turf_decal/siding/wood{
	dir = 1
	},
/obj/structure/chair/sofa/bench/right,
/turf/open/floor/wood/large,
/area/misc/survivalpod)
"W" = (
/obj/structure/fans/tiny,
/turf/open/floor/wood/stairs,
/area/misc/survivalpod)
"Y" = (
/obj/effect/turf_decal/siding/wood{
	dir = 10
	},
/obj/machinery/button/door/directional/west{
	id = "sauna_shutters"
	},
/turf/open/floor/wood/large,
/area/misc/survivalpod)
"Z" = (
/obj/structure/window/reinforced/survival_pod/spawner/directional/south,
/obj/structure/grille,
/obj/structure/window/reinforced/survival_pod/spawner/directional/north,
/obj/machinery/door/poddoor/shutters/preopen{
	id = "sauna_shutters"
	},
/turf/open/floor/pod/dark,
/area/misc/survivalpod)

(1,1,1) = {"
t
t
R
S
t
t
t
t
t
t
"}
(2,1,1) = {"
t
A
P
P
Y
W
x
i
U
t
"}
(3,1,1) = {"
t
H
J
J
T
O
d
f
k
r
"}
(4,1,1) = {"
t
V
J
J
T
y
d
f
w
Z
"}
(5,1,1) = {"
t
n
J
J
T
B
d
d
d
m
"}
(6,1,1) = {"
t
n
J
D
Q
B
d
d
d
t
"}
(7,1,1) = {"
t
n
J
j
z
B
d
q
d
t
"}
(8,1,1) = {"
t
I
J
J
T
B
d
d
d
e
"}
(9,1,1) = {"
t
h
a
a
l
B
N
d
d
t
"}
(10,1,1) = {"
t
t
K
v
t
t
t
t
t
t
"}
