//MAP CONVERTED BY dmm2tgm.py THIS HEADER COMMENT PREVENTS RECONVERSION, DO NOT REMOVE
"a" = (
/turf/open/floor/iron/dark/smooth_half,
/area/station/ai_monitored/security/armory)
"b" = (
/obj/machinery/firealarm/directional/south,
/turf/open/floor/iron/dark/smooth_large,
/area/station/ai_monitored/security/armory)
"c" = (
/obj/machinery/atmospherics/pipe/smart/manifold4w/scrubbers/hidden/layer2,
/turf/open/floor/iron/dark/smooth_half,
/area/station/ai_monitored/security/armory)
"e" = (
/obj/machinery/atmospherics/pipe/smart/manifold4w/supply/hidden/layer4,
/obj/machinery/atmospherics/pipe/smart/manifold4w/scrubbers/hidden/layer2,
/turf/open/floor/iron/dark/smooth_large,
/area/station/ai_monitored/security/armory)
"g" = (
/obj/structure/rack,
/obj/item/gun/energy/ionrifle,
/obj/item/clothing/suit/hooded/ablative,
/obj/item/gun/energy/temperature/security,
/turf/open/floor/iron/dark,
/area/station/ai_monitored/security/armory)
"h" = (
/obj/structure/table/reinforced,
/obj/item/clothing/mask/gas/sechailer{
	pixel_x = -3;
	pixel_y = 3
	},
/obj/item/clothing/mask/gas/sechailer,
/obj/item/clothing/mask/gas/sechailer{
	pixel_x = 3;
	pixel_y = -3
	},
/obj/item/flashlight/seclite,
/obj/item/flashlight/seclite,
/obj/item/flashlight/seclite,
/obj/item/storage/box/firingpins,
/obj/item/storage/box/firingpins,
/obj/item/clothing/glasses/hud/security/sunglasses{
	pixel_x = -3;
	pixel_y = -2
	},
/obj/item/clothing/glasses/hud/security/sunglasses{
	pixel_x = -3;
	pixel_y = 2
	},
/turf/open/floor/iron/dark,
/area/station/ai_monitored/security/armory)
"i" = (
/obj/machinery/atmospherics/components/unary/vent_pump/on/layer4{
	dir = 4
	},
/turf/open/floor/iron/dark/smooth_half,
/area/station/ai_monitored/security/armory)
"j" = (
/obj/structure/closet/secure_closet{
	name = "contraband locker";
	req_access = list("armory")
	},
/obj/effect/spawner/random/maintenance/three,
/obj/item/circuitboard/computer/advanced_camera,
/obj/effect/turf_decal/trimline/red/filled/line,
/obj/effect/turf_decal/trimline/red/filled/line{
	dir = 1
	},
/obj/effect/spawner/random/contraband/armory,
/obj/effect/turf_decal/bot,
/turf/open/floor/iron/dark,
/area/station/ai_monitored/security/armory)
"k" = (
/obj/effect/turf_decal/trimline/red/filled/line,
/obj/effect/turf_decal/trimline/red/filled/line{
	dir = 1
	},
/obj/machinery/atmospherics/pipe/smart/manifold4w/supply/hidden/layer4,
/obj/machinery/atmospherics/pipe/smart/manifold4w/scrubbers/hidden/layer2,
/obj/structure/rack,
/obj/item/gun/energy/laser{
	pixel_x = -3;
	pixel_y = 3
	},
/obj/item/gun/energy/laser,
/obj/item/gun/energy/laser{
	pixel_x = 3;
	pixel_y = -3
	},
/turf/open/floor/iron/dark,
/area/station/ai_monitored/security/armory)
"m" = (
/turf/open/floor/iron/dark/smooth_large,
/area/station/ai_monitored/security/armory)
"o" = (
/obj/structure/rack,
/obj/item/gun/energy/e_gun/dragnet,
/obj/item/gun/energy/e_gun/dragnet,
/obj/effect/turf_decal/trimline/blue/filled/line,
/obj/effect/turf_decal/trimline/blue/filled/line{
	dir = 1
	},
/turf/open/floor/iron/dark,
/area/station/ai_monitored/security/armory)
"p" = (
/obj/machinery/atmospherics/pipe/smart/manifold4w/supply/hidden/layer4,
/turf/open/floor/iron/dark/smooth_half,
/area/station/ai_monitored/security/armory)
"q" = (
/obj/machinery/atmospherics/components/unary/vent_scrubber/on/layer2{
	dir = 4
	},
/obj/structure/rack,
/obj/effect/spawner/armory_spawn/shotguns,
/obj/effect/turf_decal/trimline/red/filled/line,
/obj/effect/turf_decal/trimline/red/filled/line{
	dir = 1
	},
/turf/open/floor/iron/dark/smooth_half,
/area/station/ai_monitored/security/armory)
"r" = (
/obj/effect/turf_decal/trimline/red/filled/line,
/obj/effect/turf_decal/trimline/red/filled/line{
	dir = 1
	},
/obj/machinery/atmospherics/pipe/smart/manifold4w/supply/hidden/layer4,
/obj/machinery/atmospherics/pipe/smart/manifold4w/scrubbers/hidden/layer2,
/obj/structure/rack,
/obj/item/gun/energy/e_gun{
	pixel_x = -3;
	pixel_y = 3
	},
/obj/item/gun/energy/e_gun,
/obj/item/gun/energy/e_gun{
	pixel_x = 3;
	pixel_y = -3
	},
/turf/open/floor/iron/dark,
/area/station/ai_monitored/security/armory)
"s" = (
/obj/structure/rack,
/obj/item/clothing/suit/armor/bulletproof{
	pixel_x = -3;
	pixel_y = 3
	},
/obj/item/clothing/suit/armor/bulletproof,
/obj/item/clothing/suit/armor/bulletproof{
	pixel_x = 3;
	pixel_y = -3
	},
/obj/item/clothing/head/helmet/alt{
	pixel_x = -3;
	pixel_y = 3
	},
/obj/item/clothing/head/helmet/alt,
/obj/item/clothing/head/helmet/alt{
	pixel_x = 3;
	pixel_y = -3
	},
/obj/effect/turf_decal/trimline/blue/filled/line,
/obj/machinery/light/directional/north,
/obj/item/radio/intercom/directional/north,
/obj/effect/turf_decal/trimline/blue/filled/line{
	dir = 1
	},
/turf/open/floor/iron/dark,
/area/station/ai_monitored/security/armory)
"w" = (
/obj/effect/turf_decal/trimline/blue/filled/line,
/obj/effect/turf_decal/trimline/blue/filled/line{
	dir = 1
	},
/obj/structure/closet/secure_closet/armory_kiboko,
/obj/item/ammo_box/c980grenade/riot,
/obj/item/ammo_box/c980grenade/smoke,
/obj/effect/turf_decal/bot,
/turf/open/floor/iron/dark,
/area/station/ai_monitored/security/armory)
"x" = (
/obj/machinery/flasher/portable,
/turf/open/floor/iron/dark/smooth_large,
/area/station/ai_monitored/security/armory)
"z" = (
/obj/effect/turf_decal/trimline/blue/filled/line,
/obj/effect/turf_decal/trimline/blue/filled/line{
	dir = 1
	},
/obj/structure/closet/secure_closet/armory2,
/obj/item/storage/box/rubbershot,
/obj/item/storage/box/rubbershot,
/obj/item/storage/box/rubbershot,
/obj/effect/turf_decal/bot,
/turf/open/floor/iron/dark,
/area/station/ai_monitored/security/armory)
"B" = (
/obj/structure/rack,
/obj/item/grenade/barrier{
	pixel_x = -3;
	pixel_y = 1
	},
/obj/item/grenade/barrier,
/obj/item/grenade/barrier{
	pixel_x = 3;
	pixel_y = -1
	},
/obj/item/grenade/barrier{
	pixel_x = 6;
	pixel_y = -2
	},
/obj/effect/turf_decal/trimline/blue/filled/line,
/obj/effect/turf_decal/trimline/blue/filled/line{
	dir = 1
	},
/obj/machinery/atmospherics/pipe/smart/manifold4w/scrubbers/hidden/layer2,
/turf/open/floor/iron/dark,
/area/station/ai_monitored/security/armory)
"C" = (
/obj/machinery/camera{
	c_tag = "Security - Armory Interior";
	dir = 10;
	network = list("ss13","prison")
	},
/obj/structure/reagent_dispensers/wall/peppertank/directional/west,
/turf/open/floor/iron/dark/smooth_large,
/area/station/ai_monitored/security/armory)
"E" = (
/obj/effect/turf_decal/trimline/red/filled/line,
/obj/effect/turf_decal/trimline/red/filled/line{
	dir = 1
	},
/obj/machinery/atmospherics/pipe/smart/manifold4w/supply/hidden/layer4,
/obj/machinery/atmospherics/pipe/smart/manifold4w/scrubbers/hidden/layer2,
/obj/structure/rack,
/obj/item/gun/energy/disabler{
	pixel_x = -3;
	pixel_y = 3
	},
/obj/item/gun/energy/disabler,
/obj/item/gun/energy/disabler{
	pixel_x = 3;
	pixel_y = -3
	},
/turf/open/floor/iron/dark,
/area/station/ai_monitored/security/armory)
"F" = (
/obj/machinery/flasher/portable,
/obj/structure/cable,
/obj/machinery/power/apc/auto_name/directional/east,
/turf/open/floor/iron/dark/smooth_large,
/area/station/ai_monitored/security/armory)
"H" = (
/obj/effect/landmark/event_spawn,
/turf/open/floor/iron/dark/smooth_large,
/area/station/ai_monitored/security/armory)
"I" = (
/obj/item/storage/box/chemimp{
	pixel_x = 6
	},
/obj/item/storage/box/trackimp{
	pixel_x = -3
	},
/obj/item/storage/lockbox/loyalty,
/obj/structure/table/reinforced,
/turf/open/floor/iron/dark,
/area/station/ai_monitored/security/armory)
"J" = (
/obj/structure/rack,
/obj/item/clothing/suit/armor/riot{
	pixel_x = -3;
	pixel_y = 3
	},
/obj/item/clothing/suit/armor/riot,
/obj/item/clothing/suit/armor/riot{
	pixel_x = 3;
	pixel_y = -3
	},
/obj/item/clothing/head/helmet/toggleable/riot{
	pixel_x = -3;
	pixel_y = 3
	},
/obj/item/clothing/head/helmet/toggleable/riot,
/obj/item/clothing/head/helmet/toggleable/riot{
	pixel_x = 3;
	pixel_y = -3
	},
/obj/item/shield/riot{
	pixel_x = -3;
	pixel_y = 3
	},
/obj/item/shield/riot,
/obj/item/shield/riot{
	pixel_x = 3;
	pixel_y = -3
	},
/obj/effect/turf_decal/trimline/blue/filled/line,
/obj/effect/turf_decal/trimline/blue/filled/line{
	dir = 1
	},
/turf/open/floor/iron/dark,
/area/station/ai_monitored/security/armory)
"K" = (
/obj/structure/cable,
/obj/vehicle/ridden/secway,
/turf/open/floor/iron/dark/smooth_large,
/area/station/ai_monitored/security/armory)
"L" = (
/obj/machinery/airalarm/directional/west,
/turf/open/floor/iron/dark/smooth_large,
/area/station/ai_monitored/security/armory)
"M" = (
/obj/machinery/atmospherics/pipe/smart/manifold4w/supply/hidden/layer4,
/obj/machinery/atmospherics/pipe/smart/manifold4w/scrubbers/hidden/layer2,
/mob/living/simple_animal/bot/secbot/beepsky/armsky,
/turf/open/floor/iron/dark/smooth_large,
/area/station/ai_monitored/security/armory)
"N" = (
/obj/machinery/flasher/portable,
/obj/structure/cable,
/turf/open/floor/iron/dark/smooth_large,
/area/station/ai_monitored/security/armory)
"R" = (
/obj/machinery/light/directional/south,
/obj/machinery/atmospherics/pipe/smart/manifold4w/scrubbers/hidden/layer2,
/obj/structure/rack,
/obj/effect/spawner/armory_spawn/smg,
/obj/effect/turf_decal/trimline/red/filled/line,
/obj/effect/turf_decal/trimline/red/filled/line{
	dir = 1
	},
/turf/open/floor/iron/dark/smooth_half,
/area/station/ai_monitored/security/armory)
"T" = (
/obj/structure/rack,
/obj/item/storage/box/flashbangs{
	pixel_x = 3;
	pixel_y = -3
	},
/obj/item/storage/box/handcuffs,
/obj/item/storage/box/teargas{
	pixel_x = -3;
	pixel_y = 3
	},
/obj/item/key/security,
/obj/effect/turf_decal/trimline/blue/filled/line,
/obj/effect/turf_decal/trimline/blue/filled/line{
	dir = 1
	},
/turf/open/floor/iron/dark,
/area/station/ai_monitored/security/armory)
"U" = (
/obj/structure/rack,
/obj/item/clothing/suit/armor/vest{
	pixel_x = -3;
	pixel_y = 3
	},
/obj/item/clothing/suit/armor/vest,
/obj/item/clothing/suit/armor/vest{
	pixel_x = 3;
	pixel_y = -3
	},
/obj/item/clothing/head/helmet{
	pixel_x = -3;
	pixel_y = 3
	},
/obj/item/clothing/head/helmet,
/obj/item/clothing/head/helmet{
	pixel_x = 3;
	pixel_y = -3
	},
/obj/effect/turf_decal/trimline/blue/filled/line,
/obj/effect/turf_decal/trimline/blue/filled/line{
	dir = 1
	},
/turf/open/floor/iron/dark,
/area/station/ai_monitored/security/armory)
"X" = (
/turf/closed/wall/r_wall,
/area/station/ai_monitored/security/armory)
"Z" = (
/obj/structure/rack,
/obj/effect/turf_decal/trimline/red/filled/line,
/obj/effect/turf_decal/trimline/red/filled/line{
	dir = 1
	},
/turf/open/floor/iron/dark/smooth_half,
/area/station/ai_monitored/security/armory)

(1,1,1) = {"
X
X
g
I
h
X
"}
(2,1,1) = {"
m
C
m
m
m
L
"}
(3,1,1) = {"
J
i
j
z
a
q
"}
(4,1,1) = {"
s
p
r
B
c
R
"}
(5,1,1) = {"
U
a
k
o
a
Z
"}
(6,1,1) = {"
T
a
E
w
a
Z
"}
(7,1,1) = {"
m
m
M
m
H
b
"}
(8,1,1) = {"
K
x
e
m
N
F
"}
