//MAP CONVERTED BY dmm2tgm.py THIS HEADER COMMENT PREVENTS RECONVERSION, DO NOT REMOVE
"a" = (
/obj/structure/cable,
/obj/machinery/atmospherics/pipe/smart/manifold4w/supply/hidden/layer4,
/obj/machinery/atmospherics/pipe/smart/manifold4w/scrubbers/hidden/layer2,
/obj/effect/turf_decal/tile/yellow{
	dir = 1
	},
/turf/open/floor/iron,
/area/station/hallway/primary/port)
"b" = (
/obj/machinery/computer/crew{
	dir = 1
	},
/obj/effect/turf_decal/siding/dark{
	dir = 1
	},
/obj/machinery/airalarm/directional/south,
/obj/structure/sign/calendar/directional/west,
/obj/machinery/camera/directional/south{
	c_tag = "Blueshield's Office"
	},
/turf/open/floor/iron/dark/textured,
/area/station/command/heads_quarters/blueshield)
"c" = (
/obj/effect/turf_decal/tile/neutral/fourcorners,
/obj/machinery/atmospherics/pipe/smart/manifold4w/scrubbers/hidden/layer2,
/obj/structure/cable,
/obj/machinery/atmospherics/pipe/smart/manifold4w/supply/hidden/layer4,
/turf/open/floor/iron,
/area/station/hallway/primary/port)
"d" = (
/obj/effect/turf_decal/delivery/red,
/obj/structure/window/reinforced/spawner/directional/east,
/obj/structure/closet/secure_closet/tac{
	req_access = list("captain")
	},
/obj/item/gun_maintenance_supplies,
/obj/item/clothing/suit/armor/riot,
/obj/item/clothing/head/helmet/toggleable/riot{
	pixel_y = 6
	},
/obj/item/ammo_box/magazine/wt550m9,
/obj/item/screwdriver,
/obj/item/shield/riot,
/obj/item/storage/toolbox/ammobox/wt550m9,
/turf/open/floor/iron/dark/textured,
/area/station/command/heads_quarters/blueshield)
"e" = (
/obj/effect/landmark/start/blueshield,
/turf/open/floor/wood,
/area/station/command/heads_quarters/blueshield)
"f" = (
/obj/machinery/modular_computer/preset/command{
	dir = 8
	},
/obj/effect/mapping_helpers/requests_console/information,
/obj/effect/mapping_helpers/requests_console/supplies,
/obj/effect/mapping_helpers/requests_console/assistance,
/obj/effect/mapping_helpers/requests_console/announcement,
/obj/effect/turf_decal/bot,
/obj/machinery/requests_console/auto_name/directional/east,
/turf/open/floor/carpet/blue,
/area/station/command/heads_quarters/blueshield)
"g" = (
/obj/structure/table/wood/fancy/blue,
/obj/item/storage/box/coffeepack{
	pixel_x = -5
	},
/obj/machinery/coffeemaker/impressa{
	pixel_x = 1;
	pixel_y = 8
	},
/obj/item/reagent_containers/cup/glass/mug/nanotrasen{
	pixel_x = 7
	},
/obj/structure/reagent_dispensers/wall/peppertank/directional/east,
/obj/structure/sign/clock/directional/north,
/turf/open/floor/wood,
/area/station/command/heads_quarters/blueshield)
"j" = (
/obj/machinery/door/airlock/highsecurity{
	name = "Blueshield's Quarters"
	},
/obj/effect/mapping_helpers/airlock/access/all/command/captain,
/obj/effect/mapping_helpers/airlock/access/all/command/captain,
/obj/effect/turf_decal/tile/dark_blue/opposingcorners,
/obj/effect/turf_decal/siding/dark/corner{
	dir = 8
	},
/obj/effect/turf_decal/siding/dark{
	dir = 4
	},
/obj/machinery/atmospherics/pipe/smart/manifold4w/scrubbers/hidden/layer2,
/obj/machinery/atmospherics/pipe/smart/manifold4w/supply/hidden/layer4,
/turf/open/floor/iron/dark,
/area/station/command/heads_quarters/blueshield)
"k" = (
/obj/machinery/vending/wallmed/directional/east,
/obj/machinery/light/directional/east,
/obj/machinery/atmospherics/components/unary/vent_scrubber/on/layer2,
/turf/open/floor/wood,
/area/station/command/heads_quarters/blueshield)
"l" = (
/obj/structure/table/wood,
/obj/machinery/fax{
	name = "Blueshield's Fax Machine";
	fax_name = "Blueshield's Office"
	},
/obj/item/radio/intercom/directional/east,
/turf/open/floor/carpet/blue,
/area/station/command/heads_quarters/blueshield)
"m" = (
/obj/structure/chair/office{
	dir = 1
	},
/obj/machinery/atmospherics/components/unary/vent_pump/on/layer4{
	dir = 1
	},
/obj/effect/landmark/start/blueshield,
/turf/open/floor/carpet/blue,
/area/station/command/heads_quarters/blueshield)
"n" = (
/obj/machinery/atmospherics/pipe/smart/manifold4w/scrubbers/hidden/layer2,
/obj/structure/chair/sofa/corp/right,
/obj/effect/turf_decal/tile/dark_blue/opposingcorners,
/obj/effect/landmark/start/blueshield,
/obj/machinery/power/apc/auto_name/directional/west,
/obj/structure/cable,
/turf/open/floor/iron/dark,
/area/station/command/heads_quarters/blueshield)
"o" = (
/obj/machinery/computer/records/medical{
	dir = 1
	},
/obj/effect/turf_decal/siding/dark{
	dir = 5
	},
/obj/machinery/light/directional/south,
/obj/structure/sign/plaques/kiddie/perfect_man{
	pixel_y = -32
	},
/turf/open/floor/iron/dark/textured,
/area/station/command/heads_quarters/blueshield)
"p" = (
/obj/machinery/door/airlock/corporate{
	id_tag = "BSdoor";
	name = "Blueshield's Office"
	},
/obj/effect/mapping_helpers/airlock/access/any/cent_com/rep_or_captain,
/obj/machinery/atmospherics/pipe/smart/manifold4w/scrubbers/hidden/layer2,
/obj/machinery/atmospherics/pipe/smart/manifold4w/supply/hidden/layer4,
/obj/structure/cable,
/obj/machinery/door/firedoor,
/obj/effect/landmark/navigate_destination,
/turf/open/floor/iron,
/area/station/command/heads_quarters/blueshield)
"q" = (
/obj/effect/turf_decal/tile/neutral{
	dir = 8
	},
/obj/structure/sign/nanotrasen/directional/south,
/obj/machinery/light/directional/south,
/turf/open/floor/iron,
/area/station/hallway/primary/port)
"r" = (
/obj/structure/table/wood/fancy/blue,
/obj/machinery/computer/security/wooden_tv{
	pixel_y = 10
	},
/obj/item/book/manual/wiki/security_space_law{
	pixel_y = 3;
	pixel_x = 7
	},
/obj/structure/sign/poster/official/obey/directional/south,
/turf/open/floor/carpet/blue,
/area/station/command/heads_quarters/blueshield)
"t" = (
/obj/structure/bed,
/obj/item/bedsheet/nanotrasen,
/obj/structure/secure_safe/directional/south,
/obj/machinery/light/small/directional/south,
/turf/open/floor/carpet/blue,
/area/station/command/heads_quarters/blueshield)
"u" = (
/obj/effect/turf_decal/tile/neutral{
	dir = 8
	},
/turf/open/floor/iron,
/area/station/hallway/primary/port)
"v" = (
/turf/template_noop,
/area/template_noop)
"w" = (
/obj/structure/chair/comfy/black{
	dir = 1
	},
/obj/effect/landmark/start/blueshield,
/turf/open/floor/wood,
/area/station/command/heads_quarters/blueshield)
"y" = (
/turf/closed/wall/r_wall,
/area/station/command/heads_quarters/blueshield)
"A" = (
/obj/machinery/atmospherics/pipe/smart/manifold4w/supply/hidden/layer4,
/obj/effect/turf_decal/tile/dark_blue/opposingcorners,
/obj/machinery/holopad,
/obj/effect/landmark/start/blueshield,
/turf/open/floor/iron/dark,
/area/station/command/heads_quarters/blueshield)
"B" = (
/obj/machinery/photocopier/prebuilt,
/obj/effect/turf_decal/bot,
/obj/machinery/newscaster/directional/south,
/turf/open/floor/carpet/blue,
/area/station/command/heads_quarters/blueshield)
"C" = (
/obj/effect/spawner/structure/window/reinforced,
/obj/machinery/door/poddoor/shutters/preopen{
	id = "bs_priv";
	name = "Privacy Shutters"
	},
/obj/structure/cable,
/turf/open/floor/plating,
/area/station/command/heads_quarters/blueshield)
"D" = (
/obj/structure/table,
/obj/item/stock_parts/power_store/cell/high,
/obj/item/stock_parts/power_store/cell/high,
/obj/machinery/cell_charger,
/obj/structure/extinguisher_cabinet/directional/west,
/turf/open/floor/iron,
/area/station/science/robotics/mechbay)
"F" = (
/obj/machinery/atmospherics/pipe/smart/manifold4w/scrubbers/hidden/layer2,
/obj/machinery/atmospherics/pipe/smart/manifold4w/supply/hidden/layer4,
/turf/open/floor/wood,
/area/station/command/heads_quarters/blueshield)
"H" = (
/obj/machinery/atmospherics/components/unary/vent_scrubber/on/layer2{
	dir = 1
	},
/obj/effect/turf_decal/tile/dark_blue/opposingcorners,
/obj/machinery/firealarm/directional/east,
/turf/open/floor/iron/dark,
/area/station/command/heads_quarters/blueshield)
"I" = (
/obj/machinery/atmospherics/components/unary/vent_pump/on/layer4{
	dir = 4
	},
/obj/effect/landmark/start/blueshield,
/turf/open/floor/carpet/blue,
/area/station/command/heads_quarters/blueshield)
"J" = (
/obj/structure/dresser,
/obj/machinery/light_switch/directional/east,
/obj/item/modular_computer/laptop/preset/security{
	pixel_y = 8
	},
/obj/machinery/firealarm/directional/south,
/turf/open/floor/carpet/blue,
/area/station/command/heads_quarters/blueshield)
"K" = (
/obj/machinery/atmospherics/pipe/smart/manifold4w/scrubbers/hidden/layer2,
/obj/machinery/atmospherics/pipe/smart/manifold4w/supply/hidden/layer4,
/turf/open/floor/carpet/blue,
/area/station/command/heads_quarters/blueshield)
"O" = (
/obj/structure/safe/abovetilefloor,
/obj/item/reagent_containers/cup/glass/trophy{
	desc = "You did good in the worst way possible.";
	name = "Redshield 1st prize";
	pixel_y = 9;
	pixel_x = -2
	},
/obj/item/storage/medkit/tactical/blueshield,
/obj/item/reagent_containers/cup/glass/flask{
	pixel_y = -2;
	pixel_x = 2
	},
/obj/item/toy/figure/captain,
/obj/item/storage/fancy/cigarettes/cigars,
/obj/item/storage/box/matches,
/obj/item/reagent_containers/cup/glass/bottle/lizardwine,
/obj/item/paperwork/captain{
	pixel_x = -3;
	pixel_y = 4;
	name = "Asset Protection case records";
	desc = "A messily compiled stack of DAP records, containing incident reports, asset recovery briefings and classified paramilitary activities, with substantial portions censored and redacted. You probably shouldn't be reading this, unless you yearn for a one-way trip to Space Guantanamo."
	},
/obj/machinery/button/door/directional/west{
	pixel_x = -32;
	pixel_y = 4;
	id = "bs_priv";
	name = "Office Shutters Control"
	},
/obj/machinery/light_switch/directional/west{
	pixel_x = -23;
	pixel_y = 1
	},
/turf/open/floor/carpet/blue,
/area/station/command/heads_quarters/blueshield)
"P" = (
/obj/effect/turf_decal/delivery/red,
/obj/machinery/door/window/brigdoor/right/directional/east{
	req_access = list("captain");
	name = "Blueshield's Armory"
	},
/obj/structure/closet/secure_closet/blueshield,
/obj/item/taperecorder{
	name = "Captain's Log"
	},
/obj/item/dog_bone,
/obj/item/clothing/gloves/tackler/combat/insulated/blueshield,
/obj/structure/sign/flag/nanotrasen/directional/west,
/obj/machinery/light/small/blacklight/directional/west,
/turf/open/floor/iron/dark/textured,
/area/station/command/heads_quarters/blueshield)
"Q" = (
/obj/machinery/suit_storage_unit/security,
/obj/structure/window/reinforced/spawner/directional/south,
/obj/effect/turf_decal/delivery/red,
/obj/structure/window/reinforced/spawner/directional/east,
/turf/open/floor/iron/dark/textured,
/area/station/command/heads_quarters/blueshield)
"R" = (
/obj/effect/turf_decal/tile/neutral{
	dir = 8
	},
/obj/structure/extinguisher_cabinet/directional/south,
/turf/open/floor/iron,
/area/station/hallway/primary/port)
"S" = (
/obj/machinery/atmospherics/pipe/smart/manifold4w/scrubbers/hidden/layer2,
/obj/machinery/atmospherics/pipe/smart/manifold4w/supply/hidden/layer4,
/obj/structure/cable,
/obj/effect/turf_decal/tile/dark_blue/opposingcorners,
/obj/machinery/light_switch/directional/east,
/turf/open/floor/iron/dark,
/area/station/command/heads_quarters/blueshield)
"T" = (
/obj/structure/table/wood,
/obj/machinery/atmospherics/pipe/smart/manifold4w/supply/hidden/layer4,
/obj/machinery/recharger{
	pixel_x = 7;
	pixel_y = 6
	},
/obj/item/paper_bin{
	pixel_y = 4;
	pixel_x = -5
	},
/obj/item/pen/fourcolor{
	pixel_x = -5;
	pixel_y = 5
	},
/obj/effect/mapping_helpers/turn_off_lights_with_lightswitch,
/obj/effect/landmark/start/blueshield,
/turf/open/floor/carpet/blue,
/area/station/command/heads_quarters/blueshield)
"V" = (
/obj/machinery/atmospherics/pipe/smart/manifold4w/supply/hidden/layer4,
/obj/structure/bed/dogbed{
	name = "Walter's Dogbed"
	},
/mob/living/basic/pet/dog/dobermann/walter,
/obj/item/toy/figure/syndie{
	pixel_x = 9;
	pixel_y = -2;
	name = "\improper chewed up Redsuit action figure"
	},
/turf/open/floor/carpet/blue,
/area/station/command/heads_quarters/blueshield)
"W" = (
/obj/structure/table/wood/fancy/blue,
/obj/item/flashlight/lamp{
	pixel_x = -4;
	pixel_y = 13
	},
/turf/open/floor/wood,
/area/station/command/heads_quarters/blueshield)
"X" = (
/obj/machinery/atmospherics/pipe/smart/manifold4w/scrubbers/hidden/layer2,
/obj/effect/turf_decal/tile/neutral{
	dir = 8
	},
/obj/structure/cable,
/obj/machinery/atmospherics/pipe/smart/manifold4w/supply/hidden/layer4,
/turf/open/floor/iron,
/area/station/hallway/primary/port)
"Y" = (
/obj/machinery/atmospherics/pipe/smart/manifold4w/scrubbers/hidden/layer2,
/obj/machinery/atmospherics/pipe/smart/manifold4w/supply/hidden/layer4,
/obj/structure/chair/sofa/corp/left,
/obj/effect/turf_decal/tile/dark_blue/opposingcorners,
/obj/structure/cable,
/turf/open/floor/iron/dark,
/area/station/command/heads_quarters/blueshield)
"Z" = (
/obj/machinery/atmospherics/pipe/smart/manifold4w/scrubbers/hidden/layer2,
/obj/machinery/atmospherics/pipe/smart/manifold4w/supply/hidden/layer4,
/obj/effect/turf_decal/tile/dark_blue/opposingcorners,
/obj/machinery/light/directional/west,
/turf/open/floor/iron/dark,
/area/station/command/heads_quarters/blueshield)

(1,1,1) = {"
v
v
v
v
y
y
y
y
y
y
"}
(2,1,1) = {"
v
v
v
y
y
d
P
Q
r
y
"}
(3,1,1) = {"
v
v
v
y
W
w
e
I
t
y
"}
(4,1,1) = {"
v
v
v
y
g
k
F
V
J
y
"}
(5,1,1) = {"
v
v
R
y
y
y
j
y
y
y
"}
(6,1,1) = {"
v
v
u
C
n
Z
K
O
b
y
"}
(7,1,1) = {"
v
v
u
C
Y
A
T
m
o
y
"}
(8,1,1) = {"
a
c
X
p
S
H
l
f
B
y
"}
(9,1,1) = {"
v
v
q
y
y
y
y
y
y
y
"}
(10,1,1) = {"
v
v
v
y
y
y
y
y
D
v
"}
