//MAP CONVERTED BY dmm2tgm.py THIS HEADER COMMENT PREVENTS RECONVERSION, DO NOT REMOVE
"a" = (
/obj/effect/turf_decal/trimline/dark_red/filled/line{
	dir = 8
	},
/obj/effect/turf_decal/stripes/line{
	dir = 1
	},
/turf/open/floor/iron/dark,
/area/station/security/armory)
"b" = (
/obj/structure/rack,
/obj/item/gun/energy/ionrifle,
/obj/item/clothing/suit/hooded/ablative,
/obj/item/gun/energy/temperature/security,
/obj/structure/window/reinforced/spawner/directional/south,
/obj/effect/turf_decal/bot,
/obj/effect/turf_decal/tile/neutral/fourcorners,
/turf/open/floor/iron/dark,
/area/station/security/armory)
"e" = (
/obj/structure/table/reinforced,
/obj/machinery/door/firedoor,
/obj/machinery/door/window/brigdoor/right/directional/north{
	name = "Armoury Desk";
	req_access = list("armory")
	},
/obj/machinery/door/window/right/directional/south{
	name = "Armoury Desk";
	req_access = list("security")
	},
/obj/item/restraints/handcuffs,
/obj/item/assembly/flash/handheld,
/turf/open/floor/iron/dark,
/area/station/security/armory)
"f" = (
/obj/machinery/button/door/directional/south{
	id = "armouryaccess";
	name = "Armoury Access";
	req_access = list("armory")
	},
/obj/effect/turf_decal/trimline/dark_red/filled/line{
	dir = 10
	},
/turf/open/floor/iron/dark,
/area/station/security/armory)
"g" = (
/obj/structure/table/reinforced,
/obj/machinery/airalarm/directional/north,
/obj/item/storage/box/firingpins{
	pixel_y = 5
	},
/obj/effect/turf_decal/tile/neutral/fourcorners,
/turf/open/floor/iron/dark,
/area/station/security/armory)
"h" = (
/obj/structure/table/reinforced,
/obj/machinery/newscaster/directional/north,
/obj/item/clothing/mask/gas/sechailer,
/obj/item/clothing/mask/gas/sechailer{
	pixel_y = -2
	},
/obj/item/clothing/mask/gas/sechailer{
	pixel_y = 3
	},
/obj/item/flashlight/seclite{
	pixel_y = -1
	},
/obj/item/flashlight/seclite{
	pixel_x = 2;
	pixel_y = -3
	},
/obj/item/flashlight/seclite{
	pixel_x = 4;
	pixel_y = -5
	},
/obj/effect/turf_decal/tile/neutral/fourcorners,
/turf/open/floor/iron/dark,
/area/station/security/armory)
"i" = (
/obj/machinery/atmospherics/pipe/smart/manifold4w/scrubbers/hidden/layer2,
/obj/effect/turf_decal/stripes/line{
	dir = 4
	},
/turf/open/floor/iron/dark,
/area/station/security/armory)
"j" = (
/obj/effect/turf_decal/trimline/dark_red/filled/line,
/obj/structure/chair/office,
/turf/open/floor/iron/dark,
/area/station/security/armory)
"k" = (
/obj/structure/sign/nanotrasen{
	pixel_x = 32
	},
/obj/structure/table/reinforced,
/obj/item/storage/lockbox/loyalty,
/obj/effect/turf_decal/tile/neutral/fourcorners,
/obj/machinery/light/directional/east,
/turf/open/floor/iron/dark,
/area/station/security/armory)
"l" = (
/turf/closed/wall/r_wall,
/area/station/security/armory)
"m" = (
/obj/structure/cable,
/obj/machinery/atmospherics/pipe/smart/manifold4w/supply/hidden/layer4,
/obj/machinery/atmospherics/pipe/smart/manifold4w/scrubbers/hidden/layer2,
/obj/effect/turf_decal/stripes/corner{
	dir = 4
	},
/mob/living/simple_animal/bot/secbot/beepsky/armsky,
/turf/open/floor/iron/dark,
/area/station/security/armory)
"n" = (
/obj/machinery/flasher/portable,
/obj/effect/turf_decal/bot,
/obj/machinery/light/directional/west,
/obj/effect/turf_decal/tile/neutral/fourcorners,
/turf/open/floor/iron/dark,
/area/station/security/armory)
"o" = (
/obj/structure/rack,
/obj/structure/window/reinforced/spawner/directional/north,
/obj/effect/turf_decal/bot,
/obj/effect/turf_decal/tile/neutral/fourcorners,
/obj/effect/spawner/random/armory/bulletproof_armor,
/obj/effect/spawner/random/armory/bulletproof_helmet,
/turf/open/floor/iron/dark,
/area/station/security/armory)
"p" = (
/obj/machinery/flasher/portable,
/obj/effect/turf_decal/bot,
/obj/effect/turf_decal/tile/neutral/fourcorners,
/turf/open/floor/iron/dark,
/area/station/security/armory)
"r" = (
/obj/structure/cable,
/obj/effect/turf_decal/stripes/line{
	dir = 1
	},
/turf/open/floor/iron/dark,
/area/station/security/armory)
"s" = (
/obj/structure/rack,
/obj/effect/turf_decal/bot,
/obj/structure/window/reinforced/spawner/directional/east{
	pixel_x = 3
	},
/obj/structure/window/reinforced/spawner/directional/south,
/obj/effect/turf_decal/tile/neutral/fourcorners,
/obj/effect/spawner/random/armory/e_gun,
/turf/open/floor/iron/dark,
/area/station/security/armory)
"t" = (
/obj/effect/turf_decal/stripes/line{
	dir = 9
	},
/obj/machinery/atmospherics/pipe/smart/manifold4w/scrubbers/hidden/layer2,
/obj/effect/turf_decal/stripes/corner,
/turf/open/floor/iron/dark,
/area/station/security/armory)
"v" = (
/obj/vehicle/ridden/secway,
/obj/structure/reagent_dispensers/wall/peppertank/directional/east,
/obj/item/key/security,
/obj/machinery/camera/directional/east{
	c_tag = "Security - Warden's Office"
	},
/obj/effect/turf_decal/tile/neutral/fourcorners,
/turf/open/floor/iron/dark,
/area/station/security/armory)
"w" = (
/obj/machinery/door/firedoor,
/obj/machinery/door/airlock/security{
	name = "Armoury"
	},
/obj/effect/mapping_helpers/airlock/access/all/security/armory,
/obj/structure/cable,
/obj/effect/turf_decal/stripes/line{
	dir = 8
	},
/obj/effect/turf_decal/stripes/line{
	dir = 4
	},
/obj/effect/turf_decal/tile/neutral/fourcorners,
/turf/open/floor/iron/dark,
/area/station/security/armory)
"x" = (
/obj/structure/rack,
/obj/effect/turf_decal/bot,
/obj/effect/turf_decal/tile/neutral/fourcorners,
/obj/effect/spawner/armory_spawn/shotguns,
/turf/open/floor/iron/dark,
/area/station/security/armory)
"y" = (
/obj/effect/landmark/event_spawn,
/obj/structure/cable,
/obj/machinery/atmospherics/components/unary/vent_pump/on/layer4{
	dir = 8
	},
/obj/effect/turf_decal/stripes/line{
	dir = 1
	},
/turf/open/floor/iron/dark/smooth_large,
/area/station/security/armory)
"z" = (
/obj/machinery/atmospherics/pipe/smart/manifold4w/scrubbers/hidden/layer2,
/obj/effect/turf_decal/stripes/corner{
	dir = 1
	},
/obj/effect/turf_decal/stripes/line{
	dir = 4
	},
/turf/open/floor/iron/dark,
/area/station/security/armory)
"A" = (
/obj/structure/table/reinforced,
/obj/item/storage/box/chemimp{
	pixel_x = 4;
	pixel_y = 10
	},
/obj/item/storage/box/trackimp{
	pixel_y = 6
	},
/obj/effect/turf_decal/tile/neutral/fourcorners,
/turf/open/floor/iron/dark,
/area/station/security/armory)
"B" = (
/obj/structure/table/reinforced,
/obj/machinery/recharger,
/obj/effect/turf_decal/tile/neutral/fourcorners,
/turf/open/floor/iron/dark,
/area/station/security/armory)
"C" = (
/obj/effect/turf_decal/stripes/line{
	dir = 5
	},
/obj/effect/turf_decal/stripes/corner{
	dir = 8
	},
/turf/open/floor/iron/dark,
/area/station/security/armory)
"D" = (
/obj/effect/turf_decal/stripes/line{
	dir = 4
	},
/obj/effect/turf_decal/stripes/line{
	dir = 8
	},
/turf/open/floor/iron/dark,
/area/station/security/armory)
"E" = (
/obj/structure/table/reinforced,
/obj/item/radio/intercom/directional/north,
/obj/effect/turf_decal/tile/neutral/fourcorners,
/obj/effect/spawner/random/armory/barrier_grenades,
/turf/open/floor/iron/dark,
/area/station/security/armory)
"F" = (
/obj/structure/rack,
/obj/effect/turf_decal/bot,
/obj/structure/window/reinforced/spawner/directional/east{
	pixel_x = 3
	},
/obj/structure/window/reinforced/spawner/directional/north,
/obj/item/gun/energy/e_gun/dragnet{
	pixel_y = 4
	},
/obj/item/gun/energy/e_gun/dragnet,
/obj/effect/turf_decal/tile/neutral/fourcorners,
/turf/open/floor/iron/dark,
/area/station/security/armory)
"G" = (
/obj/machinery/atmospherics/components/unary/vent_scrubber/on/layer2{
	dir = 8
	},
/obj/effect/turf_decal/stripes/line{
	dir = 1
	},
/obj/effect/turf_decal/stripes/line,
/turf/open/floor/iron/dark/smooth_large,
/area/station/security/armory)
"H" = (
/obj/structure/sign/warning/directional/west,
/turf/template_noop,
/area/template_noop)
"I" = (
/obj/structure/rack,
/obj/effect/turf_decal/bot,
/obj/effect/turf_decal/tile/neutral/fourcorners,
/obj/effect/spawner/random/armory/riot_armor,
/obj/effect/spawner/random/armory/riot_helmet,
/obj/effect/spawner/random/armory/riot_shield,
/turf/open/floor/iron/dark,
/area/station/security/armory)
"K" = (
/obj/machinery/door/firedoor,
/obj/machinery/door/airlock/security{
	name = "Armoury"
	},
/obj/structure/cable,
/obj/machinery/atmospherics/pipe/smart/manifold4w/supply/hidden/layer4,
/obj/machinery/atmospherics/pipe/smart/manifold4w/scrubbers/hidden/layer2,
/obj/effect/mapping_helpers/airlock/access/all/security/armory,
/obj/effect/landmark/navigate_destination,
/obj/effect/turf_decal/stripes/line{
	dir = 8
	},
/obj/effect/turf_decal/stripes/line{
	dir = 4
	},
/obj/effect/turf_decal/tile/neutral/fourcorners,
/turf/open/floor/iron/dark,
/area/station/security/armory)
"L" = (
/obj/structure/cable,
/obj/machinery/atmospherics/pipe/smart/manifold4w/supply/hidden/layer4,
/obj/machinery/atmospherics/pipe/smart/manifold4w/scrubbers/hidden/layer2,
/obj/effect/turf_decal/trimline/dark_red/filled/warning{
	dir = 8
	},
/turf/open/floor/iron/dark,
/area/station/security/armory)
"M" = (
/obj/machinery/power/apc/auto_name/directional/south,
/obj/structure/cable,
/obj/effect/turf_decal/trimline/dark_red/filled/line,
/obj/effect/turf_decal/stripes/line{
	dir = 4
	},
/obj/machinery/status_display/ai/directional/east,
/turf/open/floor/iron/dark,
/area/station/security/armory)
"N" = (
/obj/effect/turf_decal/trimline/dark_red/filled/warning,
/turf/open/floor/iron/dark,
/area/station/security/armory)
"O" = (
/obj/effect/turf_decal/tile/neutral/fourcorners,
/obj/structure/closet/secure_closet/armory_kiboko,
/obj/item/ammo_box/c980grenade/riot,
/obj/item/ammo_box/c980grenade/smoke,
/turf/open/floor/iron/dark,
/area/station/security/armory)
"P" = (
/obj/item/storage/box/teargas{
	pixel_x = 3;
	pixel_y = 3
	},
/obj/item/storage/box/handcuffs,
/obj/item/storage/box/flashbangs{
	pixel_x = -3;
	pixel_y = -3
	},
/obj/structure/table/reinforced,
/obj/machinery/status_display/ai/directional/east,
/obj/machinery/firealarm/directional/north,
/obj/effect/turf_decal/tile/neutral/fourcorners,
/turf/open/floor/iron/dark,
/area/station/security/armory)
"Q" = (
/obj/structure/sign/nanotrasen{
	pixel_x = 32
	},
/obj/structure/closet/secure_closet/armory2,
/obj/effect/turf_decal/bot,
/obj/effect/turf_decal/tile/neutral/fourcorners,
/obj/effect/spawner/random/armory/rubbershot,
/turf/open/floor/iron/dark,
/area/station/security/armory)
"R" = (
/obj/structure/rack,
/obj/effect/turf_decal/bot,
/obj/structure/window/reinforced/spawner/directional/east{
	pixel_x = 3
	},
/obj/effect/turf_decal/tile/neutral/fourcorners,
/obj/effect/spawner/armory_spawn/smg,
/turf/open/floor/iron/dark,
/area/station/security/armory)
"S" = (
/obj/machinery/door/poddoor{
	id = "armouryaccess";
	name = "Armoury Access"
	},
/obj/effect/turf_decal/stripes/line,
/obj/effect/turf_decal/stripes/line{
	dir = 1
	},
/turf/open/floor/iron,
/area/station/security/armory)
"T" = (
/obj/structure/closet/secure_closet/contraband/armory,
/obj/machinery/light/directional/east,
/obj/effect/turf_decal/bot,
/obj/effect/spawner/random/maintenance/three,
/obj/effect/spawner/random/contraband/armory,
/obj/effect/turf_decal/tile/neutral/fourcorners,
/turf/open/floor/iron/dark,
/area/station/security/armory)
"U" = (
/obj/effect/turf_decal/stripes/line{
	dir = 1
	},
/obj/machinery/atmospherics/pipe/smart/manifold4w/scrubbers/hidden/layer2,
/obj/effect/turf_decal/stripes/line,
/turf/open/floor/iron/dark,
/area/station/security/armory)
"V" = (
/obj/structure/rack,
/obj/effect/turf_decal/bot,
/obj/structure/window/reinforced/spawner/directional/east{
	pixel_x = 3
	},
/obj/effect/turf_decal/tile/neutral/fourcorners,
/obj/effect/spawner/random/armory/disablers,
/turf/open/floor/iron/dark,
/area/station/security/armory)
"W" = (
/obj/effect/spawner/structure/window/reinforced,
/obj/structure/cable,
/turf/open/floor/plating,
/area/station/security/armory)
"X" = (
/obj/effect/turf_decal/stripes/line{
	dir = 4
	},
/obj/structure/cable,
/obj/effect/turf_decal/stripes/corner{
	dir = 1
	},
/turf/open/floor/iron/dark,
/area/station/security/armory)
"Y" = (
/obj/effect/turf_decal/trimline/dark_red/filled/warning{
	dir = 8
	},
/turf/open/floor/iron/dark,
/area/station/security/armory)
"Z" = (
/obj/effect/turf_decal/stripes/line{
	dir = 8
	},
/obj/machinery/atmospherics/pipe/smart/manifold4w/scrubbers/hidden/layer2,
/obj/effect/turf_decal/stripes/line{
	dir = 4
	},
/turf/open/floor/iron/dark,
/area/station/security/armory)

(1,1,1) = {"
l
l
W
W
l
W
w
K
W
l
"}
(2,1,1) = {"
l
B
p
p
n
a
Y
L
f
l
"}
(3,1,1) = {"
l
E
t
Z
Z
z
i
m
N
S
"}
(4,1,1) = {"
l
g
U
F
R
V
s
y
N
S
"}
(5,1,1) = {"
l
h
G
o
x
I
b
r
j
e
"}
(6,1,1) = {"
l
P
C
D
D
D
D
X
M
l
"}
(7,1,1) = {"
l
l
T
Q
O
v
k
A
l
l
"}
(8,1,1) = {"
H
l
l
l
l
l
l
l
l
H
"}
