//MAP CONVERTED BY dmm2tgm.py THIS HEADER COMMENT PREVENTS RECONVERSION, DO NOT REMOVE
"a" = (
/turf/closed/wall/r_wall,
/area/station/security/checkpoint/medical/medsci)
"b" = (
/obj/structure/cable,
/obj/machinery/atmospherics/pipe/smart/manifold4w/supply/hidden/layer4,
/obj/machinery/atmospherics/pipe/smart/manifold4w/scrubbers/hidden/layer2,
/obj/effect/turf_decal/tile/red/half/contrasted{
	dir = 1
	},
/turf/open/floor/iron,
/area/station/security/checkpoint/medical/medsci)
"c" = (
/obj/structure/disposalpipe/segment,
/obj/effect/turf_decal/tile/red{
	dir = 4
	},
/turf/open/floor/iron,
/area/station/security/checkpoint/medical/medsci)
"d" = (
/obj/machinery/firealarm/directional/north{
	pixel_x = -4
	},
/obj/machinery/light_switch/directional/north{
	pixel_x = 10
	},
/obj/structure/rack,
/obj/item/book/manual/wiki/security_space_law{
	pixel_x = -1;
	pixel_y = 4
	},
/obj/item/book/manual/wiki/security_space_law{
	pixel_x = 3
	},
/obj/effect/turf_decal/bot,
/obj/effect/turf_decal/tile/red/anticorner/contrasted{
	dir = 4
	},
/turf/open/floor/iron,
/area/station/security/checkpoint/medical/medsci)
"e" = (
/obj/structure/reagent_dispensers/wall/peppertank/directional/north,
/obj/structure/cable,
/obj/machinery/atmospherics/pipe/smart/manifold4w/supply/hidden/layer4,
/obj/machinery/atmospherics/pipe/smart/manifold4w/scrubbers/hidden/layer2,
/obj/machinery/camera/directional/north{
	c_tag = "Security Post - Medsci";
	dir = 9
	},
/obj/effect/turf_decal/tile/red/anticorner/contrasted{
	dir = 4
	},
/turf/open/floor/iron,
/area/station/security/checkpoint/medical/medsci)
"f" = (
/obj/machinery/atmospherics/components/unary/vent_scrubber/on/layer2{
	dir = 1
	},
/obj/machinery/atmospherics/pipe/smart/manifold4w/supply/hidden/layer4,
/obj/effect/turf_decal/tile/red/half/contrasted{
	dir = 1
	},
/turf/open/floor/iron/dark,
/area/station/security/checkpoint/medical/medsci)
"g" = (
/obj/effect/spawner/structure/window/reinforced,
/obj/structure/cable,
/turf/open/floor/plating,
/area/station/security/checkpoint/medical/medsci)
"h" = (
/turf/template_noop,
/area/template_noop)
"j" = (
/obj/structure/cable,
/obj/machinery/atmospherics/pipe/smart/manifold4w/supply/hidden/layer4,
/obj/machinery/atmospherics/pipe/smart/manifold4w/scrubbers/hidden/layer2,
/obj/structure/disposalpipe/segment{
	dir = 4
	},
/obj/effect/turf_decal/tile/red/half/contrasted{
	dir = 4
	},
/obj/effect/landmark/start/orderly,
/turf/open/floor/iron,
/area/station/security/checkpoint/medical/medsci)
"k" = (
/obj/structure/closet/secure_closet/brig{
	id = "scicell";
	name = "Science Cell Locker"
	},
/obj/effect/turf_decal/bot,
/obj/effect/turf_decal/tile/red/anticorner/contrasted{
	dir = 4
	},
/turf/open/floor/iron/dark,
/area/station/security/checkpoint/medical/medsci)
"l" = (
/obj/machinery/status_display/evac/directional/north,
/obj/structure/cable,
/obj/structure/table/reinforced,
/obj/machinery/recharger{
	pixel_x = 6
	},
/obj/machinery/recharger{
	pixel_x = -5
	},
/obj/effect/turf_decal/tile/red/anticorner/contrasted{
	dir = 4
	},
/turf/open/floor/iron,
/area/station/security/checkpoint/medical/medsci)
"m" = (
/obj/effect/turf_decal/stripes/line,
/obj/effect/turf_decal/stripes/line{
	dir = 1
	},
/obj/machinery/door/firedoor,
/obj/machinery/door/airlock/security/glass{
	name = "Security Post - Science"
	},
/obj/effect/turf_decal/tile/red/fourcorners,
/obj/effect/mapping_helpers/airlock/access/all/science/sci_guard,
/turf/open/floor/iron,
/area/station/security/checkpoint/medical/medsci)
"n" = (
/obj/structure/cable,
/obj/machinery/atmospherics/pipe/smart/manifold4w/supply/hidden/layer4,
/obj/machinery/atmospherics/pipe/smart/manifold4w/scrubbers/hidden/layer2,
/obj/effect/turf_decal/bot,
/obj/machinery/holopad,
/turf/open/floor/iron/large,
/area/station/security/checkpoint/medical/medsci)
"o" = (
/obj/machinery/status_display/door_timer{
	id = "medsci-cell";
	name = "Med-Sci Cell";
	pixel_y = -32
	},
/obj/effect/turf_decal/tile/red/anticorner/contrasted,
/turf/open/floor/iron,
/area/station/security/checkpoint/medical/medsci)
"p" = (
/obj/structure/cable,
/obj/structure/table/reinforced,
/obj/item/paper_bin,
/obj/item/folder/red,
/obj/item/pen,
/obj/effect/turf_decal/tile/red/half/contrasted{
	dir = 1
	},
/turf/open/floor/iron,
/area/station/security/checkpoint/medical/medsci)
"q" = (
/obj/structure/cable,
/obj/effect/turf_decal/bot,
/obj/structure/closet/secure_closet/security/science,
/obj/effect/turf_decal/tile/red/fourcorners,
/turf/open/floor/iron,
/area/station/security/checkpoint/medical/medsci)
"r" = (
/obj/structure/chair/office,
/turf/open/floor/iron,
/area/station/security/checkpoint/medical/medsci)
"s" = (
/obj/structure/cable,
/obj/effect/turf_decal/tile/red/half/contrasted,
/turf/open/floor/iron,
/area/station/security/checkpoint/medical/medsci)
"u" = (
/obj/machinery/computer/crew{
	dir = 4
	},
/obj/effect/turf_decal/tile/red/anticorner/contrasted{
	dir = 1
	},
/turf/open/floor/iron,
/area/station/security/checkpoint/medical/medsci)
"w" = (
/obj/structure/chair{
	dir = 4
	},
/obj/item/radio/intercom/directional/west,
/obj/effect/turf_decal/tile/red/anticorner/contrasted{
	dir = 1
	},
/turf/open/floor/iron/dark,
/area/station/security/checkpoint/medical/medsci)
"y" = (
/obj/structure/cable,
/obj/machinery/atmospherics/components/unary/vent_pump/on/layer4{
	dir = 1
	},
/turf/open/floor/iron/large,
/area/station/security/checkpoint/medical/medsci)
"z" = (
/obj/structure/table/reinforced,
/obj/structure/extinguisher_cabinet/directional/east,
/obj/machinery/airalarm/directional/south,
/obj/item/crowbar,
/obj/item/wrench,
/obj/item/clothing/mask/gas,
/obj/effect/turf_decal/tile/red/fourcorners,
/turf/open/floor/iron,
/area/station/security/checkpoint/medical/medsci)
"B" = (
/obj/structure/closet/secure_closet/brig{
	id = "medcell";
	name = "Medical Cell Locker"
	},
/obj/machinery/status_display/ai/directional/east,
/obj/effect/turf_decal/bot,
/obj/effect/turf_decal/tile/red/anticorner/contrasted,
/turf/open/floor/iron/dark,
/area/station/security/checkpoint/medical/medsci)
"C" = (
/obj/machinery/newscaster/directional/south,
/obj/machinery/computer/mecha{
	dir = 1
	},
/obj/effect/turf_decal/tile/red/fourcorners,
/turf/open/floor/iron,
/area/station/security/checkpoint/medical/medsci)
"E" = (
/obj/structure/table/reinforced,
/obj/item/crowbar,
/obj/item/radio{
	pixel_x = 5;
	pixel_y = 2
	},
/obj/item/radio{
	pixel_x = -3;
	pixel_y = 2
	},
/obj/item/radio{
	pixel_x = 1
	},
/obj/effect/turf_decal/tile/red/half/contrasted{
	dir = 4
	},
/turf/open/floor/iron,
/area/station/security/checkpoint/medical/medsci)
"F" = (
/obj/structure/cable,
/obj/machinery/atmospherics/pipe/smart/manifold4w/supply/hidden/layer4,
/obj/machinery/atmospherics/pipe/smart/manifold4w/scrubbers/hidden/layer2,
/obj/effect/turf_decal/tile/red/anticorner/contrasted{
	dir = 1
	},
/obj/effect/landmark/start/science_guard,
/turf/open/floor/iron,
/area/station/security/checkpoint/medical/medsci)
"H" = (
/obj/item/radio/intercom/directional/south,
/obj/effect/turf_decal/tile/red/anticorner/contrasted,
/turf/open/floor/iron,
/area/station/security/checkpoint/medical/medsci)
"I" = (
/obj/machinery/disposal/bin{
	desc = "A pneumatic waste disposal unit. This one leads to the morgue.";
	name = "corpse disposal"
	},
/obj/effect/turf_decal/bot,
/obj/structure/disposalpipe/trunk,
/obj/effect/turf_decal/tile/red/half/contrasted{
	dir = 4
	},
/obj/machinery/light/directional/east,
/turf/open/floor/iron,
/area/station/security/checkpoint/medical/medsci)
"J" = (
/obj/structure/cable,
/obj/effect/turf_decal/bot,
/obj/structure/closet/secure_closet/security/med,
/obj/effect/turf_decal/tile/red/fourcorners,
/turf/open/floor/iron,
/area/station/security/checkpoint/medical/medsci)
"K" = (
/obj/machinery/door/window/brigdoor/left/directional/south{
	id = "medsci-cell";
	name = "Med-Sci Cell";
	req_access = list("security")
	},
/obj/machinery/atmospherics/pipe/smart/manifold4w/supply/hidden/layer4,
/obj/machinery/atmospherics/pipe/smart/manifold4w/scrubbers/hidden/layer2,
/obj/effect/turf_decal/tile/red/fourcorners,
/turf/open/floor/iron/dark/side,
/area/station/security/checkpoint/medical/medsci)
"L" = (
/obj/machinery/atmospherics/pipe/smart/manifold4w/supply/hidden/layer4,
/obj/machinery/atmospherics/pipe/smart/manifold4w/scrubbers/hidden/layer2,
/obj/effect/turf_decal/tile/red/half/contrasted{
	dir = 8
	},
/turf/open/floor/iron,
/area/station/security/checkpoint/medical/medsci)
"M" = (
/obj/structure/cable,
/obj/structure/chair/office{
	dir = 8
	},
/obj/effect/landmark/start/orderly,
/turf/open/floor/iron,
/area/station/security/checkpoint/medical/medsci)
"N" = (
/obj/machinery/computer/records/security{
	dir = 4
	},
/obj/machinery/status_display/ai/directional/north,
/obj/structure/cable,
/obj/effect/turf_decal/tile/red/anticorner/contrasted{
	dir = 8
	},
/turf/open/floor/iron,
/area/station/security/checkpoint/medical/medsci)
"P" = (
/obj/machinery/computer/security{
	dir = 4
	},
/obj/effect/turf_decal/tile/red/fourcorners,
/turf/open/floor/iron,
/area/station/security/checkpoint/medical/medsci)
"R" = (
/obj/machinery/power/apc/auto_name/directional/south,
/obj/structure/cable,
/obj/effect/turf_decal/tile/red/anticorner/contrasted{
	dir = 8
	},
/turf/open/floor/iron,
/area/station/security/checkpoint/medical/medsci)
"S" = (
/obj/structure/cable,
/obj/machinery/atmospherics/pipe/smart/manifold4w/supply/hidden/layer4,
/obj/machinery/atmospherics/pipe/smart/manifold4w/scrubbers/hidden/layer2,
/obj/effect/turf_decal/tile/red/half/contrasted{
	dir = 8
	},
/turf/open/floor/iron,
/area/station/security/checkpoint/medical/medsci)
"T" = (
/obj/structure/cable,
/obj/machinery/atmospherics/pipe/smart/manifold4w/supply/hidden/layer4,
/obj/machinery/atmospherics/pipe/smart/manifold4w/scrubbers/hidden/layer2,
/obj/structure/disposalpipe/segment{
	dir = 5
	},
/turf/open/floor/iron,
/area/station/security/checkpoint/medical/medsci)
"U" = (
/obj/structure/chair{
	dir = 4
	},
/obj/machinery/status_display/evac/directional/west,
/obj/effect/turf_decal/tile/red/anticorner/contrasted{
	dir = 8
	},
/turf/open/floor/iron/dark,
/area/station/security/checkpoint/medical/medsci)
"V" = (
/obj/machinery/atmospherics/components/unary/vent_pump/on/layer4{
	dir = 1
	},
/obj/structure/sign/nanotrasen{
	pixel_y = -32
	},
/obj/machinery/light/small/directional/south,
/obj/effect/turf_decal/tile/red/half/contrasted,
/turf/open/floor/iron/dark,
/area/station/security/checkpoint/medical/medsci)
"X" = (
/obj/machinery/atmospherics/pipe/smart/manifold4w/supply/hidden/layer4,
/obj/machinery/atmospherics/pipe/smart/manifold4w/scrubbers/hidden/layer2,
/obj/effect/turf_decal/tile/red/anticorner/contrasted{
	dir = 8
	},
/obj/effect/landmark/start/science_guard,
/turf/open/floor/iron,
/area/station/security/checkpoint/medical/medsci)
"Y" = (
/obj/effect/turf_decal/stripes/line{
	dir = 4
	},
/obj/effect/turf_decal/stripes/line{
	dir = 8
	},
/obj/structure/cable,
/obj/machinery/atmospherics/pipe/smart/manifold4w/scrubbers/hidden/layer2,
/obj/machinery/atmospherics/pipe/smart/manifold4w/supply/hidden/layer4,
/obj/structure/disposalpipe/segment{
	dir = 4
	},
/obj/machinery/door/firedoor,
/obj/machinery/door/airlock/security/glass{
	name = "Security Post - Medbay"
	},
/obj/effect/mapping_helpers/airlock/access/all/medical/orderly,
/turf/open/floor/iron,
/area/station/security/checkpoint/medical/medsci)
"Z" = (
/obj/structure/cable,
/obj/machinery/atmospherics/components/unary/vent_scrubber/on/layer2,
/turf/open/floor/iron/large,
/area/station/security/checkpoint/medical/medsci)

(1,1,1) = {"
h
h
h
h
a
g
g
a
a
a
a
"}
(2,1,1) = {"
h
h
h
h
g
q
J
g
w
U
a
"}
(3,1,1) = {"
h
h
h
h
m
F
X
K
f
V
a
"}
(4,1,1) = {"
h
h
h
h
g
b
s
g
k
B
a
"}
(5,1,1) = {"
a
g
g
g
a
e
o
a
a
a
a
"}
(6,1,1) = {"
a
N
P
u
L
S
R
a
h
h
h
"}
(7,1,1) = {"
g
p
M
Z
n
y
H
a
h
h
h
"}
(8,1,1) = {"
a
l
I
c
T
r
C
a
h
h
h
"}
(9,1,1) = {"
a
g
a
d
j
E
z
a
h
h
h
"}
(10,1,1) = {"
h
h
a
g
Y
g
a
a
h
h
h
"}
