"a" = (/turf/closed/wall,/area/station/cargo/blacksmith)
"b" = (/obj/structure/disposalpipe/segment{dir = 10},/obj/structure/cable,/obj/structure/reagent_water_basin,/obj/effect/decal/cleanable/dirt,/obj/machinery/airalarm/directional/north,/obj/effect/turf_decal/siding/wood{dir = 5},/turf/open/floor/stone,/area/station/cargo/blacksmith)
"c" = (/obj/structure/sign/directions/security{dir = 4; pixel_y = 8},/obj/structure/sign/directions/supply{dir = 4},/obj/structure/sign/directions/medical{pixel_y = -8},/turf/closed/wall,/area/station/cargo/blacksmith)
"d" = (/obj/machinery/atmospherics/pipe/smart/manifold4w/supply/hidden/layer4,/obj/machinery/atmospherics/pipe/smart/manifold4w/scrubbers/hidden/layer2,/obj/effect/turf_decal/tile/brown{dir = 4},/turf/open/floor/iron,/area/station/hallway/primary/central/fore)
"e" = (/obj/machinery/atmospherics/pipe/smart/manifold4w/supply/hidden/layer4,/obj/machinery/atmospherics/pipe/smart/manifold4w/scrubbers/hidden/layer2,/obj/machinery/bluespace_vendor/directional/north,/obj/effect/turf_decal/tile/neutral/half/contrasted{dir = 1},/turf/open/floor/iron,/area/station/hallway/primary/central/fore)
"f" = (/obj/structure/disposalpipe/segment,/obj/effect/decal/cleanable/dirt,/obj/structure/cable,/obj/effect/turf_decal/siding/wood{dir = 4},/turf/open/floor/stone,/area/station/cargo/blacksmith)
"g" = (/obj/structure/cable,/obj/structure/rack,/obj/structure/disposalpipe/segment{dir = 4},/obj/machinery/requests_console/directional/west{department = "Blacksmiths Workshop"; name = "Blacksmiths Requests console"; pixel_x = 2; pixel_y = 29},/obj/item/stack/sheet/iron/fifty{pixel_x = -7},/obj/item/stack/sheet/glass/fifty{pixel_x = 7},/obj/effect/turf_decal/siding/wood{dir = 1},/turf/open/floor/stone,/area/station/cargo/blacksmith)
"h" = (/obj/structure/disposalpipe/segment,/obj/structure/cable,/obj/effect/mapping_helpers/airlock/access/any/supply/blacksmith,/obj/machinery/door/firedoor,/obj/machinery/atmospherics/pipe/smart/manifold4w/supply/hidden/layer4,/obj/machinery/atmospherics/pipe/smart/manifold4w/scrubbers/hidden/layer2,/obj/machinery/door/airlock/mining{name = "Blacksmith Workshop"},/turf/open/floor/stone,/area/station/cargo/blacksmith)
"m" = (/obj/effect/spawner/structure/window,/turf/open/floor/plating,/area/station/cargo/blacksmith)
"n" = (/obj/machinery/atmospherics/pipe/smart/manifold4w/supply/hidden/layer4,/obj/machinery/atmospherics/pipe/smart/manifold4w/scrubbers/hidden/layer2,/obj/structure/disposalpipe/segment,/obj/structure/cable,/obj/effect/turf_decal/tile/neutral{dir = 4},/turf/open/floor/iron,/area/station/hallway/primary/central/fore)
"o" = (/obj/structure/table/reinforced,/obj/machinery/door/window{dir = 1; name = "Blacksmith Desk"; req_access = list("cargo")},/obj/machinery/door/firedoor,/turf/open/floor/stone,/area/station/cargo/blacksmith)
"p" = (/obj/effect/decal/cleanable/dirt,/turf/open/floor/plating,/area/station/maintenance/department/crew_quarters/bar)
"q" = (/obj/structure/disposalpipe/segment{dir = 4},/obj/machinery/door/airlock/maintenance_hatch{name = "Maintenance Hatch"},/obj/effect/turf_decal/stripes/line{dir = 8},/obj/effect/turf_decal/stripes/line{dir = 4},/obj/effect/mapping_helpers/airlock/unres{dir = 8},/obj/effect/mapping_helpers/airlock/access/all/engineering/maintenance,/turf/open/floor/iron,/area/station/maintenance/department/crew_quarters/bar)
"v" = (/obj/effect/mapping_helpers/broken_floor,/turf/open/floor/plating,/area/station/maintenance/department/crew_quarters/bar)
"y" = (/obj/machinery/atmospherics/pipe/smart/manifold4w/supply/hidden/layer4,/obj/machinery/atmospherics/pipe/smart/manifold4w/scrubbers/hidden/layer2,/obj/item/radio/intercom/directional/north,/obj/effect/turf_decal/tile/neutral{dir = 1},/obj/machinery/light/directional/north,/turf/open/floor/iron,/area/station/hallway/primary/central/fore)
"z" = (/obj/machinery/atmospherics/components/unary/vent_pump/on/layer4{dir = 4},/obj/effect/landmark/start/blacksmith,/obj/effect/turf_decal/siding/wood,/turf/open/floor/stone,/area/station/cargo/blacksmith)
"B" = (/obj/structure/reagent_anvil,/obj/machinery/light/directional/west{dir = 1},/obj/effect/decal/cleanable/dirt,/obj/machinery/power/apc/auto_name/directional/west,/obj/structure/sign/poster/random/directional/north,/obj/structure/cable,/obj/effect/turf_decal/siding/wood{dir = 9},/turf/open/floor/stone,/area/station/cargo/blacksmith)
"D" = (/turf/open/floor/plating,/area/station/maintenance/department/crew_quarters/bar)
"E" = (/obj/effect/mapping_helpers/airlock/access/any/supply/blacksmith,/obj/structure/disposalpipe/segment{dir = 6},/obj/machinery/door/airlock/mining{name = "Blacksmith Workshop"},/turf/open/floor/stone,/area/station/cargo/blacksmith)
"H" = (/obj/effect/decal/cleanable/dirt,/obj/effect/turf_decal/tile/neutral/half/contrasted,/obj/machinery/door/airlock/maintenance_hatch{name = "Maintenance Hatch"},/obj/effect/mapping_helpers/airlock/access/any/supply/blacksmith,/turf/open/floor/iron,/area/station/cargo/blacksmith)
"I" = (/obj/machinery/light/directional/west{dir = 2},/obj/effect/decal/cleanable/dirt,/obj/machinery/atmospherics/pipe/smart/manifold4w/supply/hidden/layer4,/obj/machinery/atmospherics/pipe/smart/manifold4w/scrubbers/hidden/layer2,/obj/effect/turf_decal/siding/wood,/turf/open/floor/stone,/area/station/cargo/blacksmith)
"J" = (/turf/closed/wall,/area/station/maintenance/department/crew_quarters/bar)
"K" = (/obj/machinery/atmospherics/pipe/smart/manifold4w/supply/hidden/layer4,/obj/machinery/atmospherics/pipe/smart/manifold4w/scrubbers/hidden/layer2,/obj/effect/turf_decal/siding/wood,/turf/open/floor/stone,/area/station/cargo/blacksmith)
"L" = (/obj/structure/disposalpipe/junction/yjunction{dir = 1},/turf/open/floor/plating,/area/station/maintenance/department/crew_quarters/bar)
"P" = (/obj/structure/disposalpipe/segment,/obj/structure/cable,/obj/machinery/atmospherics/pipe/smart/manifold4w/supply/hidden/layer4,/obj/machinery/atmospherics/pipe/smart/manifold4w/scrubbers/hidden/layer2,/obj/effect/turf_decal/siding/wood{dir = 4},/turf/open/floor/stone,/area/station/cargo/blacksmith)
"R" = (/obj/structure/reagent_forge,/obj/machinery/light_switch/directional/west{pixel_y = -8},/obj/effect/decal/cleanable/dirt,/obj/effect/turf_decal/siding/wood{dir = 8},/obj/machinery/camera/autoname/directional/west,/turf/open/floor/stone,/area/station/cargo/blacksmith)
"T" = (/obj/structure/disposalpipe/segment,/turf/open/floor/plating,/area/station/maintenance/department/crew_quarters/bar)
"U" = (/obj/structure/disposalpipe/segment{dir = 4},/turf/closed/wall,/area/station/cargo/blacksmith)
"W" = (/obj/machinery/atmospherics/pipe/smart/manifold4w/supply/hidden/layer4,/obj/machinery/atmospherics/pipe/smart/manifold4w/scrubbers/hidden/layer2,/obj/effect/turf_decal/tile/neutral{dir = 1},/turf/open/floor/iron,/area/station/hallway/primary/central/fore)
"Y" = (/obj/structure/disposalpipe/segment{dir = 5},/obj/effect/decal/cleanable/dirt,/obj/machinery/atmospherics/pipe/smart/manifold4w/supply/hidden/layer4,/obj/machinery/atmospherics/components/unary/vent_scrubber/on/layer2,/obj/effect/landmark/start/blacksmith,/obj/structure/cable,/obj/effect/turf_decal/siding/wood/corner{dir = 4},/turf/open/floor/stone,/area/station/cargo/blacksmith)

(1,1,1) = {"
JDvpTJ
JaEULq
aBfaaa
aRYgba
HzKIPm
aooahc
yWWend
"}
