//MAP CONVERTED BY dmm2tgm.py THIS HEADER COMMENT PREVENTS RECONVERSION, DO NOT REMOVE
"a" = (
/turf/closed/wall/r_wall,
/area/station/command/heads_quarters/nt_rep)
"b" = (
/turf/open/floor/carpet/green,
/area/station/command/heads_quarters/nt_rep)
"c" = (
/obj/structure/sign/directions/engineering,
/obj/structure/sign/directions/evac{
	pixel_y = -8
	},
/obj/structure/sign/directions/science{
	pixel_y = 8
	},
/turf/closed/wall/r_wall,
/area/station/command/heads_quarters/nt_rep)
"e" = (
/obj/structure/dresser,
/obj/effect/turf_decal/siding/dark{
	dir = 6
	},
/turf/open/floor/carpet/green,
/area/station/command/heads_quarters/nt_rep)
"f" = (
/obj/structure/filingcabinet/medical{
	pixel_x = -10
	},
/obj/structure/filingcabinet/employment,
/obj/structure/filingcabinet/security{
	pixel_x = 10
	},
/turf/open/floor/carpet/green,
/area/station/command/heads_quarters/nt_rep)
"h" = (
/obj/item/toy/crayon/white{
	pixel_x = 10;
	pixel_y = -8
	},
/turf/closed/wall/r_wall,
/area/station/maintenance/port/fore)
"i" = (
/turf/template_noop,
/area/template_noop)
"j" = (
/obj/structure/table/wood,
/obj/item/paperwork/captain{
	pixel_x = -3;
	pixel_y = 4;
	name = "station reports"
	},
/obj/item/flashlight/lamp{
	pixel_x = -5;
	pixel_y = 10
	},
/turf/open/floor/carpet/green,
/area/station/command/heads_quarters/nt_rep)
"k" = (
/obj/structure/table/wood,
/obj/item/paper_bin{
	pixel_y = 4;
	pixel_x = -5
	},
/obj/item/stamp/granted{
	pixel_y = 12;
	pixel_x = 8
	},
/obj/item/stamp/denied{
	pixel_x = 8;
	pixel_y = 6
	},
/obj/item/stamp/centcom{
	pixel_x = 8
	},
/obj/item/pen/fourcolor{
	pixel_x = -5;
	pixel_y = 5
	},
/obj/item/pen/fountain{
	pixel_x = -5;
	pixel_y = 5
	},
/turf/open/floor/carpet/green,
/area/station/command/heads_quarters/nt_rep)
"l" = (
/obj/structure/table/wood,
/obj/item/clipboard{
	pixel_x = -4;
	pixel_y = 3
	},
/obj/item/reagent_containers/cup/glass/mug/nanotrasen,
/turf/open/floor/carpet/green,
/area/station/command/heads_quarters/nt_rep)
"m" = (
/obj/structure/secure_safe/directional/north,
/obj/effect/turf_decal/siding/dark{
	dir = 5
	},
/turf/open/floor/carpet/green,
/area/station/command/heads_quarters/nt_rep)
"n" = (
/obj/machinery/atmospherics/pipe/smart/manifold4w/scrubbers/hidden/layer2,
/obj/machinery/atmospherics/components/unary/vent_pump/on/layer4,
/obj/effect/mapping_helpers/turn_off_lights_with_lightswitch,
/obj/structure/chair/office/tactical{
	dir = 1
	},
/turf/open/floor/wood,
/area/station/command/heads_quarters/nt_rep)
"o" = (
/obj/effect/turf_decal/siding/wood/corner{
	dir = 4
	},
/obj/machinery/disposal/bin,
/obj/structure/disposalpipe/trunk{
	dir = 1
	},
/turf/open/floor/wood,
/area/station/command/heads_quarters/nt_rep)
"q" = (
/obj/machinery/door/airlock/corporate/glass,
/obj/effect/mapping_helpers/airlock/access/all/cent_com/rep_door,
/obj/effect/turf_decal/siding/dark{
	dir = 8
	},
/obj/effect/mapping_helpers/airlock/unres/delayed{
	dir = 8
	},
/turf/open/floor/wood,
/area/station/command/heads_quarters/nt_rep)
"s" = (
/obj/machinery/atmospherics/pipe/smart/manifold4w/supply/hidden/layer4,
/obj/machinery/door/airlock/maintenance_hatch{
	name = "Maintenance Hatch"
	},
/obj/effect/turf_decal/stripes/line{
	dir = 1
	},
/obj/effect/turf_decal/stripes/line,
/obj/structure/cable,
/obj/effect/mapping_helpers/airlock/access/all/cent_com/rep_door,
/turf/open/floor/iron,
/area/station/command/heads_quarters/nt_rep)
"t" = (
/obj/machinery/light/directional/west,
/obj/structure/sign/poster/official/random/directional/north,
/obj/structure/bed/double{
	dir = 1
	},
/obj/item/bedsheet/centcom/double{
	dir = 1
	},
/obj/effect/turf_decal/siding/dark{
	dir = 9
	},
/turf/open/floor/carpet/green,
/area/station/command/heads_quarters/nt_rep)
"u" = (
/obj/structure/cable,
/turf/closed/wall/r_wall,
/area/station/command/heads_quarters/nt_rep)
"v" = (
/obj/structure/safe/abovetilefloor,
/obj/item/lustwish_discount{
	name = "Consultant's LustWish elite card"
	},
/obj/item/toy/figure/dsquad,
/obj/item/storage/toolbox/guncase/skyrat/pistol/sec_glock,
/obj/item/reagent_containers/cup/glass/bottle/applejack,
/obj/item/folder/documents,
/obj/item/paperwork{
	desc = "A densely compiled stack of Internal Affairs records, documenting various investigations, audits and disciplinary proceedings, extensively redacted under CENTCOM authority.";
	name = "internal affairs records"
	},
/obj/effect/turf_decal/siding/dark{
	dir = 8
	},
/turf/open/floor/carpet/green,
/area/station/command/heads_quarters/nt_rep)
"w" = (
/obj/structure/flora/bush/grassy,
/obj/structure/flora/bush/flowers_pp,
/obj/structure/window/reinforced/fulltile,
/obj/structure/curtain/cloth/fancy/mechanical{
	icon_state = "bounty-open";
	icon_type = "bounty";
	id = "nt_rep_priv";
	name = "curtain"
	},
/turf/open/floor/grass,
/area/station/command/heads_quarters/nt_rep)
"x" = (
/obj/structure/sign/poster/official/random/directional/south,
/obj/machinery/photocopier/prebuilt,
/turf/open/floor/wood,
/area/station/command/heads_quarters/nt_rep)
"y" = (
/obj/machinery/atmospherics/pipe/smart/manifold4w/supply/hidden/layer4,
/obj/machinery/atmospherics/pipe/smart/manifold4w/scrubbers/hidden/layer2,
/obj/structure/cable,
/turf/open/floor/wood,
/area/station/command/heads_quarters/nt_rep)
"z" = (
/obj/structure/table/wood,
/obj/item/radio/intercom/directional/north,
/obj/machinery/fax{
	fax_name = "Nanotrasen Consultant's Office";
	name = "Nanotrasen Consultant's Fax Machine"
	},
/turf/open/floor/carpet/green,
/area/station/command/heads_quarters/nt_rep)
"B" = (
/turf/open/floor/wood,
/area/station/command/heads_quarters/nt_rep)
"C" = (
/obj/machinery/atmospherics/pipe/smart/manifold4w/scrubbers/hidden/layer2,
/obj/structure/cable,
/turf/open/floor/wood,
/area/station/command/heads_quarters/nt_rep)
"D" = (
/obj/structure/table/wood,
/obj/machinery/coffeemaker/impressa{
	pixel_x = 2;
	pixel_y = 6
	},
/obj/item/storage/box/coffeepack,
/obj/structure/sign/clock/directional/north,
/obj/machinery/light/directional/north,
/turf/open/floor/carpet/green,
/area/station/command/heads_quarters/nt_rep)
"E" = (
/obj/machinery/button/curtain{
	pixel_x = 8;
	pixel_y = 3;
	id = "nt_rep_priv"
	},
/turf/closed/wall/r_wall,
/area/station/maintenance/port/fore)
"F" = (
/obj/machinery/atmospherics/pipe/smart/manifold4w/scrubbers/hidden/layer2,
/obj/structure/cable,
/turf/open/floor/carpet/green,
/area/station/command/heads_quarters/nt_rep)
"G" = (
/turf/closed/wall/r_wall,
/area/station/maintenance/port/fore)
"H" = (
/obj/structure/disposalpipe/junction/yjunction{
	dir = 1
	},
/turf/open/floor/iron,
/area/station/hallway/primary/central/fore)
"I" = (
/obj/structure/chair/office,
/turf/open/floor/carpet/green,
/area/station/command/heads_quarters/nt_rep)
"J" = (
/obj/structure/chair/office{
	dir = 1
	},
/obj/machinery/holopad,
/turf/open/floor/wood,
/area/station/command/heads_quarters/nt_rep)
"K" = (
/obj/machinery/light_switch/directional/north,
/obj/structure/disposalpipe/segment{
	dir = 6
	},
/turf/open/floor/wood,
/area/station/command/heads_quarters/nt_rep)
"L" = (
/obj/machinery/door/airlock/corporate{
	name = "NT Consultant's Office"
	},
/obj/structure/disposalpipe/segment{
	dir = 4
	},
/obj/machinery/door/firedoor,
/obj/effect/mapping_helpers/airlock/access/any/cent_com/rep_or_captain,
/obj/effect/mapping_helpers/airlock/unres/delayed{
	dir = 8
	},
/obj/effect/landmark/navigate_destination/autoname,
/turf/open/floor/iron,
/area/station/command/heads_quarters/nt_rep)
"M" = (
/obj/structure/closet/secure_closet/nanotrasen_consultant,
/obj/item/clothing/accessory/medal/gold/ordom,
/obj/item/clothing/accessory/medal/silver/bureaucracy,
/obj/item/hand_labeler,
/obj/item/storage/backpack/satchel/nanotrasen,
/obj/effect/turf_decal/siding/dark{
	dir = 10
	},
/turf/open/floor/carpet/green,
/area/station/command/heads_quarters/nt_rep)
"P" = (
/obj/machinery/airalarm/directional/south,
/obj/machinery/camera/directional/south{
	c_tag = "NT Consultant's Office";
	name = "command camera"
	},
/obj/structure/cable,
/obj/structure/extinguisher_cabinet/directional/west,
/obj/item/kirbyplants/random,
/turf/open/floor/wood,
/area/station/command/heads_quarters/nt_rep)
"Q" = (
/obj/machinery/modular_computer/preset/command{
	dir = 8
	},
/turf/open/floor/carpet/green,
/area/station/command/heads_quarters/nt_rep)
"R" = (
/obj/effect/turf_decal/siding/dark{
	dir = 4
	},
/turf/open/floor/carpet/green,
/area/station/command/heads_quarters/nt_rep)
"S" = (
/obj/machinery/firealarm/directional/south,
/obj/machinery/light/directional/south,
/turf/open/floor/wood,
/area/station/command/heads_quarters/nt_rep)
"U" = (
/obj/machinery/computer/station_goal,
/obj/structure/chalkboard{
	pixel_y = 32
	},
/turf/open/floor/carpet/green,
/area/station/command/heads_quarters/nt_rep)
"V" = (
/obj/machinery/atmospherics/components/unary/vent_scrubber/on/layer2,
/obj/structure/cable,
/obj/machinery/power/apc/auto_name/directional/west,
/turf/open/floor/carpet/green,
/area/station/command/heads_quarters/nt_rep)
"Y" = (
/obj/machinery/vending/boozeomat,
/turf/closed/wall/r_wall,
/area/station/command/heads_quarters/nt_rep)

(1,1,1) = {"
i
i
G
G
G
G
G
"}
(2,1,1) = {"
i
i
G
t
v
M
G
"}
(3,1,1) = {"
G
G
G
m
R
e
G
"}
(4,1,1) = {"
G
u
a
Y
q
a
G
"}
(5,1,1) = {"
G
z
V
F
C
P
G
"}
(6,1,1) = {"
G
D
b
j
n
y
s
"}
(7,1,1) = {"
G
U
I
k
J
S
G
"}
(8,1,1) = {"
h
f
Q
l
B
x
G
"}
(9,1,1) = {"
G
a
a
a
K
o
E
"}
(10,1,1) = {"
i
i
i
c
L
w
G
"}
(11,1,1) = {"
i
i
i
i
H
i
i
"}
