//MAP CONVERTED BY dmm2tgm.py THIS HEADER COMMENT PREVENTS RECONVERSION, DO NOT REMOVE
"a" = (
/obj/structure/cable,
/obj/machinery/atmospherics/pipe/smart/manifold4w/supply/hidden/layer4,
/obj/machinery/atmospherics/pipe/smart/manifold4w/scrubbers/hidden/layer2,
/obj/effect/turf_decal/tile/yellow{
	dir = 1
	},
/obj/machinery/atmospherics/pipe/smart/manifold4w/scrubbers/hidden/layer2,
/obj/machinery/atmospherics/pipe/smart/manifold4w/scrubbers/hidden/layer2,
/turf/open/floor/iron,
/area/station/hallway/primary/port)
"b" = (
/obj/machinery/computer/crew{
	dir = 1
	},
/obj/effect/turf_decal/siding/dark{
	dir = 1
	},
/turf/open/floor/iron/dark/textured,
/area/station/command/heads_quarters/blueshield)
"c" = (
/obj/machinery/atmospherics/pipe/smart/manifold4w/scrubbers/hidden/layer2,
/obj/effect/turf_decal/tile/neutral/fourcorners,
/obj/machinery/atmospherics/pipe/smart/manifold4w/scrubbers/hidden/layer2,
/obj/machinery/atmospherics/pipe/smart/manifold4w/scrubbers/hidden/layer2,
/obj/structure/cable,
/obj/machinery/atmospherics/pipe/smart/manifold4w/supply/hidden/layer4,
/turf/open/floor/iron,
/area/station/hallway/primary/port)
"d" = (
/obj/structure/closet/secure_closet/blueshield,
/obj/structure/window/reinforced/spawner/directional/north,
/obj/item/clothing/gloves/tackler/combat/insulated/blueshield,
/obj/effect/turf_decal/delivery/red,
/obj/item/clothing/head/cowboy/skyrat/cattleman/sec,
/obj/structure/window/reinforced/spawner/directional/east,
/obj/item/modular_computer/laptop/preset/security{
	pixel_y = 5
	},
/obj/item/taperecorder{
	name = "Captain's Log"
	},
/obj/structure/window/reinforced/spawner/directional/west,
/obj/item/dog_bone,
/turf/open/floor/iron/dark/textured,
/area/station/command/heads_quarters/blueshield)
"e" = (
/obj/effect/turf_decal/siding/dark,
/obj/structure/bed/dogbed{
	name = "Walter's Dogbed"
	},
/mob/living/basic/pet/dog/dobermann/walter,
/obj/item/toy/figure/syndie{
	pixel_x = 9;
	pixel_y = -2;
	name = "\improper chewed up Redsuit action figure"
	},
/turf/open/floor/wood,
/area/station/command/heads_quarters/blueshield)
"f" = (
/obj/machinery/modular_computer/preset/command{
	dir = 8
	},
/obj/effect/mapping_helpers/requests_console/information,
/obj/effect/mapping_helpers/requests_console/supplies,
/obj/effect/mapping_helpers/requests_console/assistance,
/obj/effect/mapping_helpers/requests_console/announcement,
/obj/effect/turf_decal/bot,
/obj/machinery/requests_console/auto_name/directional/east,
/turf/open/floor/carpet/blue,
/area/station/command/heads_quarters/blueshield)
"g" = (
/obj/structure/reagent_dispensers/wall/peppertank/directional/north,
/obj/structure/table/wood/fancy/blue,
/obj/item/storage/box/coffeepack{
	pixel_x = -5
	},
/obj/machinery/coffeemaker/impressa{
	pixel_x = 1;
	pixel_y = 8
	},
/obj/item/reagent_containers/cup/glass/mug/nanotrasen{
	pixel_x = 7
	},
/turf/open/floor/wood,
/area/station/command/heads_quarters/blueshield)
"k" = (
/obj/effect/turf_decal/siding/dark{
	dir = 8
	},
/obj/effect/turf_decal/siding/dark{
	dir = 4
	},
/obj/effect/mapping_helpers/airlock/access/all/command/captain,
/obj/machinery/atmospherics/pipe/smart/manifold4w/scrubbers/hidden/layer2,
/obj/machinery/atmospherics/pipe/smart/manifold4w/supply/hidden/layer4,
/obj/machinery/atmospherics/pipe/smart/manifold4w/scrubbers/hidden/layer2,
/obj/machinery/door/airlock/highsecurity{
	name = "Blueshield's Quarters"
	},
/turf/open/floor/carpet/blue,
/area/station/command/heads_quarters/blueshield)
"l" = (
/obj/structure/table/wood,
/obj/machinery/fax{
	name = "Blueshield's Fax Machine";
	fax_name = "Blueshield's Office"
	},
/obj/item/radio/intercom/directional/east,
/obj/effect/turf_decal/siding/dark{
	dir = 1
	},
/turf/open/floor/carpet/blue,
/area/station/command/heads_quarters/blueshield)
"m" = (
/obj/structure/chair/office{
	dir = 1
	},
/obj/machinery/atmospherics/components/unary/vent_pump/on/layer4{
	dir = 1
	},
/turf/open/floor/carpet/blue,
/area/station/command/heads_quarters/blueshield)
"n" = (
/obj/machinery/atmospherics/pipe/smart/manifold4w/scrubbers/hidden/layer2,
/obj/structure/chair/sofa/corp/right,
/obj/effect/turf_decal/tile/dark_blue/opposingcorners,
/turf/open/floor/iron/dark,
/area/station/command/heads_quarters/blueshield)
"o" = (
/obj/machinery/computer/records/medical{
	dir = 1
	},
/obj/effect/turf_decal/siding/dark{
	dir = 5
	},
/turf/open/floor/iron/dark/textured,
/area/station/command/heads_quarters/blueshield)
"p" = (
/obj/machinery/door/airlock/corporate{
	id_tag = "BSdoor";
	name = "Blueshield's Office"
	},
/obj/effect/mapping_helpers/airlock/access/any/cent_com/rep_or_captain,
/obj/machinery/atmospherics/pipe/smart/manifold4w/scrubbers/hidden/layer2,
/obj/machinery/atmospherics/pipe/smart/manifold4w/supply/hidden/layer4,
/obj/structure/cable,
/turf/open/floor/iron,
/area/station/command/heads_quarters/blueshield)
"r" = (
/obj/structure/table/wood/fancy/blue,
/obj/machinery/computer/security/wooden_tv{
	pixel_y = 10
	},
/obj/item/book/manual/wiki/security_space_law{
	pixel_y = 3;
	pixel_x = 7
	},
/turf/open/floor/carpet/blue,
/area/station/command/heads_quarters/blueshield)
"t" = (
/obj/structure/bed,
/obj/item/bedsheet/nanotrasen,
/obj/structure/secure_safe/directional/south,
/turf/open/floor/carpet/blue,
/area/station/command/heads_quarters/blueshield)
"v" = (
/turf/template_noop,
/area/template_noop)
"w" = (
/turf/open/floor/wood,
/area/station/command/heads_quarters/blueshield)
"y" = (
/turf/closed/wall/r_wall,
/area/station/command/heads_quarters/blueshield)
"A" = (
/obj/machinery/atmospherics/pipe/smart/manifold4w/supply/hidden/layer4,
/obj/effect/turf_decal/tile/dark_blue/opposingcorners,
/obj/structure/cable,
/turf/open/floor/iron/dark,
/area/station/command/heads_quarters/blueshield)
"B" = (
/obj/machinery/photocopier/prebuilt,
/obj/effect/turf_decal/bot,
/turf/open/floor/carpet/blue,
/area/station/command/heads_quarters/blueshield)
"F" = (
/obj/effect/turf_decal/siding/dark,
/obj/machinery/atmospherics/components/unary/vent_scrubber/on/layer2,
/turf/open/floor/wood,
/area/station/command/heads_quarters/blueshield)
"H" = (
/obj/structure/cable,
/obj/machinery/power/apc/auto_name/directional/east,
/obj/machinery/atmospherics/components/unary/vent_scrubber/on/layer2{
	dir = 1
	},
/obj/effect/turf_decal/tile/dark_blue/opposingcorners,
/obj/structure/cable,
/turf/open/floor/iron/dark,
/area/station/command/heads_quarters/blueshield)
"I" = (
/obj/machinery/atmospherics/components/unary/vent_pump/on/layer4{
	dir = 4
	},
/turf/open/floor/carpet/blue,
/area/station/command/heads_quarters/blueshield)
"J" = (
/obj/structure/dresser,
/turf/open/floor/carpet/blue,
/area/station/command/heads_quarters/blueshield)
"K" = (
/obj/effect/turf_decal/siding/dark{
	dir = 1
	},
/obj/machinery/holopad,
/obj/machinery/atmospherics/pipe/smart/manifold4w/scrubbers/hidden/layer2,
/obj/machinery/atmospherics/pipe/smart/manifold4w/supply/hidden/layer4,
/turf/open/floor/carpet/blue,
/area/station/command/heads_quarters/blueshield)
"O" = (
/obj/machinery/atmospherics/pipe/smart/manifold4w/scrubbers/hidden/layer2,
/obj/machinery/atmospherics/pipe/smart/manifold4w/supply/hidden/layer4,
/turf/open/floor/carpet/blue,
/area/station/command/heads_quarters/blueshield)
"P" = (
/obj/structure/closet/secure_closet/tac{
	req_access = list("captain")
	},
/obj/item/gun_maintenance_supplies,
/obj/item/clothing/suit/armor/riot,
/obj/item/clothing/head/helmet/toggleable/riot{
	pixel_y = 6
	},
/obj/effect/turf_decal/delivery/red,
/obj/item/ammo_box/magazine/wt550m9,
/obj/machinery/door/window/brigdoor/right/directional/east{
	req_access = list("captain");
	name = "Blueshield's Armory"
	},
/obj/structure/window/reinforced/spawner/directional/west,
/turf/open/floor/iron/dark/textured,
/area/station/command/heads_quarters/blueshield)
"Q" = (
/obj/machinery/suit_storage_unit/security,
/obj/structure/window/reinforced/spawner/directional/south,
/obj/effect/turf_decal/delivery/red,
/obj/structure/window/reinforced/spawner/directional/east,
/obj/structure/window/reinforced/spawner/directional/west,
/turf/open/floor/iron/dark/textured,
/area/station/command/heads_quarters/blueshield)
"S" = (
/obj/machinery/atmospherics/pipe/smart/manifold4w/scrubbers/hidden/layer2,
/obj/machinery/atmospherics/pipe/smart/manifold4w/supply/hidden/layer4,
/obj/structure/cable,
/obj/effect/turf_decal/tile/dark_blue/opposingcorners,
/turf/open/floor/iron/dark,
/area/station/command/heads_quarters/blueshield)
"T" = (
/obj/structure/table/wood,
/obj/machinery/atmospherics/pipe/smart/manifold4w/supply/hidden/layer4,
/obj/effect/turf_decal/siding/dark{
	dir = 1
	},
/obj/machinery/recharger{
	pixel_x = 7;
	pixel_y = 6
	},
/obj/item/paper_bin{
	pixel_y = 4;
	pixel_x = -5
	},
/obj/item/pen/fourcolor{
	pixel_x = -5;
	pixel_y = 5
	},
/turf/open/floor/carpet/blue,
/area/station/command/heads_quarters/blueshield)
"V" = (
/obj/machinery/atmospherics/pipe/smart/manifold4w/supply/hidden/layer4,
/obj/machinery/atmospherics/pipe/smart/manifold4w/scrubbers/hidden/layer2,
/turf/open/floor/carpet/blue,
/area/station/command/heads_quarters/blueshield)
"W" = (
/obj/machinery/vending/wallmed/directional/north,
/obj/structure/table/wood/fancy/blue,
/obj/item/modular_computer/laptop/preset/security{
	pixel_y = 5
	},
/turf/open/floor/wood,
/area/station/command/heads_quarters/blueshield)
"X" = (
/obj/machinery/atmospherics/pipe/smart/manifold4w/scrubbers/hidden/layer2,
/obj/effect/turf_decal/tile/neutral{
	dir = 8
	},
/obj/machinery/atmospherics/pipe/smart/manifold4w/scrubbers/hidden/layer2,
/obj/structure/cable,
/obj/structure/cable,
/obj/machinery/atmospherics/pipe/smart/manifold4w/supply/hidden/layer4,
/turf/open/floor/iron,
/area/station/hallway/primary/port)
"Y" = (
/obj/machinery/atmospherics/pipe/smart/manifold4w/scrubbers/hidden/layer2,
/obj/machinery/atmospherics/pipe/smart/manifold4w/supply/hidden/layer4,
/obj/machinery/atmospherics/pipe/smart/manifold4w/supply/hidden/layer4,
/obj/structure/chair/sofa/corp/left,
/obj/effect/turf_decal/tile/dark_blue/opposingcorners,
/turf/open/floor/iron/dark,
/area/station/command/heads_quarters/blueshield)
"Z" = (
/obj/machinery/atmospherics/pipe/smart/manifold4w/scrubbers/hidden/layer2,
/obj/machinery/atmospherics/pipe/smart/manifold4w/supply/hidden/layer4,
/obj/effect/turf_decal/tile/dark_blue/opposingcorners,
/turf/open/floor/iron/dark,
/area/station/command/heads_quarters/blueshield)

(1,1,1) = {"
v
v
v
v
y
y
y
y
y
y
"}
(2,1,1) = {"
v
v
v
y
y
d
P
Q
r
y
"}
(3,1,1) = {"
v
v
v
y
W
w
e
I
t
y
"}
(4,1,1) = {"
v
v
v
y
g
w
F
V
J
y
"}
(5,1,1) = {"
v
v
v
y
y
y
y
k
y
y
"}
(6,1,1) = {"
v
v
v
y
n
Z
K
O
b
y
"}
(7,1,1) = {"
v
v
v
y
Y
A
T
m
o
y
"}
(8,1,1) = {"
a
c
X
p
S
H
l
f
B
y
"}
(9,1,1) = {"
v
v
v
y
y
y
y
y
y
y
"}
(10,1,1) = {"
v
v
v
y
y
y
y
y
v
v
"}
