//MAP CONVERTED BY dmm2tgm.py THIS HEADER COMMENT PREVENTS RECONVERSION, DO NOT REMOVE
"a" = (
/turf/template_noop,
/area/template_noop)
"m" = (
/obj/structure/closet/secure_closet/personal/patient,
/obj/effect/turf_decal/bot,
/obj/machinery/light/small/directional/north,
/obj/effect/landmark/start/hangover,
/obj/effect/turf_decal/tile/neutral/fourcorners,
/turf/open/floor/iron,
/area/station/medical/cryo)
"v" = (
/obj/machinery/incident_display/disease,
/turf/closed/wall,
/area/station/medical/medbay/lobby)
"x" = (
/obj/structure/bed/medical/emergency,
/obj/effect/turf_decal/trimline/blue/filled/line,
/obj/machinery/light/directional/south,
/turf/open/floor/iron/white,
/area/station/medical/medbay/lobby)
"D" = (
/turf/closed/wall,
/area/station/medical/storage)
"F" = (
/obj/effect/turf_decal/bot,
/obj/machinery/vending/medical,
/obj/effect/turf_decal/tile/neutral/half/contrasted{
	dir = 1
	},
/turf/open/floor/iron,
/area/station/medical/storage)
"G" = (
/turf/closed/wall,
/area/station/medical/medbay/lobby)
"M" = (
/obj/structure/bed/medical/emergency,
/obj/effect/turf_decal/trimline/blue/filled/line,
/turf/open/floor/iron/white,
/area/station/medical/medbay/lobby)
"P" = (
/obj/machinery/incident_display/disease,
/turf/closed/wall,
/area/station/medical/storage)
"W" = (
/obj/item/radio/intercom/directional/east,
/turf/template_noop,
/area/template_noop)

(1,1,1) = {"
a
a
a
a
a
a
a
a
a
a
a
a
a
a
a
a
a
a
a
a
a
a
"}
(2,1,1) = {"
a
a
a
a
a
a
a
a
a
a
a
a
a
a
a
a
a
a
a
a
a
a
"}
(3,1,1) = {"
a
a
a
a
a
a
a
a
a
a
a
a
a
a
a
a
a
a
a
a
a
a
"}
(4,1,1) = {"
a
a
a
a
a
a
a
a
a
a
a
a
a
a
a
a
a
a
a
a
F
P
"}
(5,1,1) = {"
x
v
a
a
a
a
a
a
a
a
a
a
a
a
a
a
a
a
a
W
a
D
"}
(6,1,1) = {"
M
G
a
a
a
a
a
a
a
a
a
a
a
a
a
a
a
a
a
a
a
a
"}
(7,1,1) = {"
a
a
a
a
a
a
a
a
a
a
a
a
a
a
a
a
a
a
a
a
a
a
"}
(8,1,1) = {"
a
a
a
a
a
a
a
a
a
a
a
a
a
a
a
a
a
a
a
a
a
a
"}
(9,1,1) = {"
a
a
a
a
a
a
a
a
a
a
a
m
a
a
a
a
a
a
a
a
a
a
"}
