//MAP CONVERTED BY dmm2tgm.py THIS HEADER COMMENT PREVENTS RECONVERSION, DO NOT REMOVE
"a" = (
/obj/structure/cable,
/obj/machinery/computer/security{
	dir = 1
	},
/obj/machinery/newscaster/directional/south,
/obj/effect/turf_decal/tile/red/half/contrasted,
/obj/machinery/light/warm/directional/south,
/turf/open/floor/iron,
/area/station/security/checkpoint/engineering)
"b" = (
/obj/machinery/atmospherics/components/unary/vent_scrubber/on/layer2{
	dir = 1
	},
/obj/effect/turf_decal/tile/neutral/fourcorners,
/obj/effect/landmark/start/engineering_guard,
/turf/open/floor/iron,
/area/station/security/checkpoint/engineering)
"d" = (
/obj/structure/cable,
/obj/machinery/atmospherics/components/unary/vent_pump/on/layer4{
	dir = 8
	},
/obj/effect/turf_decal/tile/red/half/contrasted,
/turf/open/floor/iron,
/area/station/security/checkpoint/engineering)
"e" = (
/obj/structure/cable,
/obj/item/kirbyplants/random,
/obj/machinery/status_display/door_timer{
	id = "engcell";
	name = "Engineering Cell";
	pixel_y = 32
	},
/obj/effect/turf_decal/tile/red/anticorner/contrasted{
	dir = 1
	},
/turf/open/floor/iron,
/area/station/security/checkpoint/engineering)
"g" = (
/obj/structure/cable,
/obj/structure/table/reinforced,
/obj/item/book/manual/wiki/security_space_law,
/obj/item/radio,
/obj/machinery/airalarm/directional/east,
/obj/effect/turf_decal/tile/red/half/contrasted{
	dir = 4
	},
/turf/open/floor/iron,
/area/station/security/checkpoint/engineering)
"h" = (
/obj/machinery/atmospherics/components/unary/vent_pump/on/layer4{
	dir = 1
	},
/obj/effect/turf_decal/tile/neutral/fourcorners,
/obj/effect/landmark/start/engineering_guard,
/turf/open/floor/iron,
/area/station/security/checkpoint/engineering)
"j" = (
/obj/structure/cable,
/obj/machinery/door/firedoor,
/obj/machinery/door/airlock/security{
	name = "Security Post - Engineering"
	},
/obj/effect/turf_decal/stripes/line,
/obj/effect/turf_decal/stripes/line{
	dir = 1
	},
/obj/effect/mapping_helpers/airlock/access/all/engineering/engie_guard,
/turf/open/floor/iron,
/area/station/security/checkpoint/engineering)
"k" = (
/obj/machinery/atmospherics/pipe/smart/manifold4w/supply/hidden/layer4,
/obj/machinery/atmospherics/pipe/smart/manifold4w/scrubbers/hidden/layer2,
/obj/effect/turf_decal/tile/red/anticorner/contrasted{
	dir = 8
	},
/turf/open/floor/iron,
/area/station/security/checkpoint/engineering)
"m" = (
/obj/structure/cable,
/obj/machinery/atmospherics/pipe/smart/manifold4w/supply/hidden/layer4,
/obj/machinery/atmospherics/pipe/smart/manifold4w/scrubbers/hidden/layer2,
/obj/machinery/door/window/brigdoor/left/directional/north{
	id = "engcell";
	name = "Engineering Cell";
	req_access = list("security")
	},
/obj/effect/turf_decal/tile/red/fourcorners,
/obj/effect/mapping_helpers/airlock/access/all/engineering/engie_guard,
/turf/open/floor/iron,
/area/station/security/checkpoint/engineering)
"p" = (
/obj/structure/cable,
/obj/effect/spawner/structure/window/reinforced,
/turf/open/floor/plating,
/area/station/security/checkpoint/engineering)
"r" = (
/obj/machinery/atmospherics/pipe/smart/manifold4w/supply/hidden/layer4,
/obj/machinery/atmospherics/pipe/smart/manifold4w/scrubbers/hidden/layer2,
/obj/effect/turf_decal/tile/red/half/contrasted{
	dir = 1
	},
/turf/open/floor/iron,
/area/station/security/checkpoint/engineering)
"t" = (
/obj/machinery/atmospherics/pipe/smart/manifold4w/supply/hidden/layer4,
/obj/machinery/atmospherics/pipe/smart/manifold4w/scrubbers/hidden/layer2,
/obj/effect/turf_decal/tile/red/anticorner/contrasted{
	dir = 1
	},
/turf/open/floor/iron,
/area/station/security/checkpoint/engineering)
"y" = (
/obj/structure/chair/office,
/obj/machinery/holopad,
/obj/effect/turf_decal/bot,
/obj/structure/cable,
/obj/effect/turf_decal/tile/neutral/fourcorners,
/turf/open/floor/iron,
/area/station/security/checkpoint/engineering)
"z" = (
/turf/closed/wall/r_wall,
/area/station/security/checkpoint/engineering)
"A" = (
/obj/structure/cable,
/obj/structure/table/reinforced,
/obj/machinery/recharger,
/obj/structure/extinguisher_cabinet/directional/south{
	pixel_x = 32
	},
/obj/structure/reagent_dispensers/wall/peppertank/directional/east,
/obj/machinery/status_display/evac/directional/south,
/obj/effect/turf_decal/tile/red/anticorner/contrasted,
/turf/open/floor/iron,
/area/station/security/checkpoint/engineering)
"B" = (
/obj/structure/cable,
/obj/structure/closet/secure_closet/security/engine,
/obj/machinery/camera/directional/east{
	c_tag = "Security Post - Engineering"
	},
/obj/item/radio/intercom/directional/east,
/obj/machinery/power/apc/auto_name/directional/north,
/obj/machinery/button/door/directional/north{
	id = "engdoor";
	name = "Engineering Cell Control";
	normaldoorcontrol = 1;
	pixel_y = 37
	},
/obj/effect/turf_decal/bot,
/obj/effect/turf_decal/tile/red/anticorner/contrasted{
	dir = 4
	},
/turf/open/floor/iron,
/area/station/security/checkpoint/engineering)
"D" = (
/obj/machinery/light/small/directional/east,
/obj/structure/closet/secure_closet/brig{
	id = "engcell";
	name = "Engineering Cell Locker"
	},
/obj/effect/turf_decal/tile/red/anticorner/contrasted{
	dir = 4
	},
/turf/open/floor/iron,
/area/station/security/checkpoint/engineering)
"G" = (
/obj/structure/cable,
/obj/machinery/computer/station_alert{
	dir = 1
	},
/obj/machinery/status_display/ai/directional/south,
/obj/effect/turf_decal/tile/red/half/contrasted,
/turf/open/floor/iron,
/area/station/security/checkpoint/engineering)
"I" = (
/obj/structure/cable,
/obj/machinery/firealarm/directional/south{
	pixel_x = -32
	},
/obj/machinery/light_switch/directional/south{
	pixel_x = -20
	},
/obj/effect/turf_decal/tile/red/anticorner/contrasted{
	dir = 8
	},
/turf/open/floor/iron,
/area/station/security/checkpoint/engineering)
"J" = (
/obj/effect/turf_decal/tile/red/half/contrasted{
	dir = 8
	},
/turf/open/floor/iron,
/area/station/security/checkpoint/engineering)
"K" = (
/obj/machinery/atmospherics/pipe/smart/manifold4w/supply/hidden/layer4,
/obj/structure/cable,
/obj/effect/turf_decal/tile/red/half/contrasted{
	dir = 1
	},
/turf/open/floor/iron,
/area/station/security/checkpoint/engineering)
"L" = (
/obj/structure/chair{
	dir = 8
	},
/obj/effect/turf_decal/tile/red/anticorner/contrasted,
/turf/open/floor/iron,
/area/station/security/checkpoint/engineering)
"M" = (
/turf/template_noop,
/area/template_noop)
"N" = (
/obj/structure/cable,
/obj/machinery/computer/records/security{
	dir = 1
	},
/obj/effect/turf_decal/tile/red/half/contrasted,
/turf/open/floor/iron,
/area/station/security/checkpoint/engineering)
"O" = (
/turf/closed/wall,
/area/station/security/checkpoint/engineering)
"P" = (
/turf/closed/wall/r_wall,
/area/station/engineering/lobby)
"Q" = (
/obj/structure/cable,
/obj/structure/chair,
/obj/effect/turf_decal/tile/red/half/contrasted{
	dir = 1
	},
/turf/open/floor/iron,
/area/station/security/checkpoint/engineering)
"R" = (
/obj/structure/sign/nanotrasen,
/turf/closed/wall/r_wall,
/area/station/security/checkpoint/engineering)
"T" = (
/obj/machinery/atmospherics/pipe/smart/manifold4w/supply/hidden/layer4,
/obj/machinery/atmospherics/pipe/smart/manifold4w/scrubbers/hidden/layer2,
/obj/machinery/door/airlock/security/glass{
	id_tag = "engdoor";
	name = "Engineering Cell"
	},
/obj/effect/turf_decal/stripes/line{
	dir = 4
	},
/obj/effect/turf_decal/stripes/line{
	dir = 8
	},
/obj/effect/turf_decal/tile/red/fourcorners,
/obj/effect/mapping_helpers/airlock/access/all/engineering/engie_guard,
/turf/open/floor/iron,
/area/station/security/checkpoint/engineering)
"U" = (
/obj/machinery/atmospherics/pipe/smart/manifold4w/supply/hidden/layer4,
/obj/effect/turf_decal/tile/red/half/contrasted{
	dir = 1
	},
/turf/open/floor/iron,
/area/station/security/checkpoint/engineering)
"V" = (
/obj/structure/cable,
/obj/effect/spawner/structure/window/reinforced,
/turf/open/floor/plating,
/area/station/engineering/lobby)
"Y" = (
/obj/structure/sign/warning/electric_shock,
/turf/closed/wall/r_wall,
/area/station/engineering/lobby)

(1,1,1) = {"
M
M
O
O
p
p
p
O
"}
(2,1,1) = {"
P
T
z
z
e
J
I
j
"}
(3,1,1) = {"
V
t
k
m
r
b
G
z
"}
(4,1,1) = {"
V
Q
d
p
K
y
a
z
"}
(5,1,1) = {"
V
D
L
p
U
h
N
p
"}
(6,1,1) = {"
Y
R
z
z
B
g
A
z
"}
(7,1,1) = {"
M
M
M
z
z
z
z
z
"}
