//MAP CONVERTED BY dmm2tgm.py THIS HEADER COMMENT PREVENTS RECONVERSION, DO NOT REMOVE
"a" = (
/obj/effect/turf_decal/bot,
/obj/effect/turf_decal/tile/red/fourcorners,
/obj/structure/closet/secure_closet/armory_kiboko,
/obj/item/ammo_box/c980grenade/riot,
/obj/item/ammo_box/c980grenade/smoke,
/turf/open/floor/iron/dark,
/area/station/ai_monitored/security/armory)
"b" = (
/obj/effect/turf_decal/bot,
/obj/structure/rack,
/obj/effect/turf_decal/tile/red/fourcorners,
/obj/effect/spawner/random/armory/e_gun,
/turf/open/floor/iron/dark,
/area/station/ai_monitored/security/armory)
"d" = (
/obj/structure/rack,
/obj/item/gun/energy/e_gun/dragnet,
/turf/open/floor/iron/dark,
/area/station/ai_monitored/security/armory)
"e" = (
/obj/effect/turf_decal/stripes/line,
/obj/effect/turf_decal/tile/red{
	dir = 4
	},
/obj/effect/turf_decal/stripes/corner{
	dir = 1
	},
/turf/open/floor/iron/dark,
/area/station/ai_monitored/security/armory)
"f" = (
/obj/effect/turf_decal/tile/red/fourcorners,
/obj/effect/spawner/random/contraband/cannabis,
/obj/effect/spawner/random/contraband/narcotics,
/obj/effect/spawner/random/contraband/permabrig_weapon,
/obj/effect/spawner/random/contraband/armory,
/obj/effect/spawner/random/contraband,
/obj/structure/closet/secure_closet{
	name = "contraband locker";
	req_access = list("armory")
	},
/turf/open/floor/iron/dark,
/area/station/ai_monitored/security/armory)
"g" = (
/obj/effect/turf_decal/stripes/line,
/obj/effect/turf_decal/tile/red{
	dir = 4
	},
/obj/effect/turf_decal/stripes/line{
	dir = 1
	},
/turf/open/floor/iron/dark,
/area/station/ai_monitored/security/armory)
"h" = (
/obj/effect/turf_decal/tile/red{
	dir = 4
	},
/obj/effect/turf_decal/tile/red{
	dir = 8
	},
/obj/effect/turf_decal/stripes/corner{
	dir = 4
	},
/turf/open/floor/iron/dark,
/area/station/ai_monitored/security/armory)
"i" = (
/obj/effect/turf_decal/stripes/line{
	dir = 4
	},
/obj/effect/turf_decal/tile/red{
	dir = 8
	},
/obj/machinery/atmospherics/pipe/smart/manifold4w/supply/hidden/layer4,
/obj/machinery/atmospherics/pipe/smart/manifold4w/scrubbers/hidden/layer2,
/obj/effect/turf_decal/stripes/corner{
	dir = 1
	},
/turf/open/floor/iron/dark,
/area/station/ai_monitored/security/armory)
"k" = (
/obj/machinery/holopad,
/obj/structure/cable,
/obj/effect/turf_decal/tile/red{
	dir = 4
	},
/obj/effect/turf_decal/tile/red{
	dir = 8
	},
/turf/open/floor/iron/dark,
/area/station/ai_monitored/security/armory)
"m" = (
/obj/machinery/power/apc/auto_name/directional/north,
/obj/effect/turf_decal/tile/red{
	dir = 8
	},
/obj/effect/turf_decal/tile/red{
	dir = 4
	},
/obj/machinery/light_switch/directional/west,
/obj/structure/cable,
/obj/effect/turf_decal/stripes/line{
	dir = 4
	},
/turf/open/floor/iron/dark,
/area/station/ai_monitored/security/armory)
"o" = (
/obj/effect/turf_decal/stripes/line,
/obj/effect/turf_decal/tile/red{
	dir = 4
	},
/mob/living/simple_animal/bot/secbot/beepsky/armsky,
/turf/open/floor/iron/dark,
/area/station/ai_monitored/security/armory)
"p" = (
/obj/effect/turf_decal/tile/red{
	dir = 8
	},
/obj/effect/turf_decal/tile/red{
	dir = 4
	},
/obj/structure/cable,
/turf/open/floor/iron/dark,
/area/station/ai_monitored/security/armory)
"r" = (
/obj/structure/rack,
/obj/effect/turf_decal/bot,
/obj/effect/turf_decal/tile/red/fourcorners,
/obj/structure/cable,
/obj/effect/spawner/random/armory/disablers,
/turf/open/floor/iron/dark,
/area/station/ai_monitored/security/armory)
"t" = (
/obj/effect/turf_decal/tile/red{
	dir = 8
	},
/obj/effect/turf_decal/tile/red{
	dir = 4
	},
/obj/structure/cable,
/obj/machinery/light/directional/north,
/obj/structure/rack,
/obj/effect/spawner/armory_spawn/smg,
/obj/effect/turf_decal/bot,
/obj/structure/sign/poster/official/carwo_magazine/directional/north,
/turf/open/floor/iron/dark,
/area/station/ai_monitored/security/armory)
"u" = (
/obj/effect/turf_decal/tile/red{
	dir = 4
	},
/obj/effect/turf_decal/tile/red{
	dir = 8
	},
/obj/structure/cable,
/turf/open/floor/iron/dark,
/area/station/ai_monitored/security/armory)
"v" = (
/obj/effect/turf_decal/tile/red{
	dir = 8
	},
/obj/effect/turf_decal/tile/red{
	dir = 4
	},
/obj/structure/cable,
/obj/effect/spawner/armory_spawn/shotguns,
/obj/structure/rack,
/obj/effect/turf_decal/bot,
/turf/open/floor/iron/dark,
/area/station/ai_monitored/security/armory)
"w" = (
/obj/effect/turf_decal/stripes/line{
	dir = 1
	},
/obj/effect/turf_decal/stripes/corner{
	dir = 8
	},
/obj/machinery/atmospherics/pipe/smart/manifold4w/scrubbers/hidden/layer2,
/turf/open/floor/iron/dark,
/area/station/ai_monitored/security/armory)
"y" = (
/obj/effect/turf_decal/stripes/line,
/obj/effect/turf_decal/tile/red{
	dir = 4
	},
/turf/open/floor/iron/dark,
/area/station/ai_monitored/security/armory)
"A" = (
/obj/effect/turf_decal/stripes/line,
/obj/effect/turf_decal/stripes/line{
	dir = 1
	},
/obj/machinery/atmospherics/pipe/smart/manifold4w/scrubbers/hidden/layer2,
/turf/open/floor/iron/dark,
/area/station/ai_monitored/security/armory)
"B" = (
/obj/effect/turf_decal/stripes/line{
	dir = 4
	},
/obj/effect/turf_decal/tile/red{
	dir = 8
	},
/obj/machinery/atmospherics/pipe/smart/manifold4w/supply/hidden/layer4,
/obj/machinery/atmospherics/pipe/smart/manifold4w/scrubbers/hidden/layer2,
/obj/structure/cable,
/turf/open/floor/iron/dark,
/area/station/ai_monitored/security/armory)
"C" = (
/obj/structure/rack,
/obj/structure/sign/nanotrasen{
	pixel_x = 32
	},
/obj/effect/turf_decal/tile/red/fourcorners,
/obj/effect/spawner/random/armory/riot_armor,
/obj/effect/spawner/random/armory/riot_helmet,
/obj/effect/spawner/random/armory/riot_shield,
/obj/machinery/light/directional/east,
/turf/open/floor/iron/dark,
/area/station/ai_monitored/security/armory)
"D" = (
/obj/effect/turf_decal/tile/red{
	dir = 4
	},
/obj/effect/turf_decal/stripes/line,
/obj/structure/cable,
/turf/open/floor/iron/dark,
/area/station/ai_monitored/security/armory)
"E" = (
/obj/structure/rack,
/obj/machinery/button/door/directional/south{
	id = "armory";
	name = "Armory Shutters";
	req_access = list("armory")
	},
/obj/item/gun/energy/temperature/security,
/turf/open/floor/iron/dark,
/area/station/ai_monitored/security/armory)
"F" = (
/obj/effect/turf_decal/stripes/line{
	dir = 4
	},
/obj/effect/turf_decal/tile/red{
	dir = 8
	},
/turf/open/floor/iron/dark,
/area/station/ai_monitored/security/armory)
"G" = (
/obj/effect/turf_decal/bot,
/obj/structure/rack,
/obj/effect/turf_decal/tile/red/fourcorners,
/turf/open/floor/iron/dark,
/area/station/ai_monitored/security/armory)
"H" = (
/obj/structure/rack,
/obj/effect/turf_decal/tile/red/fourcorners,
/obj/effect/spawner/random/armory/bulletproof_armor,
/obj/effect/spawner/random/armory/bulletproof_helmet,
/turf/open/floor/iron/dark,
/area/station/ai_monitored/security/armory)
"I" = (
/obj/effect/turf_decal/stripes/corner,
/obj/effect/turf_decal/tile/red{
	dir = 4
	},
/obj/effect/turf_decal/tile/red{
	dir = 8
	},
/obj/effect/turf_decal/stripes/line{
	dir = 1
	},
/turf/open/floor/iron/dark,
/area/station/ai_monitored/security/armory)
"J" = (
/obj/effect/turf_decal/stripes/line{
	dir = 1
	},
/obj/effect/turf_decal/tile/red{
	dir = 8
	},
/obj/machinery/atmospherics/pipe/smart/manifold4w/scrubbers/hidden/layer2,
/turf/open/floor/iron/dark,
/area/station/ai_monitored/security/armory)
"L" = (
/obj/effect/turf_decal/stripes/line,
/obj/effect/turf_decal/stripes/corner{
	dir = 4
	},
/obj/machinery/atmospherics/components/unary/vent_scrubber/on/layer2{
	dir = 4
	},
/turf/open/floor/iron/dark,
/area/station/ai_monitored/security/armory)
"M" = (
/obj/effect/turf_decal/tile/red{
	dir = 4
	},
/obj/effect/turf_decal/tile/red{
	dir = 8
	},
/turf/open/floor/iron/dark,
/area/station/ai_monitored/security/armory)
"N" = (
/obj/machinery/recharger,
/obj/structure/table/reinforced,
/obj/structure/sign/poster/official/random/directional/south,
/turf/open/floor/iron/dark,
/area/station/ai_monitored/security/armory)
"O" = (
/obj/structure/rack,
/obj/structure/sign/poster/official/random/directional/east,
/obj/effect/turf_decal/tile/red/fourcorners,
/obj/effect/spawner/random/armory/bulletproof_armor,
/obj/effect/spawner/random/armory/bulletproof_helmet,
/turf/open/floor/iron/dark,
/area/station/ai_monitored/security/armory)
"R" = (
/obj/effect/turf_decal/tile/red{
	dir = 8
	},
/obj/effect/turf_decal/tile/red{
	dir = 4
	},
/obj/structure/cable,
/obj/effect/turf_decal/stripes/line{
	dir = 8
	},
/turf/open/floor/iron/dark,
/area/station/ai_monitored/security/armory)
"S" = (
/obj/effect/turf_decal/tile/red/fourcorners,
/obj/structure/closet/secure_closet/armory2,
/obj/item/storage/box/rubbershot,
/turf/open/floor/iron/dark,
/area/station/ai_monitored/security/armory)
"T" = (
/obj/effect/turf_decal/stripes/line{
	dir = 4
	},
/obj/effect/turf_decal/tile/red{
	dir = 8
	},
/obj/machinery/atmospherics/pipe/smart/manifold4w/supply/hidden/layer4,
/obj/machinery/atmospherics/pipe/smart/manifold4w/scrubbers/hidden/layer2,
/obj/effect/turf_decal/stripes/line{
	dir = 8
	},
/turf/open/floor/iron/dark,
/area/station/ai_monitored/security/armory)
"U" = (
/obj/effect/turf_decal/stripes/line{
	dir = 8
	},
/obj/effect/turf_decal/tile/red{
	dir = 4
	},
/turf/open/floor/iron/dark,
/area/station/ai_monitored/security/armory)
"V" = (
/obj/effect/turf_decal/stripes/line{
	dir = 4
	},
/obj/effect/turf_decal/tile/red{
	dir = 8
	},
/obj/machinery/atmospherics/pipe/smart/manifold4w/supply/hidden/layer4,
/obj/machinery/atmospherics/pipe/smart/manifold4w/scrubbers/hidden/layer2,
/obj/effect/turf_decal/stripes/corner{
	dir = 8
	},
/turf/open/floor/iron/dark,
/area/station/ai_monitored/security/armory)
"W" = (
/obj/effect/turf_decal/tile/red{
	dir = 4
	},
/obj/effect/turf_decal/tile/red{
	dir = 8
	},
/obj/machinery/atmospherics/pipe/smart/manifold4w/scrubbers/hidden/layer2,
/obj/effect/turf_decal/stripes/line{
	dir = 1
	},
/obj/structure/cable,
/turf/open/floor/iron/dark,
/area/station/ai_monitored/security/armory)
"Y" = (
/obj/effect/turf_decal/stripes/line{
	dir = 4
	},
/obj/effect/turf_decal/tile/red{
	dir = 8
	},
/obj/machinery/atmospherics/components/unary/vent_pump/on/layer4{
	dir = 1
	},
/turf/open/floor/iron/dark,
/area/station/ai_monitored/security/armory)

(1,1,1) = {"
m
h
M
y
E
"}
(2,1,1) = {"
t
I
F
L
N
"}
(3,1,1) = {"
v
g
a
A
d
"}
(4,1,1) = {"
R
e
b
w
U
"}
(5,1,1) = {"
k
o
G
J
M
"}
(6,1,1) = {"
p
D
r
W
u
"}
(7,1,1) = {"
B
V
T
i
Y
"}
(8,1,1) = {"
f
S
O
H
C
"}
