"a" = (/obj/structure/table/reinforced,/obj/machinery/door/window{name = "Blacksmith Desk"; req_access = list("cargo")},/obj/machinery/door/firedoor,/turf/open/floor/stone,/area/station/cargo/blacksmith)
"b" = (/obj/structure/reagent_water_basin,/obj/effect/turf_decal/siding/wood{dir = 6},/obj/machinery/light/directional/south,/turf/open/floor/stone,/area/station/cargo/blacksmith)
"c" = (/turf/closed/wall,/area/station/cargo/blacksmith)
"e" = (/obj/structure/cable,/obj/machinery/atmospherics/pipe/smart/manifold4w/supply/hidden/layer4,/obj/machinery/atmospherics/pipe/smart/manifold4w/scrubbers/hidden/layer2,/obj/structure/disposalpipe/segment,/turf/open/floor/catwalk_floor,/area/station/maintenance/floor1/port/fore)
"i" = (/obj/structure/disposalpipe/segment{dir = 4},/obj/effect/turf_decal/tile/yellow,/turf/open/floor/iron/dark/side,/area/station/hallway/floor1/fore)
"j" = (/obj/structure/reagent_anvil,/obj/effect/turf_decal/siding/wood{dir = 8},/obj/machinery/light_switch/directional/west{pixel_y = -8},/obj/machinery/camera/autoname/directional/west,/obj/effect/decal/cleanable/dirt,/turf/open/floor/stone,/area/station/cargo/blacksmith)
"k" = (/obj/structure/cable,/obj/machinery/atmospherics/pipe/smart/manifold4w/supply/hidden/layer4,/obj/machinery/atmospherics/pipe/smart/manifold4w/scrubbers/hidden/layer2,/obj/structure/disposalpipe/segment{dir = 10},/obj/machinery/light/red/dim/directional/east,/turf/open/floor/catwalk_floor,/area/station/maintenance/floor1/port/fore)
"l" = (/obj/structure/cable,/obj/machinery/atmospherics/components/unary/vent_pump/on/layer4{dir = 1},/obj/effect/turf_decal/siding/wood,/obj/machinery/power/apc/auto_name/directional/south,/obj/effect/landmark/start/blacksmith,/obj/effect/decal/cleanable/dirt,/turf/open/floor/stone,/area/station/cargo/blacksmith)
"p" = (/obj/structure/cable,/obj/effect/decal/cleanable/dirt,/turf/open/floor/stone,/area/station/cargo/blacksmith)
"r" = (/obj/structure/cable,/obj/machinery/atmospherics/pipe/smart/manifold4w/supply/hidden/layer4,/obj/effect/decal/cleanable/dirt,/turf/open/floor/stone,/area/station/cargo/blacksmith)
"u" = (/turf/closed/wall,/area/station/maintenance/floor1/port/fore)
"v" = (/obj/structure/cable,/obj/machinery/door/airlock/mining{name = "Blacksmith Workshop"},/obj/effect/mapping_helpers/airlock/access/any/supply/blacksmith,/obj/machinery/door/firedoor,/turf/open/floor/stone,/area/station/cargo/blacksmith)
"w" = (/turf/closed/wall,/area/station/hallway/secondary/entry)
"x" = (/obj/machinery/door/firedoor,/obj/effect/turf_decal/delivery,/turf/open/floor/iron/dark,/area/station/hallway/secondary/entry)
"y" = (/obj/structure/disposalpipe/segment{dir = 4},/obj/effect/turf_decal/tile/yellow{dir = 8},/turf/open/floor/iron/dark/side,/area/station/hallway/floor1/fore)
"z" = (/obj/structure/cable,/obj/machinery/atmospherics/pipe/smart/manifold4w/supply/hidden/layer4,/obj/machinery/atmospherics/pipe/smart/manifold4w/scrubbers/hidden/layer2,/obj/effect/turf_decal/siding/wood{dir = 1},/turf/open/floor/stone,/area/station/cargo/blacksmith)
"A" = (/obj/structure/cable,/obj/machinery/atmospherics/pipe/smart/manifold4w/supply/hidden/layer4,/obj/machinery/atmospherics/pipe/smart/manifold4w/scrubbers/hidden/layer2,/turf/open/floor/catwalk_floor,/area/station/maintenance/floor1/port/fore)
"B" = (/obj/structure/cable,/obj/machinery/atmospherics/pipe/smart/manifold4w/supply/hidden/layer4,/obj/machinery/atmospherics/pipe/smart/manifold4w/scrubbers/hidden/layer2,/obj/structure/disposalpipe/segment{dir = 9},/turf/open/floor/catwalk_floor,/area/station/maintenance/floor1/port/fore)
"C" = (/obj/effect/turf_decal/tile/green{dir = 1},/obj/structure/sign/poster/official/random/directional/west,/turf/open/floor/iron/dark/side,/area/station/hallway/secondary/entry)
"D" = (/obj/machinery/atmospherics/components/unary/vent_scrubber/on/layer2{dir = 8},/obj/effect/turf_decal/siding/wood{dir = 5},/obj/machinery/requests_console/directional/west{department = "Blacksmiths Workshop"; name = "Blacksmiths Requests console"; pixel_x = 28},/obj/effect/decal/cleanable/dirt,/turf/open/floor/stone,/area/station/cargo/blacksmith)
"E" = (/obj/machinery/atmospherics/components/unary/vent_pump/on/layer4{dir = 1},/obj/structure/disposalpipe/segment{dir = 4},/turf/open/floor/iron/dark/side,/area/station/hallway/floor1/fore)
"F" = (/obj/structure/closet/emcloset,/turf/open/floor/iron/dark,/area/station/hallway/floor1/fore)
"G" = (/obj/structure/disposalpipe/segment{dir = 4},/obj/structure/extinguisher_cabinet/directional/south,/turf/open/floor/iron/dark/side,/area/station/hallway/floor1/fore)
"H" = (/obj/structure/disposalpipe/segment{dir = 4},/obj/effect/turf_decal/tile/brown{dir = 8},/obj/effect/turf_decal/tile/brown,/turf/open/floor/iron/dark/side,/area/station/hallway/floor1/fore)
"L" = (/obj/structure/disposalpipe/segment{dir = 4},/turf/open/floor/iron/dark/side,/area/station/hallway/floor1/fore)
"N" = (/obj/structure/reagent_forge,/obj/effect/turf_decal/siding/wood{dir = 10},/obj/machinery/airalarm/directional/west,/obj/effect/decal/cleanable/dirt,/turf/open/floor/stone,/area/station/cargo/blacksmith)
"Q" = (/obj/effect/turf_decal/tile/green/anticorner/contrasted{dir = 1},/obj/machinery/light/directional/north,/obj/structure/cable,/turf/open/floor/iron,/area/station/hallway/secondary/entry)
"W" = (/obj/structure/cable,/obj/machinery/atmospherics/pipe/smart/manifold4w/supply/hidden/layer4,/obj/machinery/atmospherics/pipe/smart/manifold4w/scrubbers/hidden/layer2,/obj/effect/turf_decal/siding/wood{dir = 1},/obj/effect/landmark/start/blacksmith,/turf/open/floor/stone,/area/station/cargo/blacksmith)
"Y" = (/obj/machinery/door/airlock/hatch{name = "Maintenance Access"},/obj/structure/cable,/obj/machinery/atmospherics/pipe/smart/manifold4w/supply/hidden/layer4,/obj/machinery/atmospherics/pipe/smart/manifold4w/scrubbers/hidden/layer2,/obj/effect/mapping_helpers/airlock/access/any/supply/blacksmith,/turf/open/floor/plating,/area/station/cargo/blacksmith)
"Z" = (/obj/effect/spawner/structure/window/reinforced,/turf/open/floor/plating,/area/station/cargo/blacksmith)

(1,1,1) = {"
LGiHyEL
uuZaZcF
AYzWDcw
kujrpvQ
euNlbcC
Buccccx
"}
