//MAP CONVERTED BY dmm2tgm.py THIS HEADER COMMENT PREVENTS RECONVERSION, DO NOT REMOVE
"a" = (
/turf/closed/wall/mineral/titanium/shuttle_wall/arrivals{
	icon_state = "11,0";
	dir = 4
	},
/area/shuttle/arrival)
"b" = (
/obj/machinery/door/airlock/external,
/turf/open/floor/iron/shuttle/arrivals,
/area/shuttle/arrival)
"c" = (
/turf/closed/wall/mineral/titanium/shuttle_wall/window/arrivals{
	icon_state = "5,0";
	dir = 8
	},
/area/shuttle/arrival)
"d" = (
/turf/closed/wall/mineral/titanium/shuttle_wall/window/arrivals{
	icon_state = "4,0";
	dir = 4
	},
/area/shuttle/arrival)
"e" = (
/turf/closed/wall/mineral/titanium/shuttle_wall/arrivals{
	icon_state = "3,3"
	},
/area/shuttle/arrival)
"f" = (
/obj/machinery/light/small/dim/directional/south,
/turf/open/floor/iron/shuttle/arrivals{
	icon_state = "sign_3"
	},
/area/shuttle/arrival)
"g" = (
/obj/machinery/door/airlock/silver/glass,
/turf/closed/wall/mineral/titanium/shuttle_wall/arrivals{
	icon_state = "floor"
	},
/area/shuttle/arrival)
"h" = (
/obj/structure/chair/comfy/shuttle{
	dir = 1
	},
/turf/closed/wall/mineral/titanium/shuttle_wall/arrivals{
	icon_state = "floor"
	},
/area/shuttle/arrival)
"j" = (
/obj/machinery/light/small/dim/directional/south,
/obj/structure/chair/sofa/bench/solo{
	dir = 1
	},
/turf/closed/wall/mineral/titanium/shuttle_wall/arrivals{
	icon_state = "floor"
	},
/area/shuttle/arrival)
"k" = (
/turf/closed/wall/mineral/titanium/shuttle_wall/window/arrivals{
	icon_state = "5,0";
	dir = 4
	},
/area/shuttle/arrival)
"l" = (
/turf/closed/wall/mineral/titanium/shuttle_wall/arrivals{
	dir = 8
	},
/area/shuttle/arrival)
"m" = (
/obj/machinery/computer/shuttle/arrivals{
	icon_state = "computer_left";
	pixel_y = -16
	},
/turf/closed/wall/mineral/titanium/shuttle_wall/window/arrivals{
	icon_state = "8,0";
	dir = 1
	},
/area/shuttle/arrival)
"n" = (
/turf/closed/wall/mineral/titanium/shuttle_wall/arrivals{
	icon_state = "12,2";
	dir = 8
	},
/area/shuttle/arrival)
"o" = (
/turf/closed/wall/mineral/titanium/shuttle_wall/arrivals{
	icon_state = "11,0";
	dir = 1
	},
/area/shuttle/arrival)
"p" = (
/turf/closed/wall/mineral/titanium/shuttle_wall/arrivals{
	icon_state = "0,3";
	dir = 4
	},
/area/shuttle/arrival)
"q" = (
/turf/closed/wall/mineral/titanium/shuttle_wall/window/arrivals{
	icon_state = "7,0";
	dir = 8
	},
/area/shuttle/arrival)
"r" = (
/turf/closed/wall/mineral/titanium/shuttle_wall/arrivals{
	icon_state = "6,0";
	dir = 4
	},
/area/shuttle/arrival)
"t" = (
/turf/closed/wall/mineral/titanium/shuttle_wall/window/arrivals{
	icon_state = "7,0";
	dir = 4
	},
/area/shuttle/arrival)
"v" = (
/turf/closed/wall/mineral/titanium/shuttle_wall/arrivals{
	icon_state = "0,1";
	dir = 4
	},
/area/shuttle/arrival)
"w" = (
/obj/machinery/computer/shuttle/arrivals{
	icon_state = "computer_right";
	pixel_y = -16
	},
/turf/closed/wall/mineral/titanium/shuttle_wall/window/arrivals{
	icon_state = "4,0";
	dir = 1
	},
/area/shuttle/arrival)
"x" = (
/turf/closed/wall/mineral/titanium/shuttle_wall/arrivals{
	icon_state = "9,3";
	dir = 1
	},
/area/shuttle/arrival)
"y" = (
/turf/closed/wall/mineral/titanium/shuttle_wall/arrivals{
	icon_state = "3,0";
	dir = 8
	},
/area/shuttle/arrival)
"A" = (
/turf/closed/wall/mineral/titanium/shuttle_wall/window/arrivals{
	icon_state = "4,0";
	dir = 8
	},
/area/shuttle/arrival)
"B" = (
/turf/closed/wall/mineral/titanium/shuttle_wall/arrivals{
	icon_state = "11,3";
	dir = 8
	},
/area/shuttle/arrival)
"D" = (
/turf/closed/wall/mineral/titanium/shuttle_wall/arrivals{
	icon_state = "12,0";
	dir = 4
	},
/area/shuttle/arrival)
"E" = (
/turf/closed/wall/mineral/titanium/shuttle_wall/window/arrivals{
	icon_state = "8,0";
	dir = 8
	},
/area/shuttle/arrival)
"G" = (
/turf/closed/wall/mineral/titanium/shuttle_wall/arrivals{
	icon_state = "0,0";
	dir = 8
	},
/area/shuttle/arrival)
"H" = (
/turf/closed/wall/mineral/titanium/shuttle_wall/arrivals{
	icon_state = "0,2";
	dir = 4
	},
/area/shuttle/arrival)
"I" = (
/turf/closed/wall/mineral/titanium/shuttle_wall/window/arrivals{
	icon_state = "8,0";
	dir = 4
	},
/area/shuttle/arrival)
"J" = (
/turf/open/floor/iron/shuttle/arrivals{
	icon_state = "sign_1"
	},
/area/shuttle/arrival)
"M" = (
/turf/closed/wall/mineral/titanium/shuttle_wall/arrivals{
	icon_state = "6,0";
	dir = 8
	},
/area/shuttle/arrival)
"N" = (
/obj/structure/chair/sofa/bench/solo{
	dir = 1
	},
/turf/closed/wall/mineral/titanium/shuttle_wall/arrivals{
	icon_state = "floor"
	},
/area/shuttle/arrival)
"O" = (
/turf/closed/wall/mineral/titanium/shuttle_wall/arrivals{
	icon_state = "12,3";
	dir = 8
	},
/area/shuttle/arrival)
"R" = (
/turf/closed/wall/mineral/titanium/shuttle_wall/arrivals{
	icon_state = "1,0";
	dir = 4
	},
/area/shuttle/arrival)
"T" = (
/turf/closed/wall/mineral/titanium/shuttle_wall/arrivals{
	icon_state = "floor"
	},
/area/shuttle/arrival)
"U" = (
/turf/closed/wall/mineral/titanium/shuttle_wall/arrivals{
	icon_state = "1,0";
	dir = 1
	},
/area/shuttle/arrival)
"V" = (
/turf/closed/wall/mineral/titanium/shuttle_wall/arrivals{
	icon_state = "1,3";
	dir = 4
	},
/area/shuttle/arrival)
"W" = (
/turf/closed/wall/mineral/titanium/shuttle_wall/arrivals{
	dir = 4
	},
/area/shuttle/arrival)
"X" = (
/turf/closed/wall/mineral/titanium/shuttle_wall/arrivals{
	icon_state = "1,0";
	dir = 8
	},
/area/shuttle/arrival)
"Y" = (
/obj/docking_port/mobile/arrivals_skyrat{
	dir = 1
	},
/turf/closed/wall/mineral/titanium/shuttle_wall/arrivals{
	icon_state = "12,1";
	dir = 8
	},
/area/shuttle/arrival)
"Z" = (
/obj/structure/railing,
/obj/structure/closet/emcloset/anchored,
/turf/open/floor/iron/shuttle/arrivals{
	icon_state = "sign_1"
	},
/area/shuttle/arrival)

(1,1,1) = {"
G
M
A
c
M
q
E
M
X
b
y
V
p
"}
(2,1,1) = {"
U
e
N
j
W
N
f
l
J
J
Z
x
H
"}
(3,1,1) = {"
m
h
T
T
T
T
T
g
T
T
Z
x
v
"}
(4,1,1) = {"
w
h
T
T
T
T
T
g
T
T
Z
x
Y
"}
(5,1,1) = {"
o
e
N
j
W
N
j
W
J
J
Z
x
n
"}
(6,1,1) = {"
D
r
I
t
r
k
d
r
a
b
R
B
O
"}
