//MAP CONVERTED BY dmm2tgm.py THIS HEADER COMMENT PREVENTS RECONVERSION, DO NOT REMOVE
"bb" = (
/obj/machinery/computer/shuttle/arrivals{
	icon_state = "computer_right";
	pixel_y = -16
	},
/turf/closed/wall/mineral/titanium/shuttle_wall/window/arrivals{
	icon_state = "4,0";
	dir = 1
	},
/area/space)
"bc" = (
/turf/closed/wall/mineral/titanium/shuttle_wall/window/arrivals{
	icon_state = "5,0";
	dir = 4
	},
/area/shuttle/arrival)
"el" = (
/obj/machinery/light/small/dim/directional/east,
/turf/open/floor/iron/shuttle/arrivals{
	icon_state = "sign_3"
	},
/area/shuttle/arrival)
"fD" = (
/turf/open/floor/iron/shuttle/arrivals{
	icon_state = "sign_1"
	},
/area/shuttle/arrival)
"gK" = (
/turf/closed/wall/mineral/titanium/shuttle_wall/arrivals{
	icon_state = "12,2";
	dir = 8
	},
/area/shuttle/arrival)
"hu" = (
/turf/closed/wall/mineral/titanium/shuttle_wall/arrivals{
	icon_state = "0,0";
	dir = 8
	},
/area/space)
"iD" = (
/turf/closed/wall/mineral/titanium/shuttle_wall/window/arrivals{
	icon_state = "7,0";
	dir = 8
	},
/area/shuttle/arrival)
"jk" = (
/turf/closed/wall/mineral/titanium/shuttle_wall/window/arrivals{
	icon_state = "4,0";
	dir = 4
	},
/area/shuttle/arrival)
"lB" = (
/turf/closed/wall/mineral/titanium/shuttle_wall/arrivals{
	icon_state = "6,0";
	dir = 8
	},
/area/space)
"mv" = (
/obj/docking_port/mobile/arrivals_skyrat{
	dir = 1
	},
/turf/closed/wall/mineral/titanium/shuttle_wall/arrivals{
	icon_state = "9,3";
	dir = 1
	},
/area/shuttle/arrival)
"mM" = (
/obj/machinery/computer/shuttle/arrivals{
	icon_state = "computer_left";
	pixel_y = -16
	},
/turf/closed/wall/mineral/titanium/shuttle_wall/window/arrivals{
	icon_state = "8,0";
	dir = 1
	},
/area/space)
"pl" = (
/turf/closed/wall/mineral/titanium/shuttle_wall/arrivals{
	dir = 4
	},
/area/shuttle/arrival)
"ps" = (
/obj/structure/chair/sofa/bench/right{
	dir = 8
	},
/obj/machinery/light/small/dim/directional/east,
/turf/open/floor/iron/shuttle/arrivals,
/area/shuttle/arrival)
"pN" = (
/obj/structure/chair/sofa/bench{
	dir = 8
	},
/obj/structure/chair/sofa/bench{
	dir = 4
	},
/turf/open/floor/iron/shuttle/arrivals,
/area/shuttle/arrival)
"so" = (
/obj/machinery/light/small/dim/directional/north,
/obj/structure/chair/sofa/bench/right{
	dir = 8
	},
/turf/open/floor/iron/shuttle/arrivals,
/area/shuttle/arrival)
"tl" = (
/obj/structure/chair/sofa/bench/left{
	dir = 4
	},
/obj/machinery/light/small/dim/directional/west,
/turf/open/floor/iron/shuttle/arrivals,
/area/shuttle/arrival)
"um" = (
/turf/closed/wall/mineral/titanium/shuttle_wall/window/arrivals{
	icon_state = "4,0";
	dir = 8
	},
/area/shuttle/arrival)
"vh" = (
/turf/closed/wall/mineral/titanium/shuttle_wall/arrivals{
	icon_state = "0,2";
	dir = 4
	},
/area/shuttle/arrival)
"vV" = (
/obj/structure/railing,
/obj/structure/closet/emcloset/anchored,
/turf/open/floor/iron/shuttle/arrivals{
	icon_state = "sign_1"
	},
/area/shuttle/arrival)
"wK" = (
/turf/closed/wall/mineral/titanium/shuttle_wall/arrivals{
	icon_state = "6,0";
	dir = 8
	},
/area/shuttle/arrival)
"xf" = (
/obj/structure/chair/sofa/bench{
	dir = 8
	},
/turf/open/floor/iron/shuttle/arrivals,
/area/shuttle/arrival)
"xs" = (
/obj/machinery/light/small/dim/directional/south,
/obj/structure/chair/sofa/bench/left{
	dir = 8
	},
/turf/open/floor/iron/shuttle/arrivals,
/area/shuttle/arrival)
"yx" = (
/turf/closed/wall/mineral/titanium/shuttle_wall/arrivals{
	icon_state = "6,0";
	dir = 4
	},
/area/shuttle/arrival)
"zd" = (
/turf/closed/wall/mineral/titanium/shuttle_wall/arrivals{
	icon_state = "1,0";
	dir = 1
	},
/area/space)
"AW" = (
/turf/closed/wall/mineral/titanium/shuttle_wall/arrivals{
	icon_state = "0,1";
	dir = 4
	},
/area/shuttle/arrival)
"Cw" = (
/turf/closed/wall/mineral/titanium/shuttle_wall/arrivals{
	icon_state = "12,1";
	dir = 8
	},
/area/shuttle/arrival)
"CF" = (
/obj/machinery/light/small/dim/directional/west,
/turf/open/floor/iron/shuttle/arrivals{
	icon_state = "sign_3"
	},
/area/shuttle/arrival)
"CH" = (
/turf/closed/wall/mineral/titanium/shuttle_wall/arrivals{
	icon_state = "3,0";
	dir = 8
	},
/area/shuttle/arrival)
"Dt" = (
/turf/closed/wall/mineral/titanium/shuttle_wall/arrivals{
	icon_state = "12,3";
	dir = 8
	},
/area/shuttle/arrival)
"Eb" = (
/turf/closed/wall/mineral/titanium/shuttle_wall/arrivals{
	icon_state = "1,0";
	dir = 4
	},
/area/shuttle/arrival)
"ES" = (
/obj/structure/railing,
/obj/structure/closet/emcloset/anchored,
/obj/machinery/light/small/dim/directional/west,
/turf/open/floor/iron/shuttle/arrivals{
	icon_state = "sign_1"
	},
/area/shuttle/arrival)
"FH" = (
/obj/structure/chair/comfy/shuttle{
	dir = 1
	},
/obj/machinery/light/small/dim/directional/west,
/turf/open/floor/iron/shuttle/arrivals,
/area/space)
"FZ" = (
/obj/structure/chair/comfy/shuttle{
	dir = 1
	},
/obj/machinery/light/small/dim/directional/east,
/turf/open/floor/iron/shuttle/arrivals,
/area/space)
"Go" = (
/obj/structure/chair/sofa/bench{
	dir = 4
	},
/turf/open/floor/iron/shuttle/arrivals,
/area/shuttle/arrival)
"GU" = (
/turf/closed/wall/mineral/titanium/shuttle_wall/arrivals{
	icon_state = "11,3";
	dir = 8
	},
/area/shuttle/arrival)
"Hx" = (
/turf/open/floor/iron/shuttle/arrivals,
/area/shuttle/arrival)
"HJ" = (
/turf/closed/wall/mineral/titanium/shuttle_wall/arrivals{
	icon_state = "9,3";
	dir = 1
	},
/area/shuttle/arrival)
"Kc" = (
/obj/structure/chair/sofa/bench/right{
	dir = 4
	},
/obj/machinery/light/small/dim/directional/west,
/turf/open/floor/iron/shuttle/arrivals,
/area/shuttle/arrival)
"Kx" = (
/turf/closed/wall/mineral/titanium/shuttle_wall/arrivals{
	dir = 8
	},
/area/shuttle/arrival)
"Lf" = (
/turf/closed/wall/mineral/titanium/shuttle_wall/arrivals{
	icon_state = "1,0";
	dir = 8
	},
/area/shuttle/arrival)
"Lp" = (
/turf/closed/wall/mineral/titanium/shuttle_wall/arrivals{
	icon_state = "1,3";
	dir = 4
	},
/area/shuttle/arrival)
"MB" = (
/turf/closed/wall/mineral/titanium/shuttle_wall/window/arrivals{
	icon_state = "7,0";
	dir = 4
	},
/area/shuttle/arrival)
"MH" = (
/turf/closed/wall/mineral/titanium/shuttle_wall/arrivals{
	icon_state = "0,3";
	dir = 4
	},
/area/shuttle/arrival)
"Ne" = (
/turf/closed/wall/mineral/titanium/shuttle_wall/arrivals{
	icon_state = "6,0";
	dir = 4
	},
/area/space)
"PS" = (
/obj/structure/railing,
/obj/structure/closet/emcloset/anchored,
/obj/machinery/light/small/dim/directional/east,
/turf/open/floor/iron/shuttle/arrivals{
	icon_state = "sign_1"
	},
/area/shuttle/arrival)
"QO" = (
/turf/closed/wall/mineral/titanium/shuttle_wall/arrivals{
	icon_state = "11,0";
	dir = 4
	},
/area/shuttle/arrival)
"QV" = (
/obj/machinery/light/small/dim/directional/south,
/obj/structure/chair/sofa/bench/right{
	dir = 4
	},
/turf/open/floor/iron/shuttle/arrivals,
/area/shuttle/arrival)
"RR" = (
/turf/closed/wall/mineral/titanium/shuttle_wall/arrivals{
	icon_state = "12,0";
	dir = 4
	},
/area/space)
"Tx" = (
/turf/closed/wall/mineral/titanium/shuttle_wall/window/arrivals{
	icon_state = "8,0";
	dir = 8
	},
/area/shuttle/arrival)
"Uh" = (
/turf/closed/wall/mineral/titanium/shuttle_wall/window/arrivals{
	icon_state = "5,0";
	dir = 8
	},
/area/shuttle/arrival)
"Uq" = (
/obj/structure/chair/sofa/bench/left{
	dir = 8
	},
/obj/machinery/light/small/dim/directional/east,
/turf/open/floor/iron/shuttle/arrivals,
/area/shuttle/arrival)
"Vw" = (
/turf/closed/wall/mineral/titanium/shuttle_wall/arrivals{
	icon_state = "11,0";
	dir = 1
	},
/area/space)
"VZ" = (
/obj/machinery/light/small/dim/directional/north,
/obj/structure/chair/sofa/bench/left{
	dir = 4
	},
/turf/open/floor/iron/shuttle/arrivals,
/area/shuttle/arrival)
"Xv" = (
/turf/closed/wall/mineral/titanium/shuttle_wall/arrivals{
	icon_state = "3,3"
	},
/area/space)
"ZB" = (
/obj/machinery/door/airlock/external,
/obj/structure/fans/tiny,
/turf/open/floor/iron/shuttle/arrivals{
	icon_state = "sign_1"
	},
/area/shuttle/arrival)
"ZI" = (
/turf/closed/wall/mineral/titanium/shuttle_wall/window/arrivals{
	icon_state = "8,0";
	dir = 4
	},
/area/shuttle/arrival)

(1,1,1) = {"
hu
lB
Lf
ZB
CH
um
Uh
wK
iD
Tx
Lf
ZB
CH
Lp
MH
"}
(2,1,1) = {"
zd
Xv
CF
Hx
tl
pN
QV
Kx
VZ
Go
Kc
fD
ES
mv
vh
"}
(3,1,1) = {"
mM
FH
Hx
Hx
Hx
Hx
Hx
Hx
Hx
Hx
Hx
Hx
vV
HJ
AW
"}
(4,1,1) = {"
bb
FZ
Hx
Hx
Hx
Hx
Hx
Hx
Hx
Hx
Hx
Hx
vV
HJ
Cw
"}
(5,1,1) = {"
Vw
Xv
el
Hx
ps
xf
xs
pl
so
xf
Uq
fD
PS
HJ
gK
"}
(6,1,1) = {"
RR
Ne
Eb
ZB
Eb
ZI
MB
yx
bc
jk
QO
ZB
Eb
GU
Dt
"}
