//MAP CONVERTED BY dmm2tgm.py THIS HEADER COMMENT PREVENTS RECONVERSION, DO NOT REMOVE
"a" = (
/turf/closed/wall/mineral/titanium,
/area/shuttle/escape)
"b" = (
/obj/structure/lattice,
/turf/template_noop,
/area/shuttle/escape)
"c" = (
/obj/machinery/door/airlock/titanium{
	name = "Escape Pod Airlock"
	},
/obj/structure/fans/tiny,
/turf/open/floor/mineral/titanium/blue,
/area/shuttle/escape)
"d" = (
/obj/machinery/power/shuttle_engine/propulsion/burst,
/turf/closed/wall/mineral/titanium,
/area/shuttle/escape)
"j" = (
/obj/structure/chair/comfy/black{
	dir = 1
	},
/turf/open/floor/plating/airless,
/area/shuttle/escape)
"l" = (
/obj/structure/chair/comfy/black,
/turf/open/floor/plating/airless,
/area/shuttle/escape)
"m" = (
/obj/structure/lattice,
/obj/item/stack/rods{
	pixel_y = 4;
	pixel_x = 4;
	amount = 7
	},
/obj/item/storage/toolbox/mechanical{
	pixel_y = -4;
	pixel_x = -5
	},
/turf/template_noop,
/area/shuttle/escape)
"v" = (
/turf/template_noop,
/area/template_noop)
"w" = (
/obj/structure/chair/comfy/shuttle{
	dir = 1
	},
/obj/machinery/light/small/directional/south,
/obj/item/storage/pod/directional/south,
/obj/item/radio/intercom/directional/south,
/turf/open/floor/mineral/titanium/blue,
/area/shuttle/escape)
"B" = (
/obj/effect/spawner/structure/window/reinforced/shuttle,
/turf/open/floor/plating,
/area/shuttle/escape)
"E" = (
/obj/machinery/door/airlock/titanium{
	name = "Escape Pod Airlock"
	},
/obj/structure/fans/tiny,
/obj/effect/mapping_helpers/airlock/access/all/command/general,
/turf/open/floor/mineral/titanium/blue,
/area/shuttle/escape)
"M" = (
/obj/machinery/computer/emergency_shuttle,
/turf/open/floor/mineral/titanium/blue,
/area/shuttle/escape)
"N" = (
/obj/machinery/door/airlock/titanium{
	name = "Escape Pod Airlock"
	},
/obj/structure/fans/tiny,
/obj/docking_port/mobile/emergency{
	name = "A Cluster of Escape Pods"
	},
/turf/open/floor/mineral/titanium/blue,
/area/shuttle/escape)
"R" = (
/obj/structure/chair/comfy/shuttle{
	dir = 1
	},
/obj/machinery/status_display/evac/directional/east,
/obj/structure/decorative{
	icon = 'icons/obj/machines/wallmounts.dmi';
	icon_state = "pod_off";
	pixel_x = -32;
	name = "pod control computer";
	desc = "A computer used to control an escape pod. Looks like it's linked up with an emergency console to avoid independant launch."
	},
/obj/structure/decorative{
	icon = 'icons/obj/machines/wallmounts.dmi';
	icon_state = "pod_on";
	pixel_x = -32;
	name = "pod control computer";
	desc = "A computer used to control an escape pod. Looks like it's linked up with an emergency console to avoid independant launch."
	},
/turf/open/floor/mineral/titanium/blue,
/area/shuttle/escape)
"T" = (
/obj/structure/table/wood/fancy/black,
/obj/item/flashlight/flare/candle{
	pixel_y = 7
	},
/obj/item/reagent_containers/cup/glass/drinkingglass/shotglass{
	pixel_x = -7;
	pixel_y = 3
	},
/obj/item/reagent_containers/cup/glass/drinkingglass/shotglass{
	pixel_x = 7;
	pixel_y = 11
	},
/obj/item/bouquet/rose{
	pixel_y = 1;
	pixel_x = 5
	},
/turf/open/floor/plating/airless,
/area/shuttle/escape)

(1,1,1) = {"
v
v
v
v
v
v
v
a
a
N
d
v
v
a
a
c
d
v
v
v
v
a
a
c
d
v
v
v
"}
(2,1,1) = {"
v
v
v
v
v
v
v
B
R
w
a
v
v
B
R
w
a
v
v
v
v
B
R
w
a
v
v
v
"}
(3,1,1) = {"
v
v
v
v
v
v
v
a
a
c
d
v
v
a
a
c
d
v
v
v
v
a
a
c
d
v
v
v
"}
(4,1,1) = {"
v
v
v
v
v
v
v
v
v
b
v
v
v
v
v
b
v
v
v
v
b
b
b
b
b
b
v
v
"}
(5,1,1) = {"
v
v
a
a
c
d
v
v
v
b
b
b
b
b
b
b
b
b
b
b
b
v
v
a
a
c
d
v
"}
(6,1,1) = {"
v
v
B
R
w
a
v
b
v
b
v
v
v
v
v
v
b
v
a
a
c
d
v
B
R
w
a
v
"}
(7,1,1) = {"
v
v
a
a
c
d
v
b
b
b
b
b
b
b
v
v
v
v
B
R
w
a
v
a
a
c
d
v
"}
(8,1,1) = {"
v
v
v
v
b
b
b
b
v
v
v
a
a
c
d
v
v
v
a
a
c
d
v
v
v
b
v
v
"}
(9,1,1) = {"
v
v
v
v
v
a
a
c
d
v
v
B
R
w
a
v
v
v
b
b
b
b
b
b
b
b
v
v
"}
(10,1,1) = {"
v
v
v
v
v
B
R
w
a
v
v
a
a
c
d
v
a
a
c
d
v
v
v
v
b
v
v
v
"}
(11,1,1) = {"
v
v
v
b
v
a
a
c
d
v
v
v
v
b
v
v
B
R
w
a
v
v
a
a
c
d
v
v
"}
(12,1,1) = {"
v
v
v
b
b
b
b
b
b
b
b
b
b
b
b
b
a
a
c
d
v
v
B
R
w
a
v
v
"}
(13,1,1) = {"
a
a
a
E
d
v
v
v
a
a
c
d
v
v
v
b
b
b
b
v
v
v
a
a
c
d
v
v
"}
(14,1,1) = {"
B
M
R
w
a
v
v
v
B
R
w
a
v
a
a
c
d
v
b
b
m
v
v
v
b
b
b
v
"}
(15,1,1) = {"
a
a
a
E
d
v
v
v
a
a
c
d
v
B
R
w
a
v
v
v
b
v
v
v
a
a
c
d
"}
(16,1,1) = {"
v
v
v
b
v
v
v
v
v
v
b
v
v
a
a
c
d
v
a
a
c
d
v
v
B
R
w
a
"}
(17,1,1) = {"
v
v
v
b
v
v
v
v
v
v
b
b
b
v
v
v
v
v
B
R
w
a
v
v
a
a
c
d
"}
(18,1,1) = {"
v
a
a
c
d
v
v
v
v
v
v
v
b
b
b
b
v
v
a
a
c
d
v
v
v
b
b
v
"}
(19,1,1) = {"
v
B
R
w
a
v
v
v
v
v
a
a
c
d
v
b
b
b
b
b
b
v
v
a
a
c
d
v
"}
(20,1,1) = {"
v
a
a
c
d
v
v
v
v
v
B
R
w
a
v
l
T
j
v
v
b
v
v
B
R
w
a
v
"}
(21,1,1) = {"
v
v
v
v
v
v
v
v
v
v
a
a
c
d
v
v
v
v
v
v
v
v
v
a
a
c
d
v
"}
