"a" = (/turf/closed/wall/mineral/titanium,/area/shuttle/escape)
"b" = (/obj/structure/lattice,/turf/template_noop,/area/shuttle/escape)
"c" = (/obj/machinery/door/airlock/titanium{name = "Escape Pod Airlock"},/obj/structure/fans/tiny,/turf/open/floor/mineral/titanium/blue,/area/shuttle/escape)
"d" = (/obj/machinery/power/shuttle_engine/propulsion/burst,/turf/closed/wall/mineral/titanium,/area/shuttle/escape)
"j" = (/obj/structure/chair/comfy/black{dir = 1},/turf/open/floor/plating/airless,/area/shuttle/escape)
"l" = (/obj/structure/chair/comfy/black,/turf/open/floor/plating/airless,/area/shuttle/escape)
"m" = (/obj/structure/lattice,/obj/item/stack/rods{pixel_y = 4; pixel_x = 4; amount = 7},/obj/item/storage/toolbox/mechanical{pixel_y = -4; pixel_x = -5},/turf/template_noop,/area/shuttle/escape)
"v" = (/turf/template_noop,/area/template_noop)
"w" = (/obj/structure/chair/comfy/shuttle{dir = 1},/obj/machinery/light/small/directional/south,/obj/item/storage/pod/directional/south,/obj/item/radio/intercom/directional/south,/turf/open/floor/mineral/titanium/blue,/area/shuttle/escape)
"B" = (/obj/effect/spawner/structure/window/reinforced/shuttle,/turf/open/floor/plating,/area/shuttle/escape)
"E" = (/obj/machinery/door/airlock/titanium{name = "Escape Pod Airlock"},/obj/structure/fans/tiny,/obj/effect/mapping_helpers/airlock/access/all/command/general,/turf/open/floor/mineral/titanium/blue,/area/shuttle/escape)
"M" = (/obj/machinery/computer/emergency_shuttle,/turf/open/floor/mineral/titanium/blue,/area/shuttle/escape)
"N" = (/obj/machinery/door/airlock/titanium{name = "Escape Pod Airlock"},/obj/structure/fans/tiny,/obj/docking_port/mobile/emergency{name = "A Cluster of Escape Pods"},/turf/open/floor/mineral/titanium/blue,/area/shuttle/escape)
"R" = (/obj/structure/chair/comfy/shuttle{dir = 1},/obj/machinery/status_display/evac/directional/east,/obj/structure/decorative{icon = 'icons/obj/machines/wallmounts.dmi'; icon_state = "pod_off"; pixel_x = -32; name = "pod control computer"; desc = "A computer used to control an escape pod. Looks like it's linked up with an emergency console to avoid independant launch."},/obj/structure/decorative{icon = 'icons/obj/machines/wallmounts.dmi'; icon_state = "pod_on"; pixel_x = -32; name = "pod control computer"; desc = "A computer used to control an escape pod. Looks like it's linked up with an emergency console to avoid independant launch."},/turf/open/floor/mineral/titanium/blue,/area/shuttle/escape)
"T" = (/obj/structure/table/wood/fancy/black,/obj/item/flashlight/flare/candle{pixel_y = 7},/obj/item/reagent_containers/cup/glass/drinkingglass/shotglass{pixel_x = -7; pixel_y = 3},/obj/item/reagent_containers/cup/glass/drinkingglass/shotglass{pixel_x = 7; pixel_y = 11},/obj/item/bouquet/rose{pixel_y = 1; pixel_x = 5},/turf/open/floor/plating/airless,/area/shuttle/escape)

(1,1,1) = {"
vvvvvvvvvvvvaBavvvvvv
vvvvvvvvvvvvaMavvaBav
vvvvaBavvvvvaRavvaRav
vvvvaRavvvbbEwEbbcwcv
vvvvcwcbvvvbdadvvdadv
vvvvdadbaBabvvvvvvvvv
vvvvvvvbaRabvvvvvvvvv
aBavvbbbcwcbvvvvvvvvv
aRavvvbvdadbaBavvvvvv
NwcbbbbvvvvbaRavvvvvv
dadvbvbvvvvbcwcbbvaBa
vvvvbvbaBavbdadvbvaRa
vvvvbvbaRavbvvvvbbcwc
aBavbvbcwcbbvaBavbdad
aRavbvvdadvbvaRavbvvv
cwcbbvvvvvvbbcwcvbblv
dadvbbvvvaBabdadvvbTv
vvvvbvvvvaRabvvvvvbjv
vvvvbaBabcwcbbvaBabvv
vvvvbaRabdadvbvaRabvv
vvvbbcwcbvvvvmbcwcbbv
aBabvdadbvvvvvvdadvvv
aRabvvvvbvaBavvvvvvvv
cwcbaBavbvaRavvvvvaBa
dadbaRavbbcwcbaBavaRa
vvvbcwcbbvdadbaRabcwc
vvvvdadvvvvvvbcwcbdad
vvvvvvvvvvvvvvdadvvvv
"}
