//MAP CONVERTED BY dmm2tgm.py THIS HEADER COMMENT PREVENTS RECONVERSION, DO NOT REMOVE
"aC" = (
/obj/structure/closet/toolcloset,
/obj/effect/decal/cleanable/cobweb/cobweb2,
/obj/structure/sign/warning/directional/east,
/obj/effect/spawner/random/maintenance/five,
/turf/open/floor/plating/rust,
/area/shuttle/escape)
"aN" = (
/obj/structure/closet/firecloset,
/turf/open/floor/iron,
/area/shuttle/escape)
"aQ" = (
/obj/machinery/light/small/directional/east,
/obj/structure/closet/crate/coffin,
/turf/open/floor/iron/freezer,
/area/shuttle/escape)
"aX" = (
/obj/structure/chair/sofa/middle/brown,
/mob/living/basic/gorilla{
	faction = list("hostile")
	},
/turf/open/floor/iron,
/area/shuttle/escape)
"aY" = (
/obj/structure/closet,
/obj/effect/spawner/random/entertainment/money_small,
/obj/effect/spawner/random/maintenance/two,
/turf/open/floor/iron/freezer,
/area/shuttle/escape)
"be" = (
/obj/machinery/status_display/evac,
/turf/closed/wall/rust,
/area/shuttle/escape)
"bf" = (
/obj/effect/decal/cleanable/blood/old,
/turf/open/floor/iron,
/area/shuttle/escape)
"bq" = (
/obj/machinery/power/emitter{
	dir = 4
	},
/turf/open/floor/iron/freezer,
/area/shuttle/escape)
"ct" = (
/obj/structure/lattice,
/obj/structure/marker_beacon/olive,
/turf/template_noop,
/area/shuttle/escape)
"cM" = (
/obj/effect/spawner/structure/window/reinforced/plasma,
/turf/open/floor/plating,
/area/shuttle/escape)
"dr" = (
/mob/living/basic/gorilla{
	faction = list("hostile")
	},
/turf/open/floor/iron,
/area/shuttle/escape)
"dO" = (
/obj/machinery/cell_charger,
/turf/open/floor/plating,
/area/shuttle/escape)
"ei" = (
/obj/structure/chair/comfy/shuttle{
	dir = 8
	},
/turf/open/floor/mineral/plastitanium/red,
/area/shuttle/escape/brig)
"eW" = (
/obj/structure/chair/sofa/middle/brown,
/mob/living/basic/gorilla{
	faction = list("hostile")
	},
/turf/open/floor/plating,
/area/shuttle/escape)
"fc" = (
/obj/structure/broken_flooring/pile/directional/east,
/turf/open/floor/plating,
/area/shuttle/escape)
"fq" = (
/obj/structure/closet/crate/solarpanel_small,
/turf/open/floor/iron/freezer,
/area/shuttle/escape)
"gf" = (
/turf/closed/wall/r_wall/rust,
/area/shuttle/escape)
"gk" = (
/obj/machinery/power/shuttle_engine/propulsion,
/turf/open/floor/plating/airless,
/area/shuttle/escape)
"gI" = (
/obj/machinery/door/airlock/security/old/glass{
	name = "Emergency Shuttle Brig"
	},
/obj/effect/mapping_helpers/airlock/access/all/security/general,
/turf/open/floor/iron,
/area/shuttle/escape/brig)
"gZ" = (
/obj/machinery/computer/emergency_shuttle,
/turf/open/floor/wood,
/area/shuttle/escape)
"hF" = (
/obj/machinery/light/small/directional/east,
/obj/machinery/shieldgen,
/turf/open/floor/iron/freezer,
/area/shuttle/escape)
"hP" = (
/obj/structure/chair/comfy/shuttle{
	dir = 4
	},
/turf/open/floor/mineral/plastitanium/red,
/area/shuttle/escape/brig)
"ig" = (
/obj/machinery/computer/crew,
/turf/open/floor/wood,
/area/shuttle/escape)
"im" = (
/obj/machinery/power/emitter,
/turf/open/floor/iron/freezer,
/area/shuttle/escape)
"iH" = (
/obj/effect/spawner/structure/window/reinforced/plasma,
/obj/structure/barricade/wooden/crude,
/obj/effect/mapping_helpers/damaged_window,
/turf/open/floor/plating,
/area/shuttle/escape)
"je" = (
/obj/structure/closet/crate/medical,
/obj/item/defibrillator,
/obj/item/defibrillator{
	pixel_y = 5
	},
/obj/item/stock_parts/power_store/cell/high/empty{
	pixel_y = 5;
	pixel_x = 4
	},
/obj/item/stock_parts/power_store/cell/high,
/obj/item/stock_parts/power_store/cell/high/empty{
	pixel_y = -5;
	pixel_x = -9
	},
/obj/item/stock_parts/power_store/cell/high/empty{
	pixel_y = -7;
	pixel_x = 2
	},
/turf/open/floor/iron/freezer,
/area/shuttle/escape)
"jX" = (
/obj/structure/closet,
/obj/effect/spawner/random/entertainment/money_small,
/obj/effect/spawner/random/maintenance/three,
/turf/open/floor/iron/freezer,
/area/shuttle/escape)
"kv" = (
/obj/effect/turf_decal/stripes/corner{
	dir = 4
	},
/turf/open/floor/iron,
/area/shuttle/escape)
"kP" = (
/obj/effect/spawner/structure/window/reinforced,
/turf/open/floor/plating,
/area/shuttle/escape)
"kY" = (
/turf/template_noop,
/area/space)
"lp" = (
/obj/machinery/light/small/directional/south,
/turf/open/floor/mineral/plastitanium/red,
/area/shuttle/escape/brig)
"lS" = (
/obj/structure/chair/sofa/left/brown,
/turf/open/floor/plating,
/area/shuttle/escape)
"lX" = (
/obj/effect/decal/cleanable/dirt/dust,
/turf/open/floor/iron/freezer,
/area/shuttle/escape)
"me" = (
/obj/structure/chair/greyscale{
	dir = 4
	},
/turf/open/floor/iron,
/area/shuttle/escape)
"mA" = (
/obj/effect/decal/cleanable/dirt/dust,
/turf/open/floor/plating/rust,
/area/shuttle/escape)
"mD" = (
/obj/structure/closet/crate/freezer/blood,
/turf/open/floor/iron/freezer,
/area/shuttle/escape)
"mP" = (
/obj/structure/chair/sofa/middle/brown,
/obj/machinery/light/small/directional/north,
/turf/open/floor/iron,
/area/shuttle/escape)
"nc" = (
/obj/effect/decal/cleanable/dirt/dust,
/turf/open/floor/plating,
/area/shuttle/escape)
"ng" = (
/obj/machinery/computer/operating,
/turf/open/floor/plating,
/area/shuttle/escape)
"nA" = (
/obj/structure/broken_flooring/pile/directional/east,
/obj/effect/turf_decal/stripes/line{
	dir = 4
	},
/turf/open/floor/plating,
/area/shuttle/escape)
"nK" = (
/obj/structure/closet/crate/freezer/surplus_limbs,
/turf/open/floor/plating,
/area/shuttle/escape)
"nO" = (
/obj/structure/table/optable,
/obj/effect/spawner/surgery_tray/full,
/obj/effect/decal/cleanable/blood/old,
/turf/open/floor/iron/freezer,
/area/shuttle/escape)
"os" = (
/obj/structure/table/wood,
/obj/machinery/recharger,
/turf/open/floor/wood,
/area/shuttle/escape)
"oB" = (
/obj/machinery/light/small/directional/west,
/obj/structure/reagent_dispensers/beerkeg,
/turf/open/floor/plating,
/area/shuttle/escape)
"oY" = (
/obj/effect/turf_decal/stripes/line{
	dir = 4
	},
/turf/open/floor/plating/rust,
/area/shuttle/escape)
"pY" = (
/obj/effect/decal/cleanable/dirt/dust,
/turf/open/floor/iron,
/area/shuttle/escape)
"qk" = (
/obj/effect/turf_decal/stripes/line{
	dir = 8
	},
/obj/machinery/door/poddoor/shutters/window{
	dir = 8;
	id = "gorillabay"
	},
/turf/open/floor/iron,
/area/shuttle/escape)
"rt" = (
/obj/effect/decal/cleanable/dirt/dust,
/obj/structure/closet/cardboard,
/obj/effect/spawner/random/maintenance/six,
/turf/open/floor/iron/freezer,
/area/shuttle/escape)
"rv" = (
/obj/effect/decal/cleanable/blood/trail,
/turf/open/floor/iron/freezer,
/area/shuttle/escape)
"rN" = (
/obj/effect/decal/cleanable/dirt/dust,
/obj/item/radio/intercom/directional/south,
/turf/open/floor/wood,
/area/shuttle/escape)
"sP" = (
/turf/closed/wall/r_wall,
/area/shuttle/escape)
"tL" = (
/obj/structure/lattice,
/obj/structure/marker_beacon/burgundy,
/turf/template_noop,
/area/shuttle/escape)
"ub" = (
/obj/structure/sign/warning/directional/south,
/turf/open/floor/plating,
/area/shuttle/escape)
"um" = (
/obj/machinery/light/small/directional/east,
/obj/structure/closet/crate/freezer/surplus_limbs,
/turf/open/floor/iron/freezer,
/area/shuttle/escape)
"uC" = (
/turf/open/floor/plating/rust,
/area/shuttle/escape)
"wj" = (
/obj/machinery/power/shieldwallgen/unlocked,
/turf/open/floor/iron/freezer,
/area/shuttle/escape)
"wy" = (
/obj/effect/decal/cleanable/glass,
/turf/open/floor/plating/rust,
/area/shuttle/escape)
"xf" = (
/obj/structure/trash_pile,
/turf/open/floor/plating,
/area/shuttle/escape)
"xt" = (
/obj/effect/decal/cleanable/dirt/dust,
/turf/open/floor/wood,
/area/shuttle/escape)
"xJ" = (
/mob/living/basic/gorilla{
	faction = list("hostile")
	},
/turf/open/floor/plating,
/area/shuttle/escape)
"xY" = (
/obj/structure/chair/comfy/shuttle{
	dir = 4
	},
/turf/open/floor/wood,
/area/shuttle/escape)
"ya" = (
/obj/structure/chair/comfy/shuttle{
	dir = 8
	},
/turf/open/floor/wood,
/area/shuttle/escape)
"yH" = (
/obj/structure/table/wood,
/obj/machinery/light/small/directional/east,
/obj/structure/extinguisher_cabinet/directional/east,
/turf/open/floor/wood,
/area/shuttle/escape)
"zg" = (
/obj/effect/decal/cleanable/dirt/dust,
/obj/structure/toilet{
	dir = 4
	},
/turf/open/floor/iron/freezer,
/area/shuttle/escape)
"zx" = (
/obj/structure/closet/cardboard,
/obj/structure/sign/warning/directional/south,
/obj/effect/spawner/random/maintenance/six,
/turf/open/floor/iron/freezer,
/area/shuttle/escape)
"zG" = (
/obj/structure/closet/crate/medical,
/obj/item/storage/medkit/regular{
	pixel_y = -5
	},
/obj/item/storage/medkit/regular{
	pixel_x = 2;
	pixel_y = 3
	},
/obj/item/storage/medkit/regular,
/obj/effect/spawner/random/medical/medkit_rare,
/turf/open/floor/iron/freezer,
/area/shuttle/escape)
"zI" = (
/obj/structure/broken_flooring/side/directional/south,
/turf/open/floor/plating,
/area/shuttle/escape)
"Aj" = (
/obj/effect/spawner/random/maintenance/five,
/turf/open/floor/iron/freezer,
/area/shuttle/escape)
"AJ" = (
/obj/structure/closet/crate/coffin,
/turf/open/floor/iron/freezer,
/area/shuttle/escape)
"Bv" = (
/obj/structure/chair/comfy/shuttle{
	dir = 8
	},
/turf/open/floor/iron,
/area/shuttle/escape)
"BM" = (
/turf/open/floor/iron,
/area/shuttle/escape)
"BU" = (
/obj/structure/table/wood,
/obj/effect/decal/cleanable/cobweb/cobweb2,
/turf/open/floor/wood,
/area/shuttle/escape)
"BZ" = (
/obj/structure/closet/crate/freezer/surplus_limbs,
/turf/open/floor/iron,
/area/shuttle/escape)
"Cp" = (
/obj/structure/chair/comfy/shuttle{
	dir = 4
	},
/obj/machinery/button/flasher{
	id = "shuttle_flasher";
	pixel_x = -24;
	pixel_y = -6
	},
/obj/machinery/flasher/directional/west{
	id = "shuttle_flasher";
	pixel_y = 5;
	pixel_x = -24
	},
/turf/open/floor/mineral/plastitanium/red,
/area/shuttle/escape/brig)
"CJ" = (
/obj/structure/urinal/directional/north,
/turf/open/floor/mineral/plastitanium/red,
/area/shuttle/escape/brig)
"DZ" = (
/obj/structure/broken_flooring/singular/directional/north,
/turf/open/floor/plating,
/area/shuttle/escape)
"Et" = (
/obj/structure/closet/crate/trashcart/filled,
/turf/open/floor/plating/rust,
/area/shuttle/escape)
"EE" = (
/obj/structure/chair/sofa/middle/brown,
/turf/open/floor/iron,
/area/shuttle/escape)
"EG" = (
/obj/structure/chair/comfy/shuttle{
	dir = 4
	},
/turf/open/floor/plating,
/area/shuttle/escape)
"FL" = (
/obj/machinery/computer/station_alert{
	dir = 8
	},
/turf/open/floor/wood,
/area/shuttle/escape)
"FV" = (
/obj/structure/trash_pile,
/turf/open/floor/iron/freezer,
/area/shuttle/escape)
"GS" = (
/turf/open/floor/iron/freezer,
/area/shuttle/escape)
"Hu" = (
/obj/machinery/light/small/directional/east,
/obj/item/melee/baseball_bat,
/obj/item/toy/beach_ball/baseball{
	pixel_x = 4;
	pixel_y = -4
	},
/turf/open/floor/iron/freezer,
/area/shuttle/escape)
"HY" = (
/obj/structure/extinguisher_cabinet/directional/north,
/turf/open/floor/plating/rust,
/area/shuttle/escape)
"Ic" = (
/obj/effect/decal/cleanable/blood/gibs/old,
/turf/open/floor/iron,
/area/shuttle/escape)
"Iu" = (
/obj/structure/broken_flooring,
/obj/structure/closet/cardboard,
/obj/item/food/meat/slab,
/turf/open/floor/plating,
/area/shuttle/escape)
"IM" = (
/obj/structure/closet/bombcloset{
	welded = 1
	},
/obj/effect/decal/cleanable/cobweb,
/turf/open/floor/iron/freezer,
/area/shuttle/escape)
"IR" = (
/obj/structure/broken_flooring/corner/directional{
	dir = 1
	},
/obj/effect/turf_decal/stripes/line{
	dir = 4
	},
/obj/structure/closet/crate/trashcart/laundry,
/turf/open/floor/plating,
/area/shuttle/escape)
"Jh" = (
/turf/open/floor/plating,
/area/shuttle/escape)
"Jp" = (
/obj/structure/closet,
/obj/effect/spawner/random/maintenance/eight,
/turf/open/floor/iron/freezer,
/area/shuttle/escape)
"KR" = (
/obj/structure/closet,
/obj/effect/spawner/random/maintenance/six,
/turf/open/floor/iron/freezer,
/area/shuttle/escape)
"Lb" = (
/obj/structure/closet/crate/freezer/surplus_limbs,
/obj/effect/spawner/random/maintenance/five,
/turf/open/floor/iron/freezer,
/area/shuttle/escape)
"Lc" = (
/obj/structure/chair/comfy/shuttle{
	dir = 4
	},
/obj/machinery/light/small/directional/west,
/turf/open/floor/plating,
/area/shuttle/escape)
"LD" = (
/obj/effect/decal/cleanable/dirt/dust,
/obj/effect/decal/cleanable/dirt/dust,
/obj/structure/closet,
/obj/effect/spawner/random/maintenance/three,
/turf/open/floor/iron/freezer,
/area/shuttle/escape)
"LI" = (
/obj/structure/chair/comfy/shuttle{
	dir = 4
	},
/turf/open/floor/iron,
/area/shuttle/escape)
"LV" = (
/obj/structure/chair/greyscale{
	dir = 8
	},
/obj/structure/sign/departments/xenobio/alt/directional/east,
/turf/open/floor/iron,
/area/shuttle/escape)
"Mc" = (
/obj/structure/broken_flooring/side/directional/west,
/turf/open/floor/plating,
/area/shuttle/escape)
"Mq" = (
/obj/effect/decal/cleanable/dirt/dust,
/obj/structure/closet,
/obj/effect/spawner/random/maintenance/four,
/turf/open/floor/iron/freezer,
/area/shuttle/escape)
"Ms" = (
/obj/structure/closet,
/obj/item/gun/ballistic/automatic/pistol/toy,
/turf/open/floor/iron/freezer,
/area/shuttle/escape)
"Mv" = (
/obj/structure/chair/greyscale{
	dir = 4
	},
/obj/machinery/light/small/directional/west,
/turf/open/floor/plating,
/area/shuttle/escape)
"MY" = (
/obj/effect/decal/cleanable/dirt/dust,
/obj/structure/closet,
/turf/open/floor/iron/freezer,
/area/shuttle/escape)
"Nt" = (
/obj/structure/chair/sofa/right/brown,
/mob/living/basic/gorilla{
	faction = list("hostile")
	},
/obj/machinery/light/small/directional/north,
/turf/open/floor/plating,
/area/shuttle/escape)
"NR" = (
/obj/structure/closet/emcloset/anchored,
/obj/effect/decal/cleanable/glass/plasma,
/turf/open/floor/iron,
/area/shuttle/escape)
"OB" = (
/obj/effect/decal/cleanable/dirt/dust,
/turf/open/floor/mineral/plastitanium/red,
/area/shuttle/escape/brig)
"OX" = (
/obj/structure/closet/crate/freezer/surplus_limbs,
/obj/structure/sign/warning/directional/south,
/turf/open/floor/iron/freezer,
/area/shuttle/escape)
"Pb" = (
/obj/structure/broken_flooring/pile/directional/west,
/turf/open/floor/plating,
/area/shuttle/escape)
"PH" = (
/obj/effect/mapping_helpers/airlock/access/all/command/general,
/obj/machinery/door/airlock/gold,
/obj/effect/turf_decal/siding/wood{
	dir = 1
	},
/turf/open/floor/iron,
/area/shuttle/escape)
"Qi" = (
/obj/structure/closet/secure_closet/freezer/empty{
	name = "DON'T MONKEY OPEN INSIDE";
	desc = "Strange, looks like someone don't grammar good."
	},
/obj/item/food/monkeycube/gorilla,
/obj/item/food/meat/slab,
/obj/effect/decal/cleanable/cobweb,
/mob/living/carbon/human/species/monkey/angry,
/obj/item/food/meat/slab{
	pixel_y = 3
	},
/obj/item/food/meat/slab{
	pixel_y = 6
	},
/turf/open/floor/iron/freezer,
/area/shuttle/escape)
"Qk" = (
/turf/template_noop,
/area/template_noop)
"Qp" = (
/turf/closed/wall,
/area/shuttle/escape)
"Ru" = (
/obj/effect/decal/remains/human,
/turf/open/floor/plating,
/area/shuttle/escape)
"Sf" = (
/obj/machinery/button/door/directional/north{
	id = "gorillabay";
	name = "Cargo Hold Shutters"
	},
/obj/effect/turf_decal/stripes/line{
	dir = 8
	},
/obj/machinery/door/poddoor/shutters/window{
	dir = 8;
	id = "gorillabay"
	},
/turf/open/floor/iron,
/area/shuttle/escape)
"Sj" = (
/obj/machinery/computer/atmos_alert{
	dir = 4
	},
/obj/machinery/light/small/directional/west,
/turf/open/floor/wood,
/area/shuttle/escape)
"Sm" = (
/obj/machinery/power/shuttle_engine/heater,
/obj/structure/window/reinforced/plasma/spawner/directional/north,
/turf/open/floor/plating/airless,
/area/shuttle/escape)
"SO" = (
/obj/docking_port/mobile/emergency{
	name = "Gorilla Cargo Freighter Mark 2"
	},
/obj/machinery/door/airlock/external/glass{
	name = "Emergency Shuttle Airlock"
	},
/turf/open/floor/plating,
/area/shuttle/escape)
"Ta" = (
/obj/structure/broken_flooring/corner/directional/north,
/turf/open/floor/plating,
/area/shuttle/escape)
"Tt" = (
/obj/structure/closet/crate/freezer/surplus_limbs,
/turf/open/floor/iron/freezer,
/area/shuttle/escape)
"TN" = (
/obj/structure/closet/cardboard,
/obj/effect/spawner/random/maintenance/six,
/obj/effect/spawner/random/maintenance/six,
/turf/open/floor/iron/freezer,
/area/shuttle/escape)
"Uj" = (
/obj/structure/chair/comfy/shuttle{
	dir = 1
	},
/turf/open/floor/wood,
/area/shuttle/escape)
"Ul" = (
/obj/structure/extinguisher_cabinet/directional/north,
/turf/open/floor/plating,
/area/shuttle/escape)
"UN" = (
/obj/machinery/shieldgen,
/obj/effect/decal/cleanable/cobweb/cobweb2,
/turf/open/floor/iron/freezer,
/area/shuttle/escape)
"Vi" = (
/obj/structure/chair/comfy/shuttle{
	dir = 8
	},
/obj/machinery/light/small/directional/east,
/obj/structure/sign/warning/directional/east,
/turf/open/floor/plating,
/area/shuttle/escape)
"VR" = (
/obj/machinery/microwave,
/turf/open/floor/iron/freezer,
/area/shuttle/escape)
"Wd" = (
/obj/effect/mapping_helpers/airlock/access/all/security/general,
/obj/machinery/door/airlock/external/glass{
	name = "Emergency Shuttle Airlock"
	},
/turf/open/floor/mineral/plastitanium/red,
/area/shuttle/escape/brig)
"Wi" = (
/obj/structure/barricade/wooden/crude,
/obj/structure/barricade/wooden,
/obj/effect/mapping_helpers/airlock/locked,
/obj/machinery/door/airlock/security/old{
	name = "Gorilla Containment"
	},
/turf/open/floor/plating,
/area/shuttle/escape)
"Ww" = (
/turf/closed/wall/rust,
/area/shuttle/escape)
"WB" = (
/obj/structure/closet/secure_closet/medical1,
/turf/open/floor/iron/freezer,
/area/shuttle/escape)
"WN" = (
/obj/machinery/wall_healer/free/directional/north{
	use_power = 0
	},
/turf/open/floor/iron,
/area/shuttle/escape)
"WQ" = (
/obj/structure/chair/comfy/shuttle{
	dir = 4
	},
/obj/effect/decal/cleanable/cobweb{
	dir = 1
	},
/turf/open/floor/mineral/plastitanium/red,
/area/shuttle/escape/brig)
"Xa" = (
/obj/structure/table/wood,
/turf/open/floor/wood,
/area/shuttle/escape)
"Xh" = (
/obj/machinery/computer/communications,
/turf/open/floor/wood,
/area/shuttle/escape)
"Xs" = (
/obj/machinery/door/airlock/external/glass{
	name = "Emergency Shuttle Airlock"
	},
/turf/open/floor/plating,
/area/shuttle/escape)
"XT" = (
/obj/item/chair/greyscale,
/turf/open/floor/wood,
/area/shuttle/escape)
"Ye" = (
/obj/effect/decal/cleanable/blood/old,
/turf/open/floor/plating,
/area/shuttle/escape)
"YS" = (
/obj/structure/chair/comfy/shuttle{
	dir = 4
	},
/obj/effect/decal/cleanable/dirt/dust,
/turf/open/floor/iron,
/area/shuttle/escape)
"Zd" = (
/obj/structure/closet/emcloset/anchored,
/obj/effect/turf_decal/stripes/corner,
/obj/effect/decal/cleanable/cobweb/cobweb2,
/turf/open/floor/iron,
/area/shuttle/escape)
"ZP" = (
/obj/effect/decal/cleanable/vomit/old,
/obj/item/reagent_containers/cup/glass/bottle/beer/almost_empty{
	pixel_x = -10;
	pixel_y = 16
	},
/turf/open/floor/iron,
/area/shuttle/escape)
"ZV" = (
/obj/structure/table/reinforced,
/obj/machinery/recharger{
	pixel_x = 6
	},
/obj/item/storage/box/handcuffs{
	pixel_x = -9
	},
/turf/open/floor/mineral/plastitanium/red,
/area/shuttle/escape/brig)

(1,1,1) = {"
Qk
Qk
Qk
Qk
ct
Ww
Qp
Ww
Ww
Wd
Ww
SO
Ww
kP
kP
kP
Qp
Xs
Ww
Xs
Ww
Ww
Qp
Qp
tL
kY
"}
(2,1,1) = {"
Qk
Qk
Qp
Ww
Qp
Qp
WQ
hP
Cp
OB
Qp
BM
Lc
LI
YS
LI
Lc
BM
Ww
fc
Mv
me
EG
Ww
Ww
Qp
"}
(3,1,1) = {"
tL
Ww
Qp
Sj
Xa
Ww
CJ
OB
OB
lp
Ww
Ul
pY
pY
pY
pY
nc
pY
Qp
HY
uC
Jh
DZ
nK
Sm
gk
"}
(4,1,1) = {"
Qk
Qp
os
ya
XT
be
ei
ei
OB
ZV
Ww
Et
pY
Jh
fc
pY
Jh
Ta
be
aC
Jh
Vi
LV
BZ
Sm
gk
"}
(5,1,1) = {"
Qk
cM
Xh
xt
rN
Qp
kP
kP
gI
kP
Qp
WN
pY
ZP
BM
mA
pY
ub
sP
sP
Wi
sP
gf
sP
Sm
gk
"}
(6,1,1) = {"
Qk
cM
gZ
Uj
xt
PH
BM
Jh
BM
wy
oB
Pb
Bv
Bv
Bv
Bv
Bv
NR
iH
Mc
xJ
Jh
dr
Jh
Sm
gk
"}
(7,1,1) = {"
Qk
cM
ig
XT
xY
Ww
Zd
nA
oY
IR
kv
aN
Qp
Ww
Ww
Ww
Qp
Ww
gf
Nt
Ye
Ru
Jh
Iu
gf
sP
"}
(8,1,1) = {"
Qk
Ww
BU
yH
FL
Qp
Ww
Sf
qk
qk
Qp
Ww
Qp
IM
fq
FV
Lb
Jp
sP
EE
xJ
dr
xJ
BM
Sm
gk
"}
(9,1,1) = {"
Qk
Qp
Qp
Ww
Ww
Ww
FV
MY
lX
lX
TN
zG
WB
GS
lX
VR
Jh
Tt
gf
aX
xJ
Jh
Ic
dr
Sm
gk
"}
(10,1,1) = {"
Qk
Ww
Ww
Qi
mD
rt
je
nc
GS
GS
Mq
jX
lX
zg
aY
GS
Aj
zx
gf
mP
dr
xJ
Ru
dr
Sm
gk
"}
(11,1,1) = {"
ct
Ww
Qp
dO
Hu
LD
GS
lX
GS
nO
rv
GS
KR
nc
xf
im
Tt
Ms
iH
eW
dr
Jh
bf
BM
Sm
gk
"}
(12,1,1) = {"
Qk
Qk
Ww
Qp
Ww
Ww
UN
wj
hF
ng
GS
AJ
aQ
GS
WB
bq
um
OX
sP
lS
Jh
zI
dr
sP
sP
Ww
"}
(13,1,1) = {"
Qk
Qk
Qk
Qk
tL
Qp
Qp
Ww
Ww
Qp
Ww
Ww
Qp
Ww
Qp
Qp
Ww
Ww
sP
sP
gf
gf
gf
sP
ct
kY
"}
