//MAP CONVERTED BY dmm2tgm.py THIS HEADER COMMENT PREVENTS RECONVERSION, DO NOT REMOVE
"aG" = (
/turf/open/floor/plating,
/area/space)
"aP" = (
/obj/machinery/computer/operating{
	dir = 4
	},
/obj/machinery/vitals_reader/advanced/directional/north,
/turf/open/floor/plating,
/area/space)
"bO" = (
/obj/machinery/atmospherics/pipe/smart/manifold4w/orange/hidden,
/turf/open/floor/catwalk_floor/iron_dark,
/area/space)
"cn" = (
/obj/machinery/power/port_gen/pacman,
/turf/open/floor/plating,
/area/space)
"cu" = (
/obj/structure/chair/comfy/shuttle,
/turf/open/floor/plating,
/area/space)
"cD" = (
/obj/structure/rack/shelf,
/turf/open/floor/plating,
/area/space)
"cU" = (
/obj/structure/cable,
/turf/open/floor/plating,
/area/space)
"dS" = (
/obj/structure/chair/comfy/shuttle,
/obj/structure/window/reinforced/survival_pod/spawner/directional/north,
/turf/open/floor/plating,
/area/space)
"ef" = (
/obj/structure/tank_dispenser/oxygen,
/turf/open/floor/plating,
/area/space)
"ew" = (
/obj/machinery/door/window/survival_pod/left/directional/south,
/turf/open/floor/plating,
/area/space)
"gv" = (
/obj/machinery/computer/aifixer{
	dir = 8
	},
/turf/open/floor/plating,
/area/space)
"gI" = (
/obj/machinery/power/shuttle_engine/huge,
/turf/open/floor/engine/hull/reinforced,
/area/space)
"iH" = (
/turf/open/space/basic,
/area/space)
"jl" = (
/obj/machinery/power/shuttle_engine/large,
/turf/open/floor/engine/hull/reinforced,
/area/space)
"jK" = (
/obj/structure/window/reinforced/survival_pod/spawner/directional/west,
/obj/machinery/power/port_gen/pacman,
/turf/open/floor/plating,
/area/space)
"kn" = (
/obj/machinery/power/rtg/advanced,
/obj/structure/cable,
/turf/open/floor/plating,
/area/space)
"kI" = (
/obj/machinery/computer/arcade/orion_trail{
	dir = 4
	},
/turf/open/floor/eighties,
/area/space)
"kY" = (
/obj/machinery/power/smes/magical/cybersun,
/obj/structure/cable,
/turf/open/floor/plating,
/area/space)
"lS" = (
/obj/effect/spawner/surgery_tray/full/deployed,
/turf/open/floor/plating,
/area/space)
"lZ" = (
/obj/machinery/computer/operating{
	dir = 4
	},
/obj/machinery/vitals_reader/advanced/directional/south,
/turf/open/floor/plating,
/area/space)
"mf" = (
/obj/machinery/cryo_cell{
	name = "pyro cell";
	desc = "Some kind of experimental machine."
	},
/turf/open/floor/plating,
/area/space)
"mH" = (
/obj/structure/table/wood/fancy/black,
/turf/open/floor/plating,
/area/space)
"nt" = (
/obj/machinery/computer/station_alert,
/turf/open/floor/plating,
/area/space)
"ny" = (
/obj/structure/girder/reinforced,
/turf/open/floor/plating,
/area/space)
"oN" = (
/turf/closed/wall/r_wall/plastitanium/syndicate,
/area/space)
"oW" = (
/obj/machinery/computer/communications/syndicate,
/turf/open/floor/plating,
/area/space)
"pR" = (
/obj/structure/cable,
/obj/effect/mapping_helpers/airlock/access/any/syndicate/general,
/turf/open/floor/plating,
/area/space)
"qf" = (
/obj/structure/table/reinforced/plastitaniumglass,
/obj/item/reagent_containers/cup/bottle/epinephrine{
	pixel_y = 11;
	pixel_x = -2
	},
/obj/item/reagent_containers/syringe{
	pixel_y = -2
	},
/turf/open/floor/plating,
/area/space)
"ry" = (
/obj/structure/chair/comfy/black{
	dir = 4
	},
/turf/open/floor/plating,
/area/space)
"sv" = (
/obj/effect/spawner/structure/window/reinforced/plasma/plastitanium,
/turf/open/floor/plating,
/area/space)
"sA" = (
/obj/machinery/vending/dorms,
/turf/open/floor/plating,
/area/space)
"sN" = (
/obj/structure/chair/comfy/black,
/turf/open/floor/plating,
/area/space)
"sV" = (
/obj/machinery/portable_atmospherics/canister/air,
/turf/open/floor/plating,
/area/space)
"te" = (
/obj/structure/chair/comfy/black{
	dir = 1
	},
/turf/open/floor/plating,
/area/space)
"tO" = (
/obj/machinery/power/shuttle_engine/heater,
/obj/structure/window/reinforced/survival_pod/spawner/directional/north,
/obj/structure/cable,
/turf/open/floor/engine/hull/reinforced,
/area/space)
"ut" = (
/obj/structure/rack/gunrack,
/turf/open/floor/plating,
/area/space)
"vg" = (
/obj/machinery/power/rtg/advanced,
/obj/structure/cable,
/obj/structure/window/reinforced/survival_pod/spawner/directional/north,
/turf/open/floor/plating,
/area/space)
"vN" = (
/obj/structure/table/reinforced,
/obj/machinery/chem_dispenser/drinks/fullupgrade{
	dir = 8
	},
/turf/open/floor/plating,
/area/space)
"wx" = (
/obj/machinery/computer/communications{
	dir = 1
	},
/turf/open/floor/plating,
/area/space)
"wV" = (
/obj/structure/chair/comfy/black{
	dir = 8
	},
/turf/open/floor/plating,
/area/space)
"xR" = (
/obj/machinery/sleeper/syndie{
	dir = 8
	},
/turf/open/floor/plating,
/area/space)
"yb" = (
/obj/structure/lattice,
/turf/open/space/basic,
/area/space)
"yC" = (
/obj/machinery/portable_atmospherics/canister/anesthetic_mix,
/obj/machinery/atmospherics/components/unary/portables_connector{
	dir = 8
	},
/turf/open/floor/catwalk_floor/iron_dark,
/area/space)
"yQ" = (
/obj/machinery/power/rtg/advanced,
/obj/structure/cable,
/obj/structure/window/reinforced/survival_pod/spawner/directional/south,
/turf/open/floor/plating,
/area/space)
"zt" = (
/obj/machinery/computer/atmos_alert/station_only,
/turf/open/floor/plating,
/area/space)
"zZ" = (
/obj/machinery/vending/donksofttoyvendor,
/turf/open/floor/plating,
/area/space)
"Aj" = (
/obj/structure/table/reinforced,
/obj/machinery/chem_dispenser/drinks/beer/fullupgrade{
	dir = 8
	},
/turf/open/floor/plating,
/area/space)
"BI" = (
/obj/structure/chair/comfy/shuttle{
	dir = 1
	},
/turf/open/floor/plating,
/area/space)
"BR" = (
/obj/machinery/portable_atmospherics/canister/oxygen,
/turf/open/floor/plating,
/area/space)
"Cj" = (
/obj/structure/chair/stool{
	dir = 8
	},
/turf/open/floor/eighties,
/area/space)
"CG" = (
/obj/structure/chair/comfy/shuttle{
	dir = 8
	},
/turf/open/floor/plating,
/area/space)
"DP" = (
/obj/structure/table/wood/poker,
/obj/item/reagent_containers/cup/glass/drinkingglass{
	pixel_y = 8;
	pixel_x = 4
	},
/obj/item/reagent_containers/cup/glass/drinkingglass/shotglass{
	pixel_y = 1;
	pixel_x = -6
	},
/turf/open/floor/plating,
/area/space)
"EM" = (
/obj/structure/chair/stool/bar/directional/north,
/turf/open/floor/plating,
/area/space)
"EZ" = (
/obj/structure/chair/comfy/shuttle{
	dir = 1
	},
/obj/structure/window/reinforced/survival_pod/spawner/directional/south,
/turf/open/floor/plating,
/area/space)
"Fn" = (
/obj/machinery/vending/clothing,
/turf/open/floor/plating,
/area/space)
"Go" = (
/obj/machinery/computer/emergency_shuttle{
	dir = 1
	},
/turf/open/floor/plating,
/area/space)
"GQ" = (
/obj/structure/table/wood/poker,
/obj/item/toy/cards/deck{
	pixel_y = 6
	},
/turf/open/floor/plating,
/area/space)
"Hq" = (
/obj/structure/table/reinforced/plastitaniumglass,
/obj/item/defibrillator/loaded{
	pixel_y = 7
	},
/obj/item/defibrillator/loaded,
/turf/open/floor/plating,
/area/space)
"HB" = (
/obj/structure/table/optable,
/obj/machinery/defibrillator_mount/directional/west,
/turf/open/floor/plating,
/area/space)
"HH" = (
/obj/machinery/power/shuttle_engine/heater,
/obj/structure/window/reinforced/survival_pod/spawner/directional/north,
/obj/structure/window/reinforced/survival_pod/spawner/directional/west,
/turf/open/floor/engine/hull/reinforced,
/area/space)
"In" = (
/obj/structure/table/reinforced/plastitaniumglass,
/obj/item/storage/medkit/tactical/premium{
	pixel_y = 3
	},
/turf/open/floor/plating,
/area/space)
"IM" = (
/obj/machinery/computer/arcade/minesweeper{
	dir = 4
	},
/turf/open/floor/eighties,
/area/space)
"LE" = (
/obj/effect/mapping_helpers/airlock/access/any/syndicate/general,
/turf/open/floor/plating,
/area/space)
"LI" = (
/obj/effect/spawner/structure/window/reinforced/plasma/plastitanium,
/obj/machinery/power/terminal{
	dir = 8
	},
/obj/structure/cable,
/turf/open/floor/plating,
/area/space)
"LW" = (
/obj/structure/table/reinforced,
/turf/open/floor/plating,
/area/space)
"Ok" = (
/obj/machinery/iv_drip,
/turf/open/floor/plating,
/area/space)
"Pd" = (
/obj/machinery/power/shuttle_engine/heater,
/obj/structure/window/reinforced/survival_pod/spawner/directional/north,
/obj/structure/window/reinforced/survival_pod/spawner/directional/east,
/obj/structure/cable,
/turf/open/floor/engine/hull/reinforced,
/area/space)
"Pf" = (
/obj/machinery/atmospherics/components/unary/thermomachine/heater/on,
/turf/open/floor/plating,
/area/space)
"Pm" = (
/obj/machinery/jukebox/no_access,
/turf/open/floor/plating,
/area/space)
"PA" = (
/obj/machinery/suit_storage_unit/syndicate/softsuit,
/turf/open/floor/plating,
/area/space)
"Qf" = (
/obj/machinery/computer/camera_advanced,
/turf/open/floor/plating,
/area/space)
"Qo" = (
/obj/effect/spawner/structure/window/reinforced/plasma/plastitanium,
/obj/machinery/power/terminal{
	dir = 4
	},
/obj/structure/cable,
/turf/open/floor/plating,
/area/space)
"QZ" = (
/obj/machinery/computer/arcade/battle{
	dir = 4
	},
/turf/open/floor/eighties,
/area/space)
"Re" = (
/obj/machinery/computer/crew,
/turf/open/floor/plating,
/area/space)
"RK" = (
/obj/structure/table/reinforced/plastitaniumglass,
/obj/item/wrench/medical{
	pixel_x = -11
	},
/obj/item/paper{
	default_raw_text = "We're trying out something new on the vessel. We've outfitted it with an experimental pyro cell and we've supplied some pyroxadone. Set the heater's temperature to at least 460K, then put the patient in. Make sure to cool them off after treatment, otherwise they may suffer more injuries.";
	name = "pyro cell notice"
	},
/turf/open/floor/plating,
/area/space)
"RR" = (
/obj/structure/lattice,
/obj/item/toy/plush/lizard_plushie/space{
	name = "Lives-In-Space"
	},
/turf/open/space/basic,
/area/space)
"RU" = (
/obj/machinery/portable_atmospherics/canister/carbon_dioxide,
/turf/open/floor/plating,
/area/space)
"Sn" = (
/obj/machinery/power/shuttle_engine/heater,
/obj/structure/window/reinforced/survival_pod/spawner/directional/north,
/obj/structure/window/reinforced/survival_pod/spawner/directional/west,
/obj/structure/cable,
/turf/open/floor/engine/hull/reinforced,
/area/space)
"Tx" = (
/mob/living/basic/trooper/syndicate/boggins,
/turf/open/floor/plating,
/area/space)
"UK" = (
/obj/structure/window/reinforced/survival_pod/spawner/directional/east,
/obj/machinery/power/port_gen/pacman,
/turf/open/floor/plating,
/area/space)
"UN" = (
/obj/machinery/power/shuttle_engine/heater,
/obj/structure/window/reinforced/survival_pod/spawner/directional/north,
/turf/open/floor/engine/hull/reinforced,
/area/space)
"Vc" = (
/obj/machinery/vending/boozeomat/syndicate{
	pixel_y = 7
	},
/turf/open/floor/plating,
/area/space)
"Wb" = (
/turf/open/floor/engine/hull/reinforced,
/area/space)
"We" = (
/mob/living/basic/drone/snowflake/bardrone,
/turf/open/floor/plating,
/area/space)
"Wz" = (
/obj/structure/window/reinforced/shuttle/survival_pod,
/turf/open/floor/plating,
/area/space)
"WD" = (
/obj/structure/chair/comfy/shuttle{
	dir = 4
	},
/turf/open/floor/plating,
/area/space)
"WE" = (
/obj/structure/chair/stool{
	dir = 8
	},
/turf/open/floor/plating,
/area/space)
"WR" = (
/obj/machinery/power/shuttle_engine/propulsion/right,
/turf/open/floor/engine/hull/reinforced,
/area/space)
"WT" = (
/obj/structure/table/reinforced,
/obj/item/reagent_containers/cup/glass/shaker{
	pixel_y = 21
	},
/obj/item/reagent_containers/cup/glass/drinkingglass{
	pixel_y = 2;
	pixel_x = 1
	},
/obj/item/reagent_containers/cup/glass/drinkingglass{
	pixel_y = 7;
	pixel_x = -5
	},
/obj/item/reagent_containers/cup/glass/drinkingglass{
	pixel_y = 7;
	pixel_x = 7
	},
/turf/open/floor/plating,
/area/space)
"Xn" = (
/obj/structure/table/reinforced/plastitaniumglass,
/turf/open/floor/plating,
/area/space)
"XK" = (
/obj/machinery/power/shuttle_engine/propulsion/left,
/turf/open/floor/engine/hull/reinforced,
/area/space)
"XV" = (
/obj/machinery/computer/robotics{
	dir = 8
	},
/turf/open/floor/plating,
/area/space)
"YW" = (
/obj/structure/table/reinforced/plastitaniumglass,
/obj/structure/window/reinforced/survival_pod/spawner/directional/east,
/turf/open/floor/plating,
/area/space)
"Zq" = (
/obj/structure/table/reinforced/plastitaniumglass,
/obj/item/reagent_containers/cup/beaker/cryoxadone{
	list_reagents = list(/datum/reagent/medicine/pyroxadone = 30);
	pixel_y = 7;
	pixel_x = -3
	},
/obj/item/reagent_containers/cup/beaker/cryoxadone{
	list_reagents = list(/datum/reagent/medicine/pyroxadone = 30);
	pixel_y = 2;
	pixel_x = 5
	},
/turf/open/floor/plating,
/area/space)
"ZT" = (
/obj/machinery/power/shuttle_engine/heater,
/obj/structure/window/reinforced/survival_pod/spawner/directional/north,
/obj/structure/window/reinforced/survival_pod/spawner/directional/east,
/turf/open/floor/engine/hull/reinforced,
/area/space)

(1,1,1) = {"
iH
iH
iH
iH
iH
iH
iH
iH
iH
iH
iH
iH
iH
iH
iH
oN
aG
oN
aG
oN
sv
sv
sv
oN
aG
oN
aG
oN
iH
iH
iH
iH
iH
iH
iH
oN
oN
oN
oN
oN
iH
iH
"}
(2,1,1) = {"
iH
iH
iH
iH
iH
iH
iH
iH
iH
iH
iH
iH
iH
iH
oN
oN
aG
oN
aG
oN
aG
aG
aG
oN
aG
oN
aG
oN
aG
iH
iH
iH
aG
oN
aG
oN
cn
tO
Wb
jl
iH
iH
"}
(3,1,1) = {"
iH
iH
iH
iH
iH
iH
iH
iH
iH
iH
oN
oN
sv
oN
oN
oN
aG
oN
aG
oN
sv
sv
sv
oN
aG
oN
aG
oN
oN
oN
oN
oN
oN
oN
aG
oN
UK
Pd
Wb
Wb
iH
iH
"}
(4,1,1) = {"
iH
iH
iH
iH
iH
iH
iH
iH
oN
oN
oN
PA
aG
BR
oN
LW
aG
oN
aG
aG
aG
aG
aG
aG
aG
aG
aG
aG
aG
oN
aG
aG
aG
oN
aG
oN
aG
cU
HH
Wb
Wb
gI
"}
(5,1,1) = {"
iH
iH
iH
iH
iH
iH
iH
oN
oN
oN
oN
PA
aG
sV
oN
cu
aG
sv
aG
aG
aG
aG
aG
aG
aG
aG
aG
aG
aG
LE
aG
aG
aG
aG
aG
aG
aG
cU
tO
Wb
Wb
Wb
"}
(6,1,1) = {"
iH
iH
iH
iH
iH
iH
iH
oN
cD
aG
oN
PA
aG
RU
oN
cu
aG
sv
aG
CG
CG
CG
CG
CG
CG
CG
CG
CG
aG
oN
aG
aG
aG
aG
aG
aG
aG
cU
UN
Wb
Wb
Wb
"}
(7,1,1) = {"
iH
iH
iH
iH
oN
sv
oN
oN
ut
aG
oN
PA
aG
aG
oN
cu
aG
sv
aG
Wz
Wz
Wz
Wz
Wz
Wz
Wz
Wz
Wz
aG
oN
aG
aG
aG
aG
aG
aG
aG
cU
UN
Wb
Wb
gI
"}
(8,1,1) = {"
iH
iH
iH
oN
oN
WD
WD
oN
ut
aG
oN
PA
aG
ef
oN
cu
aG
sv
aG
WD
WD
WD
WD
WD
WD
WD
WD
WD
aG
oN
aG
aG
aG
aG
aG
aG
aG
cU
tO
Wb
Wb
Wb
"}
(9,1,1) = {"
iH
oN
oN
oN
cu
aG
aG
oN
cD
aG
oN
oN
LE
oN
oN
LW
LE
oN
aG
aG
aG
aG
aG
aG
aG
aG
aG
aG
aG
oN
aG
aG
aG
aG
aG
aG
aG
cU
ZT
Wb
Wb
Wb
"}
(10,1,1) = {"
iH
iH
iH
sv
cu
aG
aG
oN
sv
LE
oN
aG
aG
aG
LE
aG
aG
LE
aG
aG
aG
aG
aG
aG
aG
aG
aG
aG
aG
oN
aG
aG
oN
oN
oN
oN
oN
cU
oN
HH
XK
iH
"}
(11,1,1) = {"
iH
iH
iH
sv
cu
aG
aG
LE
aG
aG
aG
aG
aG
aG
LE
aG
aG
LE
aG
aG
aG
aG
aG
oN
LE
sv
LE
oN
oN
oN
oN
oN
oN
oN
yb
yb
oN
pR
oN
oN
oN
iH
"}
(12,1,1) = {"
oN
oN
oN
oN
cu
aG
LW
oN
aG
aG
aG
CG
CG
CG
oN
CG
CG
oN
aG
aG
EZ
dS
aG
oN
aG
aG
aG
oN
aP
HB
Ok
HB
lZ
oN
oN
yb
oN
cU
cU
kY
oN
iH
"}
(13,1,1) = {"
iH
iH
iH
oN
oN
oN
oN
oN
LE
oN
sv
sv
oN
sv
oN
sv
sv
oN
oN
aG
EZ
dS
aG
oN
cu
aG
aG
oN
lS
WE
aG
WE
lS
oN
oN
ny
oN
sv
sv
LI
oN
ny
"}
(14,1,1) = {"
iH
iH
iH
sv
zt
BI
aG
Tx
aG
sv
cu
Go
sv
yb
oN
ry
aG
aG
LE
aG
EZ
dS
aG
oN
cu
aG
aG
aG
aG
aG
aG
aG
aG
Hq
sv
yb
vg
kn
kn
kn
yQ
ny
"}
(15,1,1) = {"
iH
iH
iH
sv
nt
BI
aG
aG
aG
LE
cu
wx
sv
yb
sv
mH
aG
aG
sv
aG
EZ
dS
aG
oN
aG
aG
aG
aG
aG
aG
aG
aG
aG
In
sv
yb
vg
kn
kn
kn
yQ
ny
"}
(16,1,1) = {"
oN
sv
oN
oN
Re
BI
aG
aG
aG
oN
sv
sv
oN
yb
sv
wV
aG
aG
LE
aG
EZ
dS
aG
oN
xR
qf
xR
oN
Pf
bO
bO
bO
Zq
oN
oN
ny
oN
sv
sv
Qo
oN
ny
"}
(17,1,1) = {"
sv
Qf
BI
oN
oN
aG
aG
WD
WD
sv
yb
yb
RR
yb
sv
ry
aG
aG
oN
aG
EZ
dS
aG
oN
oN
oN
oN
oN
mf
bO
yC
yC
RK
oN
oN
yb
oN
cU
cU
kY
oN
iH
"}
(18,1,1) = {"
sv
oW
BI
LE
aG
aG
oN
XV
gv
sv
yb
yb
yb
yb
sv
mH
aG
aG
sv
aG
EZ
dS
aG
oN
QZ
IM
kI
oN
oN
oN
oN
oN
oN
oN
yb
yb
oN
pR
oN
oN
oN
iH
"}
(19,1,1) = {"
oN
sv
oN
oN
oN
oN
oN
oN
oN
oN
sv
sv
sv
sv
oN
wV
aG
aG
sv
aG
aG
aG
aG
oN
Cj
Cj
Cj
oN
aG
aG
aG
aG
aG
oN
oN
oN
oN
cU
oN
ZT
WR
iH
"}
(20,1,1) = {"
iH
iH
iH
oN
Vc
aG
aG
aG
aG
Xn
EM
aG
mH
te
oN
oN
aG
aG
oN
sv
LE
LE
sv
oN
aG
aG
aG
LE
aG
aG
aG
aG
aG
aG
aG
oN
aG
cU
HH
Wb
Wb
gI
"}
(21,1,1) = {"
iH
iH
iH
oN
oN
Aj
vN
WT
We
Xn
EM
aG
aG
aG
aG
LE
aG
aG
aG
aG
aG
aG
aG
aG
aG
aG
aG
sv
aG
aG
aG
aG
aG
aG
aG
oN
aG
cU
tO
Wb
Wb
Wb
"}
(22,1,1) = {"
iH
iH
iH
iH
oN
sv
oN
oN
aG
YW
EM
aG
aG
aG
aG
sv
aG
aG
aG
aG
aG
aG
aG
aG
aG
aG
aG
LE
aG
aG
aG
aG
aG
aG
aG
oN
aG
cU
UN
Wb
Wb
Wb
"}
(23,1,1) = {"
iH
iH
iH
iH
iH
iH
iH
oN
aG
ew
aG
aG
aG
aG
aG
oN
aG
aG
aG
aG
aG
aG
zZ
sA
Fn
aG
aG
oN
aG
aG
aG
aG
aG
aG
aG
LE
aG
cU
UN
Wb
Wb
gI
"}
(24,1,1) = {"
iH
iH
iH
iH
iH
iH
iH
oN
oN
oN
Pm
aG
sN
GQ
te
oN
oN
LE
oN
oN
oN
LE
oN
oN
oN
LE
oN
oN
aG
aG
aG
aG
aG
aG
aG
oN
aG
cU
tO
Wb
Wb
Wb
"}
(25,1,1) = {"
iH
iH
iH
iH
iH
iH
iH
iH
oN
oN
oN
aG
sN
DP
te
oN
aG
aG
aG
oN
aG
aG
aG
oN
aG
aG
aG
oN
aG
aG
aG
aG
aG
aG
aG
oN
aG
cU
ZT
Wb
Wb
Wb
"}
(26,1,1) = {"
iH
iH
iH
iH
iH
iH
iH
iH
iH
iH
oN
oN
sv
oN
oN
oN
aG
aG
aG
oN
aG
aG
aG
oN
aG
aG
aG
oN
oN
aG
aG
aG
oN
oN
aG
oN
jK
Sn
Wb
jl
iH
iH
"}
(27,1,1) = {"
iH
iH
iH
iH
iH
iH
iH
iH
iH
iH
iH
iH
iH
iH
oN
oN
aG
aG
aG
oN
aG
aG
aG
oN
aG
aG
aG
oN
aG
iH
iH
iH
aG
oN
oN
oN
cn
tO
Wb
Wb
iH
iH
"}
(28,1,1) = {"
iH
iH
iH
iH
iH
iH
iH
iH
iH
iH
iH
iH
iH
iH
iH
oN
sv
sv
sv
oN
sv
sv
sv
oN
sv
sv
sv
oN
iH
iH
iH
iH
iH
iH
iH
oN
oN
oN
oN
oN
iH
iH
"}
