//MAP CONVERTED BY dmm2tgm.py THIS HEADER COMMENT PREVENTS RECONVERSION, DO NOT REMOVE
"aN" = (
/obj/effect/turf_decal/tile/bar/opposingcorners,
/obj/effect/turf_decal/siding/wood{
	dir = 6
	},
/obj/effect/decal/cleanable/confetti,
/turf/open/floor/iron,
/area/shuttle/escape)
"cN" = (
/obj/effect/turf_decal/tile/bar/opposingcorners,
/obj/effect/decal/cleanable/confetti,
/turf/open/floor/iron,
/area/shuttle/escape)
"ej" = (
/obj/structure/chair/plastic{
	dir = 4
	},
/obj/effect/decal/cleanable/confetti,
/turf/open/floor/wood,
/area/shuttle/escape)
"hs" = (
/obj/structure/chair/plastic{
	dir = 8
	},
/turf/open/floor/wood,
/area/shuttle/escape)
"kf" = (
/obj/effect/spawner/structure/window/hollow,
/obj/structure/curtain/cloth,
/turf/open/floor/wood,
/area/shuttle/escape)
"kW" = (
/obj/item/toy/balloon,
/turf/open/floor/wood,
/area/shuttle/escape)
"lh" = (
/obj/structure/fireplace,
/obj/structure/chair/comfy/beige,
/turf/open/floor/carpet,
/area/shuttle/escape)
"lI" = (
/obj/structure/mineral_door/wood,
/turf/open/floor/iron/showroomfloor,
/area/shuttle/escape)
"oo" = (
/obj/structure/chair/comfy/beige{
	dir = 8
	},
/turf/open/floor/carpet,
/area/shuttle/escape)
"qE" = (
/obj/effect/decal/cleanable/confetti,
/turf/open/floor/wood,
/area/shuttle/escape)
"qL" = (
/obj/structure/chair/sofa/left{
	dir = 1;
	color = "#f0eec6"
	},
/turf/open/floor/carpet,
/area/shuttle/escape)
"qY" = (
/obj/structure/sink/kitchen/directional/east,
/obj/structure/mirror/directional/west,
/turf/open/floor/iron/showroomfloor,
/area/shuttle/escape)
"rT" = (
/obj/structure/dresser,
/obj/structure/railing{
	dir = 4
	},
/turf/open/floor/wood,
/area/shuttle/escape)
"si" = (
/obj/machinery/vending/cola/black,
/obj/effect/turf_decal/tile/bar/opposingcorners,
/obj/effect/turf_decal/siding/wood{
	dir = 9
	},
/turf/open/floor/iron,
/area/shuttle/escape)
"st" = (
/obj/docking_port/mobile/emergency{
	name = "How's your sex life?"
	},
/obj/machinery/door/airlock/wood,
/turf/open/floor/wood,
/area/shuttle/escape)
"tD" = (
/obj/effect/turf_decal/tile/bar/opposingcorners,
/obj/machinery/light/small/directional/west,
/obj/effect/turf_decal/siding/wood{
	dir = 8
	},
/obj/item/toy/balloon,
/turf/open/floor/iron,
/area/shuttle/escape)
"tP" = (
/obj/item/toy/balloon,
/obj/effect/decal/cleanable/confetti,
/turf/open/floor/wood,
/area/shuttle/escape)
"tX" = (
/turf/open/floor/carpet,
/area/shuttle/escape)
"uW" = (
/obj/structure/chair/office{
	dir = 4
	},
/turf/open/floor/wood,
/area/shuttle/escape)
"vG" = (
/obj/structure/bed/double,
/obj/structure/curtain/cloth,
/obj/item/bedsheet/hos/double,
/turf/open/floor/carpet,
/area/shuttle/escape)
"wk" = (
/obj/structure/table/reinforced,
/obj/item/reagent_containers/cup/glass/shaker,
/obj/effect/turf_decal/tile/bar/opposingcorners,
/obj/effect/turf_decal/siding/wood{
	dir = 1
	},
/turf/open/floor/iron,
/area/shuttle/escape)
"wJ" = (
/obj/structure/chair/sofa/right{
	color = "#f0eec6";
	dir = 1
	},
/turf/open/floor/carpet,
/area/shuttle/escape)
"xo" = (
/obj/machinery/light/small/directional/south,
/obj/item/toy/balloon,
/turf/open/floor/carpet,
/area/shuttle/escape)
"xL" = (
/obj/machinery/computer/security/wooden_tv,
/turf/open/floor/carpet,
/area/shuttle/escape)
"xQ" = (
/turf/open/space/basic,
/area/space)
"yi" = (
/obj/structure/mirror/broken/directional/west,
/obj/item/table_clock,
/turf/open/floor/carpet,
/area/shuttle/escape)
"yE" = (
/obj/structure/fake_stairs/wood/directional/north,
/turf/open/floor/wood,
/area/shuttle/escape)
"zV" = (
/obj/structure/table/wood,
/obj/item/reagent_containers/cup/glass/coffee{
	pixel_x = 7;
	pixel_y = 14
	},
/obj/item/reagent_containers/cup/glass/coffee/no_lid{
	pixel_x = -5;
	pixel_y = 2
	},
/obj/item/storage/box/party_poppers{
	pixel_x = 8
	},
/turf/open/floor/wood,
/area/shuttle/escape)
"AQ" = (
/obj/structure/chair/sofa/right{
	color = "#f0eec6";
	dir = 1
	},
/turf/open/floor/wood,
/area/shuttle/escape)
"Dm" = (
/obj/item/kirbyplants,
/obj/item/toy/balloon,
/turf/open/floor/wood,
/area/shuttle/escape)
"Ed" = (
/obj/item/kirbyplants,
/turf/open/floor/wood,
/area/shuttle/escape)
"FX" = (
/obj/structure/table/wood,
/obj/item/flashlight/lamp,
/turf/open/floor/carpet,
/area/shuttle/escape)
"HO" = (
/obj/structure/table/wood,
/obj/machinery/computer/libraryconsole/bookmanagement,
/turf/open/floor/wood,
/area/shuttle/escape)
"Id" = (
/obj/structure/table/reinforced,
/obj/item/reagent_containers/cup/glass/drinkingglass/shotglass,
/obj/effect/turf_decal/tile/bar/opposingcorners,
/obj/effect/turf_decal/siding/wood{
	dir = 5
	},
/turf/open/floor/iron,
/area/shuttle/escape)
"Kf" = (
/obj/structure/rack/shelf,
/obj/machinery/light/small/directional/east,
/turf/open/floor/carpet,
/area/shuttle/escape)
"Lf" = (
/obj/structure/table/wood,
/obj/item/clothing/gloves/tackler/football,
/turf/open/floor/carpet,
/area/shuttle/escape)
"Lm" = (
/obj/item/paper/fluff/shuttles/daniel,
/turf/open/floor/carpet,
/area/shuttle/escape)
"LJ" = (
/obj/structure/toilet/secret,
/obj/machinery/light/small/directional/west,
/turf/open/floor/iron/showroomfloor,
/area/shuttle/escape)
"LK" = (
/obj/structure/table/wood,
/obj/item/stack/spacecash/c1{
	amount = 8
	},
/obj/item/stack/spacecash/c10,
/turf/open/floor/carpet,
/area/shuttle/escape)
"Mk" = (
/obj/structure/chair/sofa/left{
	dir = 1;
	color = "#f0eec6"
	},
/turf/open/floor/wood,
/area/shuttle/escape)
"Mo" = (
/obj/structure/table/wood,
/obj/item/reagent_containers/cup/glass/bottle/wine{
	pixel_y = 7
	},
/turf/open/floor/carpet,
/area/shuttle/escape)
"MI" = (
/obj/machinery/light/small/directional/east,
/turf/open/floor/wood,
/area/shuttle/escape)
"MX" = (
/obj/structure/bed/dogbed,
/obj/item/bouquet/rose,
/turf/open/floor/carpet,
/area/shuttle/escape)
"Nf" = (
/obj/item/reagent_containers/cup/glass/waterbottle/empty,
/turf/open/floor/wood,
/area/shuttle/escape)
"Ng" = (
/obj/machinery/computer/emergency_shuttle,
/turf/open/floor/carpet,
/area/shuttle/escape)
"OX" = (
/obj/machinery/light/small/directional/west,
/mob/living/basic/chicken{
	name = "Peter";
	real_name = "Peter"
	},
/turf/open/floor/wood,
/area/shuttle/escape)
"RV" = (
/turf/closed/wall/mineral/wood,
/area/shuttle/escape)
"SQ" = (
/obj/effect/spawner/structure/window/hollow,
/obj/structure/curtain/cloth{
	color = "#AA4444"
	},
/turf/open/floor/wood,
/area/shuttle/escape)
"Um" = (
/obj/structure/table/reinforced,
/obj/effect/turf_decal/tile/bar/opposingcorners,
/obj/effect/turf_decal/siding/wood,
/obj/item/pizzabox/meat{
	pizza = /obj/item/food/pizza/arnold;
	pixel_y = 10
	},
/turf/open/floor/iron,
/area/shuttle/escape)
"VQ" = (
/obj/effect/turf_decal/tile/bar/opposingcorners,
/obj/effect/turf_decal/siding/wood{
	dir = 4
	},
/turf/open/floor/iron,
/area/shuttle/escape)
"VU" = (
/obj/effect/mob_spawn/corpse/human,
/obj/item/gun/ballistic/automatic/pistol/m1911,
/obj/item/food/cakeslice/birthday,
/obj/effect/decal/cleanable/blood,
/turf/open/floor/carpet,
/area/shuttle/escape)
"Zl" = (
/obj/structure/table/reinforced,
/obj/item/food/cake/birthday,
/obj/effect/turf_decal/tile/bar/opposingcorners,
/obj/effect/turf_decal/siding/wood{
	dir = 10
	},
/obj/item/knife/kitchen,
/turf/open/floor/iron,
/area/shuttle/escape)
"ZN" = (
/turf/open/floor/wood,
/area/shuttle/escape)

(1,1,1) = {"
xQ
xQ
xQ
xQ
RV
RV
RV
RV
st
RV
RV
"}
(2,1,1) = {"
xQ
xQ
xQ
xQ
RV
si
tD
Zl
qE
Dm
RV
"}
(3,1,1) = {"
xQ
RV
RV
RV
RV
wk
cN
Um
kW
ej
RV
"}
(4,1,1) = {"
xQ
RV
LJ
qY
RV
Id
VQ
aN
tP
zV
RV
"}
(5,1,1) = {"
RV
RV
RV
lI
RV
RV
RV
HO
uW
hs
RV
"}
(6,1,1) = {"
RV
Ng
yi
tX
OX
Mk
RV
MX
tX
xo
RV
"}
(7,1,1) = {"
SQ
tX
VU
Lm
ZN
AQ
RV
lh
LK
qL
RV
"}
(8,1,1) = {"
RV
tX
vG
oo
Nf
rT
RV
xL
Mo
wJ
kf
"}
(9,1,1) = {"
RV
Lf
Kf
FX
MI
yE
yE
MI
ZN
Ed
RV
"}
(10,1,1) = {"
RV
RV
RV
kf
RV
RV
RV
RV
kf
RV
RV
"}
