//MAP CONVERTED BY dmm2tgm.py THIS HEADER COMMENT PREVENTS RECONVERSION, DO NOT REMOVE
"ab" = (
/obj/effect/spawner/structure/window/hollow/reinforced/plasma/directional{
	dir = 4
	},
/turf/open/floor/mineral/gold,
/area/shuttle/escape)
"ao" = (
/obj/machinery/door/airlock/gold/glass{
	name = "Feast Hall"
	},
/turf/open/floor/mineral/gold,
/area/shuttle/escape)
"bI" = (
/obj/machinery/door/airlock/gold{
	name = "Private Room"
	},
/turf/open/floor/mineral/gold,
/area/shuttle/escape)
"bK" = (
/obj/structure/chair/comfy/black{
	dir = 4
	},
/turf/open/floor/carpet/royalblack,
/area/shuttle/escape)
"bM" = (
/obj/machinery/power/shuttle_engine/heater{
	icon_state = "router";
	pixel_x = -3;
	desc = "Directs random numbers into compressed particles in order to power engines.";
	name = "RNG rerouter"
	},
/obj/structure/window/reinforced/plasma/spawner/directional/east,
/turf/open/floor/circuit,
/area/shuttle/escape)
"bP" = (
/obj/structure/rack,
/obj/structure/window/reinforced/plasma/spawner/directional/north,
/obj/item/gun/energy/e_gun/nuclear,
/turf/open/floor/mineral/gold,
/area/shuttle/escape)
"bT" = (
/obj/structure/chair/comfy/black{
	dir = 8
	},
/obj/machinery/light/directional/east,
/turf/open/floor/carpet/royalblue,
/area/shuttle/escape)
"cM" = (
/obj/structure/chair/comfy/shuttle{
	dir = 1
	},
/obj/structure/window/reinforced/plasma/spawner/directional/south,
/turf/open/floor/carpet/royalblack,
/area/shuttle/escape)
"cW" = (
/obj/machinery/computer/communications,
/turf/open/floor/carpet/royalblack,
/area/shuttle/escape)
"dg" = (
/obj/structure/platform/gold,
/obj/item/stack/sheet/mineral/diamond/fifty{
	anchored = 1
	},
/obj/structure/window/reinforced/plasma/spawner/directional/west,
/obj/structure/window/reinforced/plasma/spawner/directional/south,
/turf/open/floor/mineral/gold,
/area/shuttle/escape)
"dh" = (
/obj/structure/table/wood/fancy/royalblack,
/obj/machinery/light/directional/south,
/obj/item/reagent_containers/cup/glass/bottle/champagne{
	pixel_y = 15;
	pixel_x = 7
	},
/obj/item/reagent_containers/cup/glass/bottle/champagne{
	pixel_y = 13;
	pixel_x = -5
	},
/obj/item/reagent_containers/cup/glass/bottle/champagne{
	pixel_y = 7;
	pixel_x = 2
	},
/turf/open/floor/carpet/royalblack,
/area/shuttle/escape)
"eM" = (
/obj/structure/showcase/mecha/marauder{
	dir = 8
	},
/obj/structure/window/reinforced/plasma/spawner/directional/west,
/turf/open/floor/mineral/gold,
/area/shuttle/escape)
"eS" = (
/obj/structure/chair/comfy/shuttle,
/turf/open/floor/carpet/royalblack,
/area/shuttle/escape)
"fh" = (
/obj/structure/table/wood/fancy/blue,
/obj/item/reagent_containers/cup/glass/drinkingglass{
	pixel_x = -6;
	pixel_y = 3
	},
/turf/open/floor/carpet/royalblue,
/area/shuttle/escape)
"fx" = (
/obj/structure/table/wood/fancy/royalblack,
/obj/item/kitchen/spoon{
	pixel_y = 7;
	pixel_x = -5
	},
/obj/item/plate,
/obj/item/kitchen/fork{
	pixel_y = -1;
	pixel_x = 5
	},
/obj/item/reagent_containers/cup/glass/drinkingglass{
	pixel_y = 16;
	pixel_x = 11
	},
/turf/open/floor/carpet/royalblack,
/area/shuttle/escape)
"gN" = (
/obj/machinery/door/airlock/gold{
	name = "Emergency Shuttle"
	},
/obj/docking_port/mobile/emergency{
	name = "Millionaire Escape Shuttle"
	},
/turf/open/floor/mineral/gold,
/area/shuttle/escape)
"gQ" = (
/obj/effect/spawner/structure/window/hollow/reinforced/plasma/directional{
	dir = 8
	},
/turf/open/floor/mineral/diamond,
/area/shuttle/escape)
"hB" = (
/obj/structure/table/wood/fancy/royalblack,
/obj/item/toy/plush/lizard_plushie{
	name = "rules-the-peasants"
	},
/obj/item/clothing/head/costume/crown/fancy{
	pixel_y = 14;
	pixel_x = -1
	},
/obj/machinery/light/directional/north,
/turf/open/floor/carpet/royalblack,
/area/shuttle/escape)
"hD" = (
/obj/machinery/power/shuttle_engine/heater,
/obj/structure/window/reinforced/plasma/spawner/directional/north,
/turf/open/floor/plating,
/area/shuttle/escape)
"hT" = (
/obj/structure/platform/gold,
/obj/structure/window/reinforced/plasma/spawner/directional/west,
/obj/item/gun/ballistic/rifle/boltaction/pipegun/pistol/prime{
	anchored = 1
	},
/obj/structure/window/reinforced/plasma/spawner/directional/south,
/turf/open/floor/mineral/gold,
/area/shuttle/escape)
"ie" = (
/obj/structure/platform/gold,
/obj/item/card/id/advanced/silver{
	anchored = 1
	},
/obj/structure/window/reinforced/plasma/spawner/directional/south,
/obj/structure/window/reinforced/plasma/spawner/directional/east,
/turf/open/floor/mineral/gold,
/area/shuttle/escape)
"it" = (
/obj/structure/platform/gold,
/obj/item/instrument/violin/golden{
	anchored = 1
	},
/obj/structure/window/reinforced/plasma/spawner/directional/east,
/obj/machinery/light/directional/west,
/turf/open/floor/mineral/gold,
/area/shuttle/escape)
"iv" = (
/obj/effect/station_crash,
/turf/open/floor/carpet/royalblack,
/area/shuttle/escape)
"iA" = (
/obj/structure/chair/comfy/black{
	dir = 1
	},
/turf/open/floor/carpet/royalblue,
/area/shuttle/escape)
"iM" = (
/obj/structure/table/wood/fancy/royalblack,
/obj/item/melee/baton/security/loaded{
	name = "god's weakest baton";
	desc = "Praise be, for it may carry an officer through many a combat.";
	stamina_damage = 99;
	preload_cell_type = /obj/item/stock_parts/power_store/cell/bluespace;
	on_stun_sound = 'sound/items/weapons/zapbang.ogg';
	resistance_flags = 115
	},
/turf/open/floor/carpet/royalblack,
/area/shuttle/escape)
"jP" = (
/obj/structure/platform/gold,
/obj/item/stack/sheet/mineral/silver/fifty{
	anchored = 1
	},
/obj/structure/window/reinforced/plasma/spawner/directional/west,
/obj/structure/window/reinforced/plasma/spawner/directional/north,
/turf/open/floor/mineral/gold,
/area/shuttle/escape)
"kB" = (
/obj/structure/chair/sofa/corp/left,
/turf/open/floor/carpet/royalblack,
/area/shuttle/escape)
"kG" = (
/obj/item/surgery_tray/full/advanced,
/obj/structure/table/reinforced/titaniumglass,
/obj/machinery/vitals_reader/advanced/directional/north,
/turf/open/floor/mineral/silver,
/area/shuttle/escape)
"kH" = (
/obj/machinery/light/directional/north,
/turf/open/floor/carpet/royalblack,
/area/shuttle/escape)
"kP" = (
/obj/structure/window/reinforced/plasma/spawner/directional/east,
/turf/open/floor/mineral/gold,
/area/shuttle/escape)
"kT" = (
/obj/structure/statue/gold/ce,
/turf/open/floor/mineral/gold,
/area/shuttle/escape)
"lm" = (
/obj/structure/window/reinforced/plasma/spawner/directional/east,
/obj/structure/rack,
/obj/item/skillchip/sabrage{
	pixel_y = -5
	},
/obj/item/skillchip/sabrage,
/obj/item/skillchip/sabrage{
	pixel_y = 7
	},
/turf/open/floor/carpet/royalblack,
/area/shuttle/escape)
"lp" = (
/obj/machinery/light/directional/west,
/turf/open/floor/mineral/gold,
/area/shuttle/escape)
"mk" = (
/obj/structure/rack,
/obj/item/grenade/clusterbuster/teargas{
	pixel_y = 10
	},
/obj/item/grenade/clusterbuster/teargas{
	pixel_y = 3
	},
/obj/item/grenade/clusterbuster/teargas{
	pixel_y = -5
	},
/turf/open/floor/mineral/gold,
/area/shuttle/escape)
"mn" = (
/obj/structure/chair/comfy/black{
	dir = 8
	},
/turf/open/floor/carpet/royalblue,
/area/shuttle/escape)
"nm" = (
/obj/structure/statue/gold/hos,
/turf/open/floor/mineral/gold,
/area/shuttle/escape)
"nQ" = (
/obj/structure/chair/comfy/shuttle{
	dir = 4
	},
/turf/open/floor/mineral/diamond,
/area/shuttle/escape)
"oC" = (
/obj/machinery/door/airlock/gold{
	name = "Emergency Shuttle"
	},
/obj/effect/mapping_helpers/airlock/access/all/security/general,
/turf/open/floor/mineral/gold,
/area/shuttle/escape)
"pk" = (
/obj/machinery/door/airlock/gold{
	name = "Shuttle Brig"
	},
/obj/effect/mapping_helpers/airlock/access/all/security/general,
/turf/open/floor/mineral/gold,
/area/shuttle/escape)
"qt" = (
/obj/structure/window/reinforced/plasma/spawner/directional/west,
/obj/structure/rack,
/obj/item/melee/baton/telescopic/gold{
	pixel_y = 9
	},
/obj/item/melee/baton/telescopic/gold{
	pixel_y = 4
	},
/obj/item/melee/baton/telescopic/gold,
/turf/open/floor/carpet/royalblack,
/area/shuttle/escape)
"qv" = (
/obj/structure/chair/sofa/corp/right,
/turf/open/floor/carpet/royalblack,
/area/shuttle/escape)
"qx" = (
/obj/structure/table/optable,
/obj/machinery/light/small/directional/south,
/obj/item/defibrillator/loaded,
/turf/open/floor/mineral/silver,
/area/shuttle/escape)
"rz" = (
/obj/structure/statue/gold/qm,
/turf/open/floor/mineral/gold,
/area/shuttle/escape)
"rJ" = (
/obj/structure/platform/gold,
/obj/structure/window/reinforced/plasma/spawner/directional/east,
/obj/item/clothing/gloves/boxing/golden{
	anchored = 1
	},
/obj/structure/window/reinforced/plasma/spawner/directional/south,
/turf/open/floor/mineral/gold,
/area/shuttle/escape)
"rR" = (
/obj/structure/chair/comfy/shuttle{
	dir = 4
	},
/turf/open/floor/carpet/royalblack,
/area/shuttle/escape)
"tg" = (
/obj/structure/chair/comfy/shuttle{
	dir = 1
	},
/turf/open/floor/mineral/silver,
/area/shuttle/escape)
"tC" = (
/obj/structure/table/wood/fancy/royalblack,
/obj/item/reagent_containers/cup/glass/bottle/champagne{
	pixel_y = 15;
	pixel_x = -5
	},
/obj/item/reagent_containers/cup/glass/bottle/wine{
	pixel_y = 5
	},
/turf/open/floor/carpet/royalblack,
/area/shuttle/escape)
"uc" = (
/obj/structure/table/wood/fancy/royalblack,
/obj/item/food/cake/wedding{
	pixel_y = 7
	},
/turf/open/floor/carpet/royalblack,
/area/shuttle/escape)
"uk" = (
/obj/structure/platform/gold,
/obj/item/stack/sheet/mineral/gold/fifty{
	anchored = 1
	},
/obj/structure/window/reinforced/plasma/spawner/directional/west,
/obj/machinery/light/directional/east,
/turf/open/floor/mineral/gold,
/area/shuttle/escape)
"ut" = (
/obj/machinery/power/shuttle_engine/propulsion/right,
/turf/open/floor/plating,
/area/shuttle/escape)
"uQ" = (
/turf/closed/wall/mineral/gold,
/area/shuttle/escape)
"uT" = (
/obj/structure/chair/sofa/corp/right{
	dir = 1
	},
/turf/open/floor/carpet/royalblack,
/area/shuttle/escape)
"vh" = (
/obj/structure/rack,
/obj/item/gun/grenadelauncher,
/turf/open/floor/mineral/gold,
/area/shuttle/escape)
"vr" = (
/obj/structure/showcase/mecha/marauder{
	dir = 4
	},
/obj/structure/window/reinforced/plasma/spawner/directional/east,
/turf/open/floor/mineral/gold,
/area/shuttle/escape)
"vz" = (
/obj/structure/table/optable,
/obj/machinery/light/small/directional/north,
/obj/item/defibrillator/loaded,
/turf/open/floor/mineral/silver,
/area/shuttle/escape)
"wg" = (
/obj/structure/chair/comfy/shuttle,
/turf/open/floor/mineral/diamond,
/area/shuttle/escape)
"wp" = (
/turf/closed/wall/mineral/diamond,
/area/shuttle/escape)
"wI" = (
/obj/structure/closet/firecloset/full,
/turf/open/floor/carpet/royalblack,
/area/shuttle/escape)
"wJ" = (
/obj/structure/platform/gold,
/obj/structure/window/reinforced/plasma/spawner/directional/north,
/obj/structure/window/reinforced/plasma/spawner/directional/west,
/obj/item/gun/ballistic/automatic/pistol/deagle/gold{
	anchored = 1
	},
/turf/open/floor/mineral/gold,
/area/shuttle/escape)
"wX" = (
/obj/structure/table/reinforced/titaniumglass,
/obj/item/storage/medkit/fire,
/obj/item/storage/medkit/brute{
	pixel_y = 6
	},
/obj/item/storage/medkit/o2{
	pixel_y = 12
	},
/obj/item/storage/medkit/toxin{
	pixel_y = 18
	},
/obj/machinery/vitals_reader/advanced/directional/west,
/turf/open/floor/mineral/silver,
/area/shuttle/escape)
"xj" = (
/obj/structure/chair/comfy/shuttle{
	dir = 1
	},
/obj/machinery/light/directional/south,
/turf/open/floor/mineral/silver,
/area/shuttle/escape)
"xt" = (
/obj/structure/platform/gold,
/obj/item/card/id/advanced/gold{
	anchored = 1
	},
/obj/structure/window/reinforced/plasma/spawner/directional/east,
/obj/machinery/light/directional/west,
/turf/open/floor/mineral/gold,
/area/shuttle/escape)
"xG" = (
/obj/effect/spawner/structure/window/hollow/reinforced/plasma/directional{
	dir = 8
	},
/turf/open/floor/mineral/gold,
/area/shuttle/escape)
"xH" = (
/obj/structure/showcase/machinery/rng,
/turf/open/floor/circuit,
/area/shuttle/escape)
"xL" = (
/obj/structure/window/reinforced/plasma/spawner/directional/west,
/obj/structure/window/reinforced/plasma/spawner/directional/south,
/obj/structure/rack,
/obj/item/storage/box/handcuffs,
/turf/open/floor/carpet/royalblack,
/area/shuttle/escape)
"yC" = (
/obj/structure/statue/gold/hop,
/turf/open/floor/mineral/gold,
/area/shuttle/escape)
"yE" = (
/obj/machinery/power/shuttle_engine/propulsion/left,
/turf/open/floor/plating,
/area/shuttle/escape)
"yZ" = (
/obj/machinery/door/airlock/silver/glass{
	name = "Medical Bay"
	},
/obj/effect/mapping_helpers/airlock/access/all/medical/general,
/turf/open/floor/mineral/silver,
/area/shuttle/escape)
"zt" = (
/obj/structure/table/wood/fancy/blue,
/obj/item/reagent_containers/cup/glass/bottle/champagne{
	pixel_y = 13;
	pixel_x = 2
	},
/obj/item/reagent_containers/cup/glass/drinkingglass{
	pixel_y = 4;
	pixel_x = 7
	},
/obj/item/reagent_containers/cup/glass/drinkingglass{
	pixel_y = 4;
	pixel_x = -4
	},
/obj/machinery/light/small/directional/north,
/turf/open/floor/carpet/royalblue,
/area/shuttle/escape)
"AC" = (
/obj/effect/spawner/structure/window/reinforced/plasma,
/turf/open/floor/mineral/gold,
/area/shuttle/escape)
"AL" = (
/obj/structure/chair/comfy/shuttle{
	dir = 1
	},
/obj/structure/window/reinforced/plasma/spawner/directional/south,
/obj/machinery/light/directional/south,
/turf/open/floor/carpet/royalblack,
/area/shuttle/escape)
"BV" = (
/obj/structure/closet/emcloset/wall{
	pixel_x = -30
	},
/turf/open/floor/mineral/gold,
/area/shuttle/escape)
"Cp" = (
/obj/machinery/door/airlock/gold{
	name = "Shuttle Bridge"
	},
/obj/effect/mapping_helpers/airlock/access/all/command/general,
/turf/open/floor/carpet/royalblack,
/area/shuttle/escape)
"Cz" = (
/obj/effect/spawner/structure/window/hollow/reinforced/plasma/directional{
	dir = 4
	},
/turf/open/floor/mineral/diamond,
/area/shuttle/escape)
"CK" = (
/obj/structure/chair/comfy/shuttle{
	dir = 4
	},
/obj/structure/window/reinforced/plasma/spawner/directional/west,
/turf/open/floor/carpet/royalblack,
/area/shuttle/escape)
"CU" = (
/turf/open/floor/carpet/royalblue,
/area/shuttle/escape)
"De" = (
/obj/structure/window/reinforced/plasma/spawner/directional/south,
/obj/structure/window/reinforced/plasma/spawner/directional/east,
/obj/structure/rack,
/obj/item/storage/box/flashbangs,
/turf/open/floor/carpet/royalblack,
/area/shuttle/escape)
"DD" = (
/obj/structure/table/wood/fancy/blue,
/obj/item/reagent_containers/cup/glass/bottle/champagne{
	pixel_y = 21;
	pixel_x = -1
	},
/obj/item/reagent_containers/cup/glass/drinkingglass,
/obj/item/reagent_containers/cup/glass/drinkingglass{
	pixel_y = 4;
	pixel_x = 7
	},
/turf/open/floor/carpet/royalblue,
/area/shuttle/escape)
"Ef" = (
/obj/machinery/power/shuttle_engine/heater{
	icon_state = "router";
	pixel_x = 3;
	name = "RNG rerouter";
	desc = "Directs random numbers into compressed particles in order to power engines."
	},
/obj/structure/window/reinforced/plasma/spawner/directional/west,
/turf/open/floor/circuit,
/area/shuttle/escape)
"Er" = (
/obj/structure/table/wood/fancy/royalblack,
/obj/structure/flora/tree/pine/xmas/millionaire{
	pixel_x = -15;
	pixel_y = 7
	},
/turf/open/floor/carpet/royalblack,
/area/shuttle/escape)
"EC" = (
/obj/structure/rack,
/obj/item/mod/control/pre_equipped/magnate,
/turf/open/floor/mineral/gold,
/area/shuttle/escape)
"ES" = (
/obj/structure/table/wood/fancy/royalblack,
/obj/machinery/light/directional/north,
/obj/item/book/bible,
/turf/open/floor/carpet/royalblack,
/area/shuttle/escape)
"Gu" = (
/obj/machinery/door/airlock/gold{
	name = "Private Room"
	},
/obj/effect/mapping_helpers/airlock/access/all/security/general,
/turf/open/floor/mineral/gold,
/area/shuttle/escape)
"HZ" = (
/obj/structure/platform/gold,
/obj/item/card/id/advanced/platinum{
	anchored = 1
	},
/obj/structure/window/reinforced/plasma/spawner/directional/east,
/obj/structure/window/reinforced/plasma/spawner/directional/north,
/turf/open/floor/mineral/gold,
/area/shuttle/escape)
"Ih" = (
/obj/structure/rack,
/obj/item/melee/baton/security/stunsword/loaded,
/turf/open/floor/mineral/gold,
/area/shuttle/escape)
"Iu" = (
/obj/structure/chair/comfy/black{
	dir = 4
	},
/turf/open/floor/carpet/royalblue,
/area/shuttle/escape)
"IJ" = (
/turf/template_noop,
/area/template_noop)
"KO" = (
/obj/structure/closet/secure_closet/freezer/empty,
/obj/effect/spawner/random/food_or_drink/three_course_meal,
/obj/effect/spawner/random/food_or_drink/three_course_meal,
/obj/effect/spawner/random/food_or_drink/three_course_meal,
/obj/effect/spawner/random/food_or_drink/three_course_meal,
/turf/open/floor/carpet/royalblack,
/area/shuttle/escape)
"KP" = (
/obj/structure/table/wood/fancy/royalblack,
/obj/item/kitchen/fork{
	pixel_y = 7;
	pixel_x = -5
	},
/obj/item/plate,
/obj/item/kitchen/spoon{
	pixel_y = -1;
	pixel_x = 4
	},
/obj/item/reagent_containers/cup/glass/drinkingglass{
	pixel_y = -1;
	pixel_x = -11
	},
/turf/open/floor/carpet/royalblack,
/area/shuttle/escape)
"LN" = (
/obj/structure/chair/sofa/corp/left{
	dir = 1
	},
/turf/open/floor/carpet/royalblack,
/area/shuttle/escape)
"LU" = (
/obj/structure/chair/comfy/shuttle{
	dir = 4
	},
/obj/machinery/light/directional/west,
/turf/open/floor/carpet/royalblack,
/area/shuttle/escape)
"LZ" = (
/obj/structure/table/reinforced/titaniumglass,
/obj/item/storage/medkit/tactical/premium,
/obj/item/storage/medkit/tactical/premium{
	pixel_y = 8
	},
/turf/open/floor/mineral/silver,
/area/shuttle/escape)
"Mj" = (
/obj/structure/table/reinforced/titaniumglass,
/obj/item/storage/medkit/expeditionary,
/obj/item/storage/medkit/advanced{
	pixel_y = 7
	},
/obj/machinery/vitals_reader/advanced/directional/west,
/turf/open/floor/mineral/silver,
/area/shuttle/escape)
"Ms" = (
/obj/structure/table/wood/fancy/royalblack,
/turf/open/floor/carpet/royalblack,
/area/shuttle/escape)
"MK" = (
/obj/structure/chair/comfy/shuttle{
	dir = 8
	},
/obj/machinery/light/directional/north,
/obj/machinery/keycard_auth/wall_mounted/directional/north,
/turf/open/floor/mineral/diamond,
/area/shuttle/escape)
"MQ" = (
/obj/machinery/computer/operating{
	dir = 1
	},
/obj/machinery/defibrillator_mount/charging{
	pixel_y = -32
	},
/turf/open/floor/mineral/silver,
/area/shuttle/escape)
"Nb" = (
/obj/structure/closet/emcloset,
/turf/open/floor/carpet/royalblack,
/area/shuttle/escape)
"Nd" = (
/obj/structure/table/wood/fancy/royalblack,
/obj/machinery/recharger,
/turf/open/floor/carpet/royalblack,
/area/shuttle/escape)
"Nk" = (
/obj/effect/spawner/structure/window/reinforced/plasma,
/turf/open/floor/mineral/diamond,
/area/shuttle/escape)
"ND" = (
/obj/structure/window/reinforced/plasma/spawner/directional/east,
/obj/machinery/power/shuttle_engine/heater{
	icon_state = "router";
	pixel_x = -3;
	desc = "Directs random numbers into compressed particles in order to power engines.";
	name = "RNG rerouter"
	},
/turf/open/floor/circuit,
/area/shuttle/escape)
"NO" = (
/obj/machinery/stasis{
	dir = 1
	},
/turf/open/floor/mineral/silver,
/area/shuttle/escape)
"Oa" = (
/obj/structure/statue/gold/cmo,
/turf/open/floor/mineral/gold,
/area/shuttle/escape)
"Ob" = (
/obj/machinery/vending/boozeomat,
/turf/closed/wall/mineral/gold,
/area/shuttle/escape)
"Oh" = (
/obj/structure/table/wood/fancy/royalblack,
/obj/item/food/cake/chocolate{
	pixel_x = 6;
	pixel_y = 3
	},
/obj/item/knife/kitchen{
	pixel_x = -8;
	pixel_y = 4
	},
/turf/open/floor/carpet/royalblack,
/area/shuttle/escape)
"Qx" = (
/obj/item/storage/belt/sheath/sabre{
	pixel_x = 5
	},
/obj/item/storage/belt/sheath/sabre,
/obj/item/storage/belt/sheath/sabre{
	pixel_x = -5
	},
/obj/structure/rack,
/obj/machinery/light/directional/north,
/obj/item/reagent_containers/cup/glass/bottle/champagne,
/turf/open/floor/carpet/royalblack,
/area/shuttle/escape)
"QD" = (
/obj/machinery/light/directional/east,
/turf/open/floor/mineral/gold,
/area/shuttle/escape)
"Rg" = (
/obj/structure/platform/gold,
/obj/item/reagent_containers/cup/glass/trophy/gold_cup{
	anchored = 1
	},
/obj/structure/window/reinforced/plasma/spawner/directional/east,
/obj/structure/window/reinforced/plasma/spawner/directional/north,
/turf/open/floor/mineral/gold,
/area/shuttle/escape)
"Rr" = (
/obj/structure/chair/comfy/black{
	dir = 8
	},
/turf/open/floor/carpet/royalblack,
/area/shuttle/escape)
"Rt" = (
/turf/closed/wall/mineral/silver,
/area/shuttle/escape)
"Rv" = (
/obj/machinery/computer/crew,
/turf/open/floor/carpet/royalblack,
/area/shuttle/escape)
"RB" = (
/obj/structure/rack,
/obj/item/stock_parts/power_store/battery/infinite,
/turf/open/floor/mineral/gold,
/area/shuttle/escape)
"RK" = (
/turf/open/floor/mineral/silver,
/area/shuttle/escape)
"RP" = (
/obj/machinery/computer/emergency_shuttle,
/turf/open/floor/carpet/royalblack,
/area/shuttle/escape)
"Tp" = (
/turf/open/floor/carpet/royalblack,
/area/shuttle/escape)
"TV" = (
/obj/structure/chair/comfy/shuttle{
	dir = 8
	},
/obj/structure/window/reinforced/plasma/spawner/directional/east,
/turf/open/floor/carpet/royalblack,
/area/shuttle/escape)
"US" = (
/obj/machinery/door/window/brigdoor/left/directional/south{
	name = "Security Storage";
	req_access = list("brig")
	},
/mob/living/basic/bot/secbot/beepsky/armsky{
	pixel_y = 3;
	desc = "Defender of the righteous, saviour of the weak.";
	name = "Brother Paladinsky";
	health = 300
	},
/turf/open/floor/carpet/royalblack,
/area/shuttle/escape)
"Vb" = (
/obj/structure/chair/comfy/shuttle,
/obj/machinery/light/directional/north,
/turf/open/floor/mineral/silver,
/area/shuttle/escape)
"Vf" = (
/obj/structure/chair/comfy/shuttle{
	dir = 8
	},
/turf/open/floor/mineral/diamond,
/area/shuttle/escape)
"Vg" = (
/obj/machinery/power/shuttle_engine/propulsion,
/turf/open/floor/plating,
/area/shuttle/escape)
"Vo" = (
/obj/structure/platform/gold,
/obj/structure/window/reinforced/plasma/spawner/directional/west,
/obj/item/gun/energy/disabler/smoothbore/prime{
	anchored = 1
	},
/obj/machinery/light/directional/east,
/turf/open/floor/mineral/gold,
/area/shuttle/escape)
"VB" = (
/obj/structure/statue/gold/rd,
/turf/open/floor/mineral/gold,
/area/shuttle/escape)
"VJ" = (
/obj/structure/window/reinforced/plasma/spawner/directional/west,
/turf/open/floor/mineral/gold,
/area/shuttle/escape)
"VL" = (
/obj/structure/table/wood/fancy/royalblack,
/obj/machinery/light/directional/south,
/turf/open/floor/carpet/royalblack,
/area/shuttle/escape)
"We" = (
/obj/machinery/computer/operating,
/obj/machinery/defibrillator_mount/charging{
	pixel_y = 32
	},
/turf/open/floor/mineral/silver,
/area/shuttle/escape)
"WG" = (
/obj/effect/spawner/structure/window/reinforced/shuttle,
/turf/open/floor/mineral/silver,
/area/shuttle/escape)
"Xy" = (
/obj/structure/window/reinforced/plasma/spawner/directional/west,
/obj/machinery/power/shuttle_engine/heater{
	icon_state = "router";
	pixel_x = 3;
	name = "RNG rerouter";
	desc = "Directs random numbers into compressed particles in order to power engines."
	},
/turf/open/floor/circuit,
/area/shuttle/escape)
"Yh" = (
/obj/structure/chair/comfy/shuttle{
	dir = 4
	},
/obj/machinery/light/directional/north,
/obj/machinery/keycard_auth/wall_mounted/directional/north,
/turf/open/floor/mineral/diamond,
/area/shuttle/escape)
"Yr" = (
/obj/structure/rack,
/obj/item/storage/bag/money/vault,
/turf/open/floor/mineral/gold,
/area/shuttle/escape)
"YS" = (
/obj/item/surgery_tray/full/advanced,
/obj/structure/table/reinforced/titaniumglass,
/obj/machinery/vitals_reader/advanced/directional/south,
/turf/open/floor/mineral/silver,
/area/shuttle/escape)
"Zx" = (
/turf/open/floor/mineral/gold,
/area/shuttle/escape)

(1,1,1) = {"
IJ
IJ
IJ
IJ
IJ
IJ
IJ
IJ
IJ
IJ
IJ
IJ
IJ
IJ
IJ
IJ
IJ
IJ
IJ
IJ
uQ
uQ
uQ
oC
uQ
gN
uQ
uQ
Rt
Rt
Rt
Rt
Rt
Rt
Rt
IJ
IJ
"}
(2,1,1) = {"
IJ
IJ
IJ
IJ
IJ
IJ
IJ
IJ
IJ
IJ
IJ
IJ
IJ
IJ
IJ
uQ
AC
AC
uQ
uQ
uQ
LU
rR
Zx
uQ
iv
BV
wI
Rt
Mj
NO
NO
wX
Rt
Rt
Rt
Rt
"}
(3,1,1) = {"
IJ
IJ
IJ
IJ
IJ
IJ
IJ
IJ
IJ
IJ
uQ
uQ
uQ
uQ
uQ
uQ
fh
DD
iA
uQ
eS
iM
Nd
Zx
AC
Tp
Zx
Rt
Rt
Vb
RK
RK
tg
Rt
Rt
hD
yE
"}
(4,1,1) = {"
IJ
IJ
IJ
IJ
IJ
IJ
IJ
IJ
IJ
IJ
IJ
IJ
uQ
Zx
Zx
uQ
mn
bT
CU
Gu
Zx
Zx
Zx
Zx
uQ
Tp
Zx
yZ
RK
RK
RK
RK
xj
Rt
Xy
hD
Vg
"}
(5,1,1) = {"
IJ
IJ
IJ
IJ
IJ
IJ
IJ
uQ
uQ
xG
uQ
xG
uQ
Zx
uQ
uQ
uQ
uQ
uQ
uQ
uQ
qt
xL
Zx
uQ
Tp
Zx
yZ
RK
RK
RK
RK
LZ
Rt
xH
hD
Vg
"}
(6,1,1) = {"
IJ
IJ
IJ
wp
gQ
gQ
uQ
uQ
uQ
AC
uQ
AC
uQ
uQ
uQ
CK
CK
CK
CK
Zx
uQ
Qx
US
Zx
AC
Tp
Zx
Rt
Rt
Rt
RK
RK
Rt
Rt
xH
hD
Vg
"}
(7,1,1) = {"
wp
wp
wp
wp
Nk
Nk
uQ
HZ
xt
ie
vr
Rg
it
rJ
uQ
kH
Tp
Tp
Tp
Zx
uQ
lm
De
Zx
uQ
Tp
Zx
cM
Rt
We
RK
RK
MQ
Rt
ND
hD
Vg
"}
(8,1,1) = {"
IJ
IJ
wp
wp
Yh
nQ
nQ
bP
Oa
vh
nm
Yr
VB
EC
AC
TV
TV
TV
TV
Zx
uQ
uQ
uQ
pk
uQ
Tp
Zx
cM
WG
vz
RK
RK
qx
Rt
Rt
hD
ut
"}
(9,1,1) = {"
IJ
IJ
AC
cW
Tp
Tp
Tp
Tp
Tp
Tp
Tp
Tp
Tp
Tp
uQ
VJ
VJ
VJ
VJ
Zx
Zx
Zx
lp
Zx
Zx
Tp
Zx
AL
Rt
kG
RK
RK
YS
Rt
Rt
Rt
Rt
"}
(10,1,1) = {"
IJ
IJ
AC
RP
wg
Tp
Tp
Tp
Tp
Tp
Tp
Tp
Tp
Tp
Cp
Tp
Tp
Tp
Tp
Tp
Tp
Tp
Tp
Tp
Tp
Tp
Zx
cM
Rt
Rt
Rt
Rt
Rt
Rt
Rt
IJ
IJ
"}
(11,1,1) = {"
IJ
IJ
AC
Rv
Tp
Tp
Tp
Tp
Tp
Tp
Tp
Tp
Tp
Tp
uQ
kP
kP
kP
kP
Zx
Zx
Zx
QD
Zx
Zx
Zx
Zx
cM
uQ
KO
Zx
Zx
Oh
uQ
uQ
uQ
uQ
"}
(12,1,1) = {"
IJ
IJ
wp
wp
MK
Vf
Vf
bP
yC
mk
rz
RB
kT
Ih
AC
CK
CK
CK
CK
Zx
tC
uQ
uQ
uQ
ao
ao
uQ
uQ
uQ
KO
Zx
Zx
uc
uQ
uQ
hD
yE
"}
(13,1,1) = {"
wp
wp
wp
wp
Nk
Nk
uQ
jP
uk
dg
eM
wJ
Vo
hT
uQ
kH
Tp
Tp
Tp
Zx
Er
uQ
Zx
Zx
Zx
Zx
Zx
lp
Zx
Zx
Zx
Zx
Zx
uQ
Ef
hD
Vg
"}
(14,1,1) = {"
IJ
IJ
IJ
wp
Cz
Cz
uQ
uQ
uQ
AC
uQ
AC
uQ
uQ
uQ
TV
TV
TV
TV
Zx
Ms
uQ
hB
Zx
bK
bK
bK
bK
bK
bK
bK
Zx
VL
uQ
xH
hD
Vg
"}
(15,1,1) = {"
IJ
IJ
IJ
IJ
IJ
IJ
IJ
uQ
uQ
ab
uQ
ab
uQ
Zx
uQ
uQ
uQ
uQ
uQ
Zx
Zx
uQ
qv
Zx
fx
fx
fx
fx
fx
fx
fx
Zx
LN
uQ
xH
hD
Vg
"}
(16,1,1) = {"
IJ
IJ
IJ
IJ
IJ
IJ
IJ
IJ
IJ
IJ
IJ
IJ
uQ
Zx
Zx
uQ
Iu
CU
bI
Zx
Zx
uQ
kB
Zx
KP
KP
KP
KP
KP
KP
KP
Zx
uT
uQ
bM
hD
Vg
"}
(17,1,1) = {"
IJ
IJ
IJ
IJ
IJ
IJ
IJ
IJ
IJ
IJ
uQ
uQ
uQ
uQ
uQ
uQ
zt
iA
uQ
Nb
wI
uQ
ES
Zx
Rr
Rr
Rr
Rr
Rr
Rr
Rr
Zx
dh
uQ
uQ
hD
ut
"}
(18,1,1) = {"
IJ
IJ
IJ
IJ
IJ
IJ
IJ
IJ
IJ
IJ
IJ
IJ
IJ
IJ
IJ
uQ
AC
AC
uQ
uQ
uQ
Ob
Zx
Zx
Zx
Zx
Zx
QD
Zx
Zx
Zx
Zx
Zx
wI
uQ
uQ
uQ
"}
(19,1,1) = {"
IJ
IJ
IJ
IJ
IJ
IJ
IJ
IJ
IJ
IJ
IJ
IJ
IJ
IJ
IJ
IJ
IJ
IJ
IJ
IJ
uQ
uQ
uQ
uQ
uQ
AC
uQ
uQ
uQ
AC
uQ
uQ
uQ
uQ
uQ
IJ
IJ
"}
