//MAP CONVERTED BY dmm2tgm.py THIS HEADER COMMENT PREVENTS RECONVERSION, DO NOT REMOVE
"cn" = (
/obj/effect/turf_decal/siding/thinplating_new/dark{
	dir = 6
	},
/obj/structure/table/reinforced/titaniumglass,
/obj/machinery/recharger,
/obj/item/melee/baton,
/obj/structure/extinguisher_cabinet/directional/west,
/turf/open/floor/iron/dark/textured_large,
/area/space)
"co" = (
/obj/effect/turf_decal/stripes/line{
	dir = 8
	},
/obj/machinery/power/shuttle_engine/propulsion/burst{
	dir = 8
	},
/turf/open/floor/plating/airless,
/area/space)
"dl" = (
/turf/closed/wall/mineral/titanium,
/area/space)
"el" = (
/obj/effect/turf_decal/stripes/line{
	dir = 8
	},
/obj/machinery/power/shuttle_engine/propulsion/burst/left{
	dir = 8
	},
/turf/open/floor/plating/airless,
/area/space)
"eU" = (
/obj/effect/turf_decal/tile/dark_blue/half/contrasted{
	dir = 4
	},
/turf/open/floor/iron/smooth_edge{
	dir = 8
	},
/area/space)
"gg" = (
/obj/machinery/door/airlock/external/ruin{
	name = "NT-C Taurus External Airlock"
	},
/turf/open/floor/iron/dark/small,
/area/space)
"hL" = (
/obj/effect/turf_decal/tile/dark_blue/anticorner/contrasted,
/obj/machinery/computer/crew{
	dir = 1
	},
/turf/open/floor/iron/smooth,
/area/space)
"ig" = (
/obj/structure/railing{
	dir = 4
	},
/turf/open/floor/iron/stairs{
	dir = 1
	},
/area/space)
"lz" = (
/obj/machinery/door/airlock/security/old{
	name = "NT-C Taurus Cryogenics"
	},
/obj/effect/turf_decal/siding/wood{
	dir = 1
	},
/turf/open/floor/iron/dark/small,
/area/space)
"lE" = (
/obj/machinery/airalarm/directional/west,
/turf/open/floor/wood/large,
/area/space)
"mv" = (
/obj/structure/closet/secure_closet/personal/cabinet,
/obj/item/ammo_box/magazine/m223,
/obj/item/ammo_box/magazine/m223,
/turf/open/floor/wood/large,
/area/space)
"mV" = (
/obj/effect/turf_decal/siding/thinplating_new/dark{
	dir = 4
	},
/obj/machinery/suit_storage_unit/standard_unit,
/obj/machinery/airalarm/directional/west,
/turf/open/floor/iron/dark/textured_large,
/area/space)
"nk" = (
/obj/structure/railing{
	dir = 4
	},
/turf/open/floor/iron/large,
/area/space)
"nF" = (
/obj/effect/turf_decal/tile/dark_blue/anticorner/contrasted{
	dir = 4
	},
/turf/open/floor/iron/smooth,
/area/space)
"nK" = (
/obj/structure/table/reinforced/titaniumglass,
/obj/effect/turf_decal/tile/dark_blue/anticorner/contrasted{
	dir = 8
	},
/obj/item/storage/toolbox/emergency,
/turf/open/floor/iron/smooth,
/area/space)
"oJ" = (
/obj/machinery/door/airlock/corporate/glass{
	name = "NT-C Taurus Bridge"
	},
/turf/open/floor/iron/dark/small,
/area/space)
"qk" = (
/obj/effect/turf_decal/tile/dark_blue/anticorner/contrasted{
	dir = 4
	},
/obj/machinery/computer/crew,
/turf/open/floor/iron/smooth,
/area/space)
"qB" = (
/obj/machinery/door/airlock/engineering{
	name = "NT-C Taurus Engineering"
	},
/turf/open/floor/iron/dark/small,
/area/space)
"qF" = (
/obj/structure/table/wood,
/obj/item/paper_bin,
/obj/item/pen,
/obj/item/stamp/centcom,
/turf/open/floor/carpet/executive,
/area/space)
"rs" = (
/obj/effect/turf_decal/tile/dark_blue/anticorner/contrasted,
/obj/structure/closet/crate/bin,
/turf/open/floor/iron/smooth,
/area/space)
"rM" = (
/obj/machinery/airalarm/directional/east,
/turf/open/floor/iron/herringbone,
/area/space)
"sn" = (
/obj/effect/turf_decal/siding/thinplating_new/dark/end,
/obj/item/kirbyplants/organic/plant21,
/obj/machinery/biogenerator/medstation/directional/north,
/turf/open/floor/iron/dark/textured_large,
/area/space)
"sY" = (
/turf/open/floor/iron/dark/smooth_large,
/area/space)
"tg" = (
/obj/machinery/power/smes/full,
/obj/effect/turf_decal/siding/thinplating_new/dark{
	dir = 8
	},
/turf/open/floor/iron/dark/textured_large,
/area/space)
"tv" = (
/obj/structure/table/reinforced/titaniumglass,
/obj/effect/turf_decal/tile/dark_blue/half/contrasted{
	dir = 4
	},
/obj/machinery/turretid{
	control_area = "/area/shuttle/escape";
	desc = "Used to control the Lance's automated defenses.";
	icon_state = "control_kill";
	lethal = 1;
	req_access = list("command");
	pixel_y = 3
	},
/turf/open/floor/iron/smooth_edge{
	dir = 8
	},
/area/space)
"tY" = (
/obj/machinery/cryopod{
	dir = 4
	},
/obj/effect/turf_decal/siding/wood{
	dir = 4
	},
/turf/open/floor/carpet/blue,
/area/space)
"uB" = (
/turf/open/floor/iron/smooth,
/area/space)
"wB" = (
/obj/effect/turf_decal/siding/thinplating_new/dark/end,
/obj/item/kirbyplants/organic/plant21,
/obj/machinery/airalarm/directional/north,
/turf/open/floor/iron/dark/textured_large,
/area/space)
"xc" = (
/obj/structure/table/reinforced/titaniumglass,
/obj/effect/turf_decal/tile/dark_blue/anticorner/contrasted{
	dir = 4
	},
/obj/machinery/recharger,
/turf/open/floor/iron/smooth,
/area/space)
"xt" = (
/obj/effect/turf_decal/tile/dark_blue/half/contrasted{
	dir = 8
	},
/obj/machinery/airalarm/directional/west,
/turf/open/floor/iron/smooth_edge{
	dir = 4
	},
/area/space)
"ya" = (
/obj/structure/chair/office,
/turf/open/floor/iron/smooth_large,
/area/space)
"yf" = (
/obj/machinery/power/shuttle_engine/heater{
	dir = 8
	},
/obj/structure/window/reinforced/survival_pod/spawner/directional/west,
/obj/machinery/door/window/survival_pod/left/directional/east{
	name = "Engine Access"
	},
/turf/open/floor/plating,
/area/space)
"zj" = (
/obj/machinery/airalarm/directional/east,
/turf/open/floor/wood/large,
/area/space)
"zx" = (
/obj/structure/table/reinforced,
/obj/machinery/cell_charger,
/obj/effect/turf_decal/siding/thinplating_new/dark{
	dir = 8
	},
/turf/open/floor/iron/dark/textured_large,
/area/space)
"AJ" = (
/obj/structure/bed,
/obj/item/bedsheet/orange,
/turf/open/floor/iron,
/area/space)
"CF" = (
/turf/open/space/basic,
/area/space)
"CZ" = (
/obj/effect/turf_decal/siding/thinplating_new/dark{
	dir = 4
	},
/obj/structure/rack/shelf,
/obj/item/ammo_box/c46x30mm,
/obj/item/storage/toolbox/ammobox/wt550m9,
/obj/item/storage/toolbox/ammobox/wt550m9,
/turf/open/floor/iron/dark/textured_large,
/area/space)
"Di" = (
/obj/structure/chair/office{
	dir = 1
	},
/turf/open/floor/iron/smooth_large,
/area/space)
"DL" = (
/obj/machinery/suit_storage_unit/standard_unit,
/obj/effect/turf_decal/siding/thinplating_new/dark{
	dir = 10
	},
/turf/open/floor/iron/dark/textured_large,
/area/space)
"DU" = (
/obj/effect/turf_decal/tile/dark_blue/anticorner/contrasted,
/obj/machinery/computer/centcom_announcement{
	dir = 8;
	name = "private security announcement console";
	command_name = "Nanotrasen Private Security Response Team Update"
	},
/turf/open/floor/iron/smooth,
/area/space)
"EN" = (
/obj/item/kirbyplants/organic/plant21,
/turf/open/floor/iron/smooth_large,
/area/space)
"EW" = (
/obj/effect/turf_decal/tile/dark_blue,
/turf/open/floor/iron/smooth_corner,
/area/space)
"Fg" = (
/obj/structure/railing{
	dir = 4
	},
/turf/open/floor/iron/stairs,
/area/space)
"Fk" = (
/obj/structure/table/reinforced,
/obj/item/storage/toolbox/mechanical{
	pixel_y = 9
	},
/obj/item/storage/toolbox/electrical{
	pixel_y = 2
	},
/obj/item/multitool,
/obj/machinery/biogenerator/medstation/directional/south,
/turf/open/floor/iron/smooth,
/area/space)
"FU" = (
/obj/effect/turf_decal/tile/dark_blue/half/contrasted,
/obj/machinery/computer/security{
	dir = 1
	},
/turf/open/floor/iron/smooth_edge{
	dir = 1
	},
/area/space)
"Gw" = (
/obj/effect/turf_decal/siding/thinplating_new/dark{
	dir = 4
	},
/obj/machinery/suit_storage_unit/standard_unit,
/turf/open/floor/iron/dark/textured_large,
/area/space)
"GE" = (
/obj/effect/turf_decal/siding/thinplating_new/dark{
	dir = 4
	},
/turf/open/floor/iron/dark/textured_large,
/area/space)
"GI" = (
/turf/open/floor/iron/smooth_large,
/area/space)
"GW" = (
/obj/machinery/door/airlock/security/old{
	name = "NT-C Taurus E.V.A."
	},
/turf/open/floor/iron/dark/small,
/area/space)
"Ha" = (
/obj/effect/turf_decal/stripes/line{
	dir = 8
	},
/obj/machinery/power/shuttle_engine/propulsion/burst/right{
	dir = 8
	},
/turf/open/floor/plating/airless,
/area/space)
"HV" = (
/obj/structure/table/reinforced/titaniumglass,
/obj/item/paper_bin,
/obj/item/pen,
/turf/open/floor/iron/smooth_large,
/area/space)
"Ir" = (
/turf/open/floor/iron,
/area/space)
"Iz" = (
/obj/structure/table/reinforced/titaniumglass,
/obj/effect/turf_decal/tile/dark_blue/anticorner/contrasted{
	dir = 1
	},
/obj/item/storage/medkit/advanced,
/obj/structure/extinguisher_cabinet/directional/north,
/turf/open/floor/iron/smooth,
/area/space)
"IE" = (
/obj/effect/turf_decal/tile/dark_blue/half/contrasted{
	dir = 4
	},
/obj/structure/table/reinforced/titaniumglass,
/turf/open/floor/iron/smooth_edge{
	dir = 8
	},
/area/space)
"Je" = (
/obj/machinery/cryopod{
	dir = 4
	},
/obj/machinery/computer/cryopod/directional/west,
/obj/effect/turf_decal/siding/wood{
	dir = 4
	},
/turf/open/floor/carpet/blue,
/area/space)
"Jo" = (
/obj/effect/turf_decal/tile/dark_blue/half/contrasted{
	dir = 1
	},
/obj/machinery/computer/security,
/turf/open/floor/iron/smooth_edge,
/area/space)
"JU" = (
/obj/structure/table/reinforced,
/obj/item/stack/sheet/mineral/plasma/five,
/obj/effect/turf_decal/siding/thinplating_new/dark{
	dir = 8
	},
/turf/open/floor/iron/dark/textured_large,
/area/space)
"KZ" = (
/obj/machinery/door/airlock/security/old/glass{
	name = "NT-C Taurus Holding Cell"
	},
/turf/open/floor/iron/dark/small,
/area/space)
"Le" = (
/obj/structure/table/wood,
/obj/item/folder/red,
/turf/open/floor/carpet/executive,
/area/space)
"LP" = (
/obj/effect/turf_decal/tile/dark_blue/half/contrasted,
/obj/machinery/computer/records/security{
	dir = 1
	},
/turf/open/floor/iron/smooth_edge{
	dir = 1
	},
/area/space)
"Mz" = (
/obj/effect/turf_decal/siding/wood{
	dir = 8
	},
/obj/structure/chair/office{
	dir = 4
	},
/turf/open/floor/carpet/executive,
/area/space)
"MG" = (
/obj/effect/turf_decal/siding/thinplating_new/dark{
	dir = 9
	},
/obj/structure/rack/shelf,
/obj/item/storage/box/handcuffs,
/turf/open/floor/iron/dark/textured_large,
/area/space)
"NS" = (
/turf/closed/wall/mineral/titanium/nodiagonal,
/area/space)
"Ou" = (
/obj/machinery/power/port_gen/pacman,
/obj/effect/turf_decal/siding/thinplating_new/dark{
	dir = 8
	},
/turf/open/floor/iron/dark/textured_large,
/area/space)
"OZ" = (
/obj/effect/turf_decal/siding/thinplating_new/dark{
	dir = 10
	},
/obj/machinery/vending/snack/teal{
	onstation = 0
	},
/turf/open/floor/iron/dark/textured_large,
/area/space)
"PJ" = (
/obj/effect/spawner/structure/window/reinforced/shuttle,
/turf/open/floor/plating,
/area/space)
"Rn" = (
/obj/effect/turf_decal/tile/dark_blue/half/contrasted{
	dir = 1
	},
/obj/machinery/computer/records/security,
/turf/open/floor/iron/smooth_edge,
/area/space)
"Ro" = (
/turf/open/floor/iron/herringbone,
/area/space)
"Ru" = (
/obj/structure/table/reinforced/titaniumglass,
/obj/item/megaphone/sec,
/turf/open/floor/iron/smooth_large,
/area/space)
"RV" = (
/turf/open/floor/wood/large,
/area/space)
"Sz" = (
/obj/effect/turf_decal/siding/wood{
	dir = 8
	},
/turf/open/floor/carpet/executive,
/area/space)
"Tq" = (
/obj/machinery/vending/security{
	onstation = 0;
	name = "\improper SecTech";
	desc = "An old security equipment vendor. Used back before Security were ever introduced to Armadyne.";
	icon = 'icons/obj/machines/vending.dmi';
	product_ads = "Crack communist skulls!;Beat some heads in!;Don't forget - harm is good!;Your weapons are right here.;Handcuffs!;Freeze, scumbag!;Don't tase me bro!;Tase them, bro.;Why not have a donut?";
	premium = list(/obj/item/storage/belt/security/webbing = 5,/obj/item/coin/antagtoken = 1,/obj/item/clothing/head/helmet/blueshirt = 1,/obj/item/clothing/suit/armor/vest/blueshirt = 1,/obj/item/grenade/stingbang = 1,/obj/item/watertank/pepperspray = 2,/obj/item/storage/belt/holster/energy = 4);
	products = list(/obj/item/restraints/handcuffs = 8,/obj/item/restraints/handcuffs/cable/zipties = 10,/obj/item/grenade/flashbang = 4,/obj/item/assembly/flash/handheld = 5,/obj/item/food/donut/plain = 12,/obj/item/storage/box/evidence = 6,/obj/item/flashlight/seclite = 4,/obj/item/restraints/legcuffs/bola/energy = 7,/obj/item/clothing/gloves/tackler = 5);
	skyrat_products = null;
	zubbers_contraband = null;
	contraband = list(/obj/item/clothing/glasses/sunglasses = 2, /obj/item/storage/fancy/donut_box = 2);
	pixel_x = 32;
	density = 0
	},
/turf/open/floor/iron/herringbone,
/area/space)
"TP" = (
/obj/machinery/door/airlock/highsecurity{
	name = "NT-C Taurus Armory";
	security_level = 6
	},
/turf/open/floor/iron/dark/small,
/area/space)
"Up" = (
/obj/effect/turf_decal/siding/thinplating_new/dark{
	dir = 4
	},
/obj/structure/rack/shelf,
/obj/item/ammo_box/c45,
/obj/item/ammo_box/c45,
/obj/item/ammo_box/magazine/m45,
/obj/item/ammo_box/magazine/m45,
/obj/item/ammo_box/magazine/m45,
/obj/item/ammo_box/magazine/m45,
/obj/item/ammo_box/magazine/m45,
/obj/item/ammo_box/magazine/m45,
/obj/item/ammo_box/magazine/m45,
/obj/item/ammo_box/magazine/m45,
/turf/open/floor/iron/dark/textured_large,
/area/space)
"UE" = (
/obj/structure/table/reinforced/titaniumglass,
/obj/machinery/fax/admin,
/turf/open/floor/iron/smooth_large,
/area/space)
"UF" = (
/obj/machinery/door/airlock/hos{
	name = "NT-C Taurus Commander's Office"
	},
/obj/effect/turf_decal/siding/wood{
	dir = 1
	},
/turf/open/floor/iron/dark/small,
/area/space)
"Vx" = (
/obj/effect/turf_decal/siding/thinplating_new/dark{
	dir = 6
	},
/turf/open/floor/iron/dark/textured_large,
/area/space)
"WR" = (
/obj/structure/chair/comfy/black{
	dir = 4
	},
/turf/open/floor/iron/smooth_large,
/area/space)
"WV" = (
/obj/effect/turf_decal/siding/thinplating_new/dark{
	dir = 5
	},
/turf/open/floor/iron/dark/textured_large,
/area/space)
"WW" = (
/obj/effect/turf_decal/siding/thinplating_new/dark{
	dir = 4
	},
/obj/structure/rack/shelf,
/obj/item/storage/box/lethalshot,
/obj/item/storage/box/lethalshot,
/obj/item/gun/ballistic/shotgun/automatic/combat,
/turf/open/floor/iron/dark/textured_large,
/area/space)
"Xb" = (
/obj/structure/tank_dispenser/oxygen,
/obj/structure/extinguisher_cabinet/directional/north,
/turf/open/floor/iron/smooth,
/area/space)
"Xh" = (
/turf/open/floor/mineral/gold,
/area/space)
"Yc" = (
/obj/effect/turf_decal/tile/dark_blue/half/contrasted{
	dir = 8
	},
/obj/machinery/biogenerator/medstation/directional/west,
/turf/open/floor/iron/smooth_edge{
	dir = 4
	},
/area/space)
"YE" = (
/obj/effect/turf_decal/siding/thinplating_new/dark,
/obj/machinery/vending/cola/blue{
	onstation = 0
	},
/turf/open/floor/iron/dark/textured_large,
/area/space)
"Zx" = (
/obj/effect/turf_decal/tile/dark_blue{
	dir = 4
	},
/turf/open/floor/iron/smooth_corner{
	dir = 4
	},
/area/space)
"ZW" = (
/obj/machinery/suit_storage_unit/standard_unit,
/obj/effect/turf_decal/siding/thinplating_new/dark{
	dir = 9
	},
/turf/open/floor/iron/dark/textured_large,
/area/space)

(1,1,1) = {"
NS
CF
CF
CF
CF
CF
CF
dl
gg
dl
CF
CF
CF
CF
CF
CF
NS
"}
(2,1,1) = {"
NS
CF
CF
CF
CF
CF
CF
PJ
sY
PJ
CF
CF
CF
CF
CF
CF
NS
"}
(3,1,1) = {"
NS
dl
CF
CF
CF
CF
dl
NS
sY
NS
dl
CF
CF
CF
CF
dl
NS
"}
(4,1,1) = {"
NS
NS
el
co
Ha
NS
NS
NS
gg
NS
NS
NS
el
co
Ha
NS
NS
"}
(5,1,1) = {"
NS
NS
yf
yf
yf
NS
Xb
WV
GE
Vx
Fk
NS
yf
yf
yf
NS
NS
"}
(6,1,1) = {"
dl
NS
uB
uB
uB
uB
uB
uB
uB
uB
uB
uB
uB
uB
uB
NS
dl
"}
(7,1,1) = {"
CF
NS
NS
Ou
JU
tg
DL
uB
uB
uB
ZW
tg
zx
Ou
NS
NS
CF
"}
(8,1,1) = {"
CF
NS
NS
NS
NS
NS
NS
NS
qB
NS
NS
NS
NS
NS
NS
NS
CF
"}
(9,1,1) = {"
CF
dl
NS
tY
Je
tY
NS
cn
Ro
NS
Gw
Gw
mV
Gw
NS
dl
CF
"}
(10,1,1) = {"
CF
CF
PJ
RV
zj
RV
lz
Ro
Ro
GW
Ro
Ro
Ro
Ro
PJ
CF
CF
"}
(11,1,1) = {"
CF
CF
dl
NS
NS
NS
NS
sn
Ro
NS
NS
NS
NS
NS
dl
CF
CF
"}
(12,1,1) = {"
CF
CF
CF
gg
sY
sY
gg
Ro
Ro
PJ
Up
WW
CZ
NS
CF
CF
CF
"}
(13,1,1) = {"
CF
CF
CF
NS
NS
NS
NS
wB
Ro
TP
Tq
rM
Ro
NS
CF
CF
CF
"}
(14,1,1) = {"
CF
CF
CF
NS
mv
lE
UF
Ro
Ro
NS
NS
NS
NS
NS
CF
CF
CF
"}
(15,1,1) = {"
CF
CF
CF
PJ
Mz
Sz
NS
OZ
Ro
Ro
KZ
Ir
Ir
PJ
CF
CF
CF
"}
(16,1,1) = {"
CF
CF
CF
NS
Le
qF
NS
YE
Ro
MG
PJ
Ir
AJ
PJ
CF
CF
CF
"}
(17,1,1) = {"
CF
CF
CF
NS
NS
NS
NS
PJ
oJ
PJ
NS
NS
NS
NS
CF
CF
CF
"}
(18,1,1) = {"
CF
CF
CF
NS
Iz
xt
ig
nk
nk
nk
Fg
Yc
nK
NS
CF
CF
CF
"}
(19,1,1) = {"
CF
CF
CF
PJ
Rn
GI
EN
HV
UE
Ru
EN
GI
LP
PJ
CF
CF
CF
"}
(20,1,1) = {"
CF
CF
CF
PJ
Jo
Di
GI
Xh
Xh
Xh
GI
ya
FU
PJ
CF
CF
CF
"}
(21,1,1) = {"
CF
CF
CF
PJ
qk
Zx
GI
GI
Xh
GI
GI
EW
hL
PJ
CF
CF
CF
"}
(22,1,1) = {"
CF
CF
CF
PJ
PJ
xc
tv
Zx
WR
EW
IE
rs
PJ
PJ
CF
CF
CF
"}
(23,1,1) = {"
CF
CF
CF
CF
PJ
PJ
PJ
nF
eU
DU
PJ
PJ
PJ
CF
CF
CF
CF
"}
(24,1,1) = {"
CF
CF
CF
CF
CF
CF
PJ
PJ
PJ
PJ
PJ
CF
CF
CF
CF
CF
CF
"}
