//MAP CONVERTED BY dmm2tgm.py THIS HEADER COMMENT PREVENTS RECONVERSION, DO NOT REMOVE
"bD" = (
/obj/effect/turf_decal/siding/dark{
	dir = 1
	},
/obj/effect/decal/cleanable/blood/gibs/xeno/up,
/turf/open/floor/iron/smooth_half{
	dir = 1
	},
/area/shuttle/abandoned)
"bM" = (
/obj/effect/turf_decal/stripes/line{
	dir = 8
	},
/obj/machinery/light/small/directional/west,
/obj/machinery/atmospherics/pipe/smart/manifold/purple/visible{
	dir = 8
	},
/turf/open/floor/plating,
/area/shuttle/abandoned)
"cV" = (
/obj/structure/table,
/obj/item/food/canned/beans{
	pixel_y = 12;
	pixel_x = 8
	},
/obj/item/reagent_containers/cup/glass/bottle/beer/light{
	pixel_x = -5;
	pixel_y = 7
	},
/turf/open/floor/carpet/purple,
/area/shuttle/abandoned)
"dG" = (
/obj/effect/turf_decal/siding/yellow{
	dir = 4
	},
/obj/machinery/light/small/directional/east,
/turf/open/floor/iron/dark/smooth_half{
	dir = 1
	},
/area/shuttle/abandoned)
"eh" = (
/obj/effect/turf_decal/stripes/line{
	dir = 9
	},
/obj/structure/cable,
/obj/structure/spider/stickyweb,
/turf/open/floor/plating,
/area/shuttle/abandoned)
"es" = (
/obj/structure/sign/nanotrasen,
/turf/closed/wall/mineral/plastitanium/nodiagonal,
/area/shuttle/abandoned)
"eB" = (
/obj/machinery/light/directional/west,
/obj/structure/table/reinforced{
	color = "#c2bfa3"
	},
/obj/item/storage/box/donkpockets{
	pixel_x = -5;
	pixel_y = 3
	},
/obj/item/reagent_containers/cup/glass/shaker{
	pixel_x = 4;
	pixel_y = 1
	},
/obj/structure/spacevine/xen/thick,
/turf/open/floor/wood,
/area/shuttle/abandoned)
"fi" = (
/obj/effect/turf_decal/stripes/line,
/obj/effect/turf_decal/caution/stand_clear,
/obj/machinery/door/poddoor/shutters{
	id_tag = "exploshittlebot"
	},
/obj/machinery/atmospherics/pipe/smart/simple/scrubbers/hidden{
	dir = 10
	},
/turf/open/floor/iron/dark/textured_half{
	dir = 1
	},
/area/shuttle/abandoned)
"fE" = (
/obj/machinery/light_switch/directional/east,
/obj/structure/sign/poster/official/random/directional/east,
/turf/open/floor/mineral/titanium/tiled/purple,
/area/shuttle/abandoned)
"ga" = (
/obj/effect/turf_decal/siding/yellow{
	dir = 8
	},
/obj/machinery/button/door{
	pixel_x = -24;
	id_tag = "exploshittlebot";
	pixel_y = -5
	},
/obj/effect/turf_decal/arrows{
	dir = 8
	},
/obj/machinery/atmospherics/pipe/smart/simple/scrubbers/hidden{
	dir = 1
	},
/obj/effect/decal/cleanable/blood/gibs/robot_debris/up,
/turf/open/floor/iron/dark/smooth_half{
	dir = 1
	},
/area/shuttle/abandoned)
"gt" = (
/obj/machinery/atmospherics/pipe/smart/manifold4w/purple/visible,
/turf/open/floor/plating,
/area/shuttle/abandoned)
"gB" = (
/obj/structure/window/reinforced/survival_pod/spawner/directional/south,
/obj/machinery/power/shuttle_engine/heater,
/turf/open/floor/plating,
/area/shuttle/abandoned)
"gC" = (
/obj/structure/table,
/obj/item/flashlight/lamp{
	pixel_x = -1;
	pixel_y = 4
	},
/turf/open/floor/carpet/purple,
/area/shuttle/abandoned)
"gJ" = (
/obj/structure/table,
/obj/item/food/canned/beans{
	pixel_y = 14;
	pixel_x = -6
	},
/turf/open/floor/carpet/purple,
/area/shuttle/abandoned)
"he" = (
/obj/effect/turf_decal/siding/yellow{
	dir = 8
	},
/obj/effect/turf_decal/stripes/line,
/obj/structure/sign/warning/vacuum/external{
	pixel_x = -32
	},
/obj/machinery/door/poddoor/shutters{
	id_tag = "exploshittlebot"
	},
/obj/machinery/atmospherics/pipe/smart/simple/scrubbers/hidden{
	dir = 5
	},
/turf/open/floor/iron/dark/textured_half{
	dir = 1
	},
/area/shuttle/abandoned)
"hw" = (
/obj/effect/turf_decal/stripes/line{
	dir = 8
	},
/obj/machinery/power/shuttle_engine/heater,
/obj/structure/window/reinforced/survival_pod/spawner/directional/south,
/turf/open/floor/plating,
/area/shuttle/abandoned)
"hC" = (
/obj/effect/turf_decal/siding/dark{
	dir = 1
	},
/obj/structure/spacevine/xen,
/turf/open/floor/iron/smooth,
/area/shuttle/abandoned)
"hI" = (
/obj/structure/table/reinforced{
	color = "#c2bfa3"
	},
/obj/machinery/microwave{
	pixel_y = 3
	},
/turf/open/floor/wood,
/area/shuttle/abandoned)
"iw" = (
/obj/structure/spacevine/xen,
/turf/open/floor/iron/smooth_half{
	dir = 1
	},
/area/shuttle/abandoned)
"iB" = (
/obj/structure/table/reinforced,
/obj/structure/sign/poster/official/random/directional/west,
/turf/open/floor/mineral/titanium/tiled/purple,
/area/shuttle/abandoned)
"iK" = (
/obj/effect/turf_decal/stripes/line{
	dir = 6
	},
/obj/machinery/power/shuttle_engine/propulsion,
/turf/open/floor/plating/airless,
/area/shuttle/abandoned)
"ly" = (
/obj/effect/decal/cleanable/blood/gibs/robot_debris/limb,
/obj/effect/decal/cleanable/blood/oil,
/turf/open/floor/mineral/titanium/tiled/purple,
/area/shuttle/abandoned)
"lV" = (
/obj/effect/turf_decal/stripes/line{
	dir = 4
	},
/obj/machinery/power/port_gen/pacman,
/obj/machinery/atmospherics/pipe/bridge_pipe/purple/visible,
/turf/open/floor/plating,
/area/shuttle/abandoned)
"ma" = (
/obj/machinery/button/door{
	pixel_y = -24;
	id_tag = "exploshittletop"
	},
/obj/effect/turf_decal/stripes/line{
	dir = 8
	},
/obj/machinery/atmospherics/components/binary/valve{
	dir = 4;
	name = "Air reserve valve"
	},
/obj/structure/spider/stickyweb,
/turf/open/floor/plating,
/area/shuttle/abandoned)
"mb" = (
/obj/machinery/atmospherics/pipe/smart/simple/supply/hidden{
	dir = 5
	},
/obj/structure/blob/normal,
/turf/open/floor/iron/smooth_half{
	dir = 1
	},
/area/shuttle/abandoned)
"mH" = (
/obj/effect/decal/cleanable/blood/gibs/xeno/core,
/turf/open/floor/iron/smooth_half{
	dir = 1
	},
/area/shuttle/abandoned)
"mV" = (
/obj/effect/turf_decal/stripes/line{
	dir = 4
	},
/obj/machinery/light/small/directional/east,
/obj/machinery/atmospherics/pipe/smart/simple/purple/visible{
	dir = 10
	},
/turf/open/floor/plating,
/area/shuttle/abandoned)
"nh" = (
/obj/effect/turf_decal/siding/yellow{
	dir = 8
	},
/obj/effect/turf_decal/stripes/line{
	dir = 1
	},
/obj/machinery/door/poddoor/shutters{
	id_tag = "exploshittletop"
	},
/obj/machinery/atmospherics/pipe/smart/simple/scrubbers/hidden{
	dir = 6
	},
/turf/open/floor/iron/dark/textured_half{
	dir = 1
	},
/area/shuttle/abandoned)
"nq" = (
/turf/template_noop,
/area/template_noop)
"nS" = (
/obj/machinery/atmospherics/components/unary/portables_connector/visible,
/obj/machinery/portable_atmospherics/canister/plasma,
/obj/effect/turf_decal/stripes/line{
	dir = 9
	},
/obj/effect/turf_decal/bot/left,
/obj/effect/decal/cleanable/cobweb,
/turf/open/floor/plating,
/area/shuttle/abandoned)
"nY" = (
/obj/effect/turf_decal/siding/yellow{
	dir = 4
	},
/obj/machinery/button/door{
	pixel_x = 24;
	id_tag = "exploshittletop"
	},
/obj/machinery/atmospherics/pipe/smart/simple/supply/hidden{
	dir = 9
	},
/turf/open/floor/iron/dark/smooth_half{
	dir = 1
	},
/area/shuttle/abandoned)
"ol" = (
/obj/machinery/computer/crew,
/turf/open/floor/mineral/titanium/tiled/purple,
/area/shuttle/abandoned)
"ox" = (
/obj/machinery/door/airlock/external,
/obj/effect/mapping_helpers/airlock/cyclelink_helper_multi{
	cycle_id = "exploshittle"
	},
/obj/effect/turf_decal/stripes/line{
	dir = 8
	},
/obj/effect/turf_decal/stripes/line{
	dir = 4
	},
/obj/structure/cable,
/obj/docking_port/mobile{
	dir = 8;
	id_tag = "exploration";
	name = "Exploration Shuttle";
	port_direction = 8;
	preferred_direction = 2;
	shuttle_id = "Explorer"
	},
/turf/open/floor/iron/textured_half{
	dir = 1
	},
/area/shuttle/abandoned)
"pC" = (
/obj/effect/turf_decal/siding/dark/corner{
	dir = 1
	},
/obj/machinery/atmospherics/components/unary/vent_scrubber/on,
/turf/open/floor/iron/smooth_half{
	dir = 1
	},
/area/shuttle/abandoned)
"qN" = (
/obj/machinery/atmospherics/pipe/smart/simple/supply/hidden{
	dir = 1
	},
/obj/effect/decal/cleanable/blood/gibs/old,
/turf/open/floor/mineral/titanium/tiled/purple,
/area/shuttle/abandoned)
"qZ" = (
/obj/effect/turf_decal/siding/yellow{
	dir = 8
	},
/obj/machinery/atmospherics/pipe/smart/simple/purple/hidden{
	dir = 4
	},
/obj/machinery/atmospherics/pipe/smart/simple/scrubbers/hidden{
	dir = 1
	},
/turf/open/floor/iron/dark/smooth_half{
	dir = 1
	},
/area/shuttle/abandoned)
"rg" = (
/obj/machinery/atmospherics/components/tank/air{
	dir = 8
	},
/turf/open/floor/plating,
/area/shuttle/abandoned)
"sx" = (
/obj/structure/spacevine/xen,
/obj/effect/decal/remains/xeno/larva,
/turf/open/floor/iron/smooth_half{
	dir = 1
	},
/area/shuttle/abandoned)
"sy" = (
/obj/effect/turf_decal/stripes/line{
	dir = 1
	},
/obj/effect/turf_decal/bot/left,
/obj/effect/decal/cleanable/cobweb,
/turf/open/floor/plating,
/area/shuttle/abandoned)
"sK" = (
/obj/effect/turf_decal/siding/wood{
	dir = 1
	},
/obj/structure/spacevine/xen,
/obj/structure/spacevine/xen/thick,
/obj/structure/sign/poster/official/random/directional/west,
/turf/open/floor/wood,
/area/shuttle/abandoned)
"sR" = (
/obj/effect/turf_decal/arrows,
/obj/machinery/atmospherics/pipe/smart/simple/scrubbers/hidden{
	dir = 1
	},
/obj/structure/spider/stickyweb,
/turf/open/floor/iron/smooth_half{
	dir = 1
	},
/area/shuttle/abandoned)
"te" = (
/obj/effect/turf_decal/stripes/line{
	dir = 1
	},
/obj/machinery/light/small/directional/north,
/obj/structure/cable,
/turf/open/floor/iron/textured_half,
/area/shuttle/abandoned)
"tQ" = (
/obj/effect/turf_decal/siding/wood{
	dir = 4
	},
/obj/structure/spacevine/xen,
/obj/structure/spacevine/xen/thick,
/obj/item/storage/box/donkpockets/donkpocketgondola,
/turf/open/floor/wood,
/area/shuttle/abandoned)
"ug" = (
/turf/closed/wall/mineral/titanium/nodiagonal,
/area/shuttle/abandoned)
"vq" = (
/obj/effect/turf_decal/caution{
	dir = 1
	},
/turf/open/floor/iron/dark/smooth_half{
	dir = 1
	},
/area/shuttle/abandoned)
"xG" = (
/obj/structure/table/reinforced{
	color = "#c2bfa3"
	},
/obj/item/storage/toolbox/mechanical,
/obj/item/multitool,
/turf/open/floor/mineral/titanium,
/area/shuttle/abandoned)
"xR" = (
/obj/machinery/atmospherics/pipe/bridge_pipe/purple/visible,
/turf/open/floor/plating,
/area/shuttle/abandoned)
"yj" = (
/obj/structure/reagent_dispensers/fueltank,
/obj/effect/turf_decal/stripes/line{
	dir = 5
	},
/obj/effect/turf_decal/bot/right,
/obj/effect/decal/cleanable/cobweb/cobweb2,
/turf/open/floor/plating,
/area/shuttle/abandoned)
"yJ" = (
/obj/effect/spawner/structure/window/reinforced/shuttle,
/turf/open/floor/plating,
/area/shuttle/abandoned)
"yO" = (
/obj/structure/table/reinforced{
	color = "#c2bfa3"
	},
/obj/machinery/chem_dispenser/drinks{
	dir = 1
	},
/obj/effect/turf_decal/siding/wood{
	dir = 4
	},
/turf/open/floor/wood,
/area/shuttle/abandoned)
"AI" = (
/obj/effect/turf_decal/siding/dark{
	dir = 8
	},
/obj/structure/blob/normal,
/turf/open/floor/iron/smooth_half{
	dir = 1
	},
/area/shuttle/abandoned)
"Dq" = (
/obj/structure/sign/nanotrasen,
/turf/closed/wall/mineral/titanium/nodiagonal,
/area/shuttle/abandoned)
"DQ" = (
/obj/machinery/atmospherics/pipe/smart/simple/supply/hidden{
	dir = 10
	},
/turf/open/floor/iron/smooth,
/area/shuttle/abandoned)
"DR" = (
/obj/machinery/atmospherics/pipe/smart/simple/supply/hidden{
	dir = 1
	},
/obj/structure/spider/stickyweb,
/turf/open/floor/iron/smooth_half{
	dir = 1
	},
/area/shuttle/abandoned)
"DX" = (
/obj/machinery/light/directional/west,
/turf/open/floor/carpet/purple,
/area/shuttle/abandoned)
"EZ" = (
/turf/closed/wall/mineral/plastitanium,
/area/shuttle/abandoned)
"Fc" = (
/obj/machinery/door/airlock/shuttle,
/obj/machinery/atmospherics/pipe/smart/simple/supply/hidden{
	dir = 1
	},
/turf/open/floor/iron/textured_half,
/area/shuttle/abandoned)
"Gh" = (
/obj/effect/decal/cleanable/blood/gibs/xeno,
/obj/structure/blob/normal,
/turf/open/floor/iron/smooth_half{
	dir = 1
	},
/area/shuttle/abandoned)
"GS" = (
/obj/machinery/atmospherics/components/unary/vent_pump/on{
	dir = 4
	},
/obj/machinery/atmospherics/pipe/smart/simple/scrubbers/hidden{
	dir = 1
	},
/turf/open/floor/iron/smooth_half{
	dir = 1
	},
/area/shuttle/abandoned)
"GZ" = (
/obj/effect/turf_decal/stripes/line{
	dir = 10
	},
/obj/machinery/power/shuttle_engine/propulsion,
/turf/open/floor/plating/airless,
/area/shuttle/abandoned)
"Hr" = (
/obj/effect/turf_decal/siding/wood{
	dir = 5
	},
/obj/structure/spacevine/xen,
/obj/structure/spacevine/xen/thick,
/turf/open/floor/wood,
/area/shuttle/abandoned)
"Hw" = (
/turf/open/floor/iron/smooth_half{
	dir = 1
	},
/area/shuttle/abandoned)
"HU" = (
/obj/structure/table/reinforced{
	color = "#c2bfa3"
	},
/obj/machinery/chem_dispenser/drinks/beer{
	dir = 1
	},
/turf/open/floor/wood,
/area/shuttle/abandoned)
"HW" = (
/obj/machinery/atmospherics/pipe/smart/manifold/supply/hidden,
/obj/structure/cable,
/obj/structure/spider/stickyweb,
/turf/open/floor/iron/smooth,
/area/shuttle/abandoned)
"HZ" = (
/obj/machinery/atmospherics/pipe/smart/simple/supply/hidden{
	dir = 10
	},
/obj/effect/decal/cleanable/blood/gibs/robot_debris/down,
/turf/open/floor/mineral/titanium/tiled/purple,
/area/shuttle/abandoned)
"Id" = (
/obj/effect/turf_decal/siding/yellow{
	dir = 4
	},
/obj/effect/turf_decal/stripes/line,
/obj/structure/sign/warning/vacuum/external{
	pixel_x = 32
	},
/obj/machinery/door/poddoor/shutters{
	id_tag = "exploshittlebot"
	},
/turf/open/floor/iron/dark/textured_half{
	dir = 1
	},
/area/shuttle/abandoned)
"Ie" = (
/obj/machinery/door/airlock/hatch,
/obj/machinery/atmospherics/pipe/smart/simple/purple/visible{
	dir = 4
	},
/turf/open/floor/plating,
/area/shuttle/abandoned)
"Iq" = (
/obj/structure/spider/stickyweb,
/turf/open/floor/iron/smooth_half{
	dir = 1
	},
/area/shuttle/abandoned)
"Iy" = (
/obj/machinery/atmospherics/pipe/smart/simple/scrubbers/hidden{
	dir = 1
	},
/obj/structure/spider/stickyweb,
/turf/open/floor/iron/smooth_half{
	dir = 1
	},
/area/shuttle/abandoned)
"IF" = (
/obj/machinery/atmospherics/components/unary/vent_pump/on{
	dir = 4
	},
/turf/open/floor/mineral/titanium/tiled/purple,
/area/shuttle/abandoned)
"IW" = (
/turf/open/floor/carpet/purple,
/area/shuttle/abandoned)
"Kb" = (
/obj/item/trash/sosjerky,
/turf/open/floor/carpet/purple,
/area/shuttle/abandoned)
"KA" = (
/obj/machinery/computer/rdconsole,
/turf/open/floor/mineral/titanium/tiled/purple,
/area/shuttle/abandoned)
"KH" = (
/turf/closed/wall/mineral/plastitanium/nodiagonal,
/area/shuttle/abandoned)
"KY" = (
/obj/effect/turf_decal/siding/yellow{
	dir = 8
	},
/obj/machinery/light/small/directional/west,
/obj/machinery/atmospherics/pipe/smart/simple/scrubbers/hidden{
	dir = 1
	},
/turf/open/floor/iron/dark/smooth_half{
	dir = 1
	},
/area/shuttle/abandoned)
"Lb" = (
/obj/effect/turf_decal/stripes/line,
/obj/machinery/power/shuttle_engine/propulsion,
/turf/open/floor/plating/airless,
/area/shuttle/abandoned)
"Lt" = (
/obj/structure/closet/crate,
/obj/item/pickaxe,
/obj/item/mining_scanner,
/obj/item/gps/mining,
/obj/effect/turf_decal/stripes/line{
	dir = 8
	},
/obj/machinery/atmospherics/pipe/bridge_pipe/purple/visible,
/obj/item/stack/sheet/mineral/plasma/five,
/turf/open/floor/plating,
/area/shuttle/abandoned)
"Mn" = (
/obj/structure/table/reinforced,
/obj/item/paper_bin{
	pixel_x = -19;
	pixel_y = 4
	},
/obj/item/pen{
	pixel_x = 5;
	pixel_y = 6
	},
/turf/open/floor/mineral/titanium/tiled/purple,
/area/shuttle/abandoned)
"Nm" = (
/obj/structure/window/reinforced/survival_pod/spawner/directional/south,
/obj/effect/turf_decal/stripes/line{
	dir = 4
	},
/obj/machinery/power/shuttle_engine/heater,
/turf/open/floor/plating,
/area/shuttle/abandoned)
"Ns" = (
/obj/structure/reagent_dispensers/watertank,
/obj/machinery/atmospherics/pipe/bridge_pipe/purple/visible,
/turf/open/floor/plating,
/area/shuttle/abandoned)
"NC" = (
/obj/machinery/atmospherics/pipe/smart/simple/supply/hidden{
	dir = 1
	},
/obj/structure/spider/stickyweb,
/turf/open/floor/iron/smooth,
/area/shuttle/abandoned)
"NG" = (
/obj/machinery/atmospherics/components/unary/portables_connector/visible,
/obj/machinery/portable_atmospherics/canister/plasma,
/obj/effect/turf_decal/stripes/line{
	dir = 1
	},
/obj/effect/turf_decal/bot/right,
/turf/open/floor/plating,
/area/shuttle/abandoned)
"NQ" = (
/obj/machinery/light/directional/east,
/obj/effect/decal/cleanable/cobweb/cobweb2,
/obj/machinery/computer/camera_advanced/shuttle_docker{
	dir = 8
	},
/turf/open/floor/mineral/titanium/tiled/purple,
/area/shuttle/abandoned)
"Oc" = (
/obj/machinery/atmospherics/pipe/smart/manifold/supply/hidden{
	dir = 8
	},
/obj/structure/spider/stickyweb,
/turf/open/floor/iron/smooth_half{
	dir = 1
	},
/area/shuttle/abandoned)
"Ot" = (
/obj/machinery/atmospherics/pipe/smart/simple/supply/hidden{
	dir = 6
	},
/obj/structure/spider/stickyweb,
/turf/open/floor/iron/smooth_half{
	dir = 1
	},
/area/shuttle/abandoned)
"Pc" = (
/obj/machinery/atmospherics/components/unary/outlet_injector/on{
	dir = 1
	},
/turf/open/floor/catwalk_floor,
/area/shuttle/abandoned)
"Pp" = (
/obj/machinery/light/directional/west,
/obj/structure/table/reinforced,
/obj/machinery/recharger,
/turf/open/floor/mineral/titanium/tiled/purple,
/area/shuttle/abandoned)
"PH" = (
/obj/machinery/computer/shuttle,
/turf/open/floor/mineral/titanium/tiled/purple,
/area/shuttle/abandoned)
"PV" = (
/turf/open/floor/catwalk_floor,
/area/shuttle/abandoned)
"PY" = (
/obj/machinery/door/airlock/external,
/obj/effect/mapping_helpers/airlock/cyclelink_helper_multi{
	cycle_id = "exploshittle"
	},
/obj/effect/turf_decal/stripes/line{
	dir = 8
	},
/obj/effect/turf_decal/stripes/line{
	dir = 4
	},
/obj/structure/cable,
/turf/open/floor/iron/textured_half{
	dir = 1
	},
/area/shuttle/abandoned)
"Qs" = (
/obj/machinery/door/airlock/external,
/obj/effect/mapping_helpers/airlock/cyclelink_helper_multi{
	cycle_id = "exploshittle"
	},
/obj/effect/turf_decal/stripes/line{
	dir = 8
	},
/obj/effect/turf_decal/stripes/line{
	dir = 4
	},
/obj/machinery/atmospherics/pipe/smart/simple/supply/hidden{
	dir = 4
	},
/obj/structure/cable,
/turf/open/floor/iron/textured_half{
	dir = 1
	},
/area/shuttle/abandoned)
"QT" = (
/obj/machinery/atmospherics/pipe/smart/simple/supply/hidden{
	dir = 6
	},
/turf/open/floor/iron/dark/smooth_half{
	dir = 1
	},
/area/shuttle/abandoned)
"Rk" = (
/obj/machinery/atmospherics/components/unary/vent_pump/on{
	dir = 1
	},
/obj/machinery/atmospherics/pipe/smart/simple/purple/hidden{
	dir = 4
	},
/turf/open/floor/iron/dark/smooth_half{
	dir = 1
	},
/area/shuttle/abandoned)
"RC" = (
/obj/structure/table/reinforced{
	color = "#c2bfa3"
	},
/obj/machinery/recharger,
/obj/effect/decal/cleanable/cobweb/cobweb2,
/turf/open/floor/mineral/titanium,
/area/shuttle/abandoned)
"RJ" = (
/obj/machinery/holopad,
/obj/effect/turf_decal/box,
/obj/machinery/atmospherics/pipe/smart/simple/scrubbers/hidden{
	dir = 1
	},
/turf/open/floor/iron/smooth_half{
	dir = 1
	},
/area/shuttle/abandoned)
"RX" = (
/obj/machinery/light/directional/east,
/obj/machinery/light_switch/directional/east,
/obj/structure/cable,
/obj/structure/spider/stickyweb,
/turf/open/floor/iron/smooth,
/area/shuttle/abandoned)
"Sp" = (
/obj/effect/decal/cleanable/cobweb,
/obj/item/gun/energy/laser/musket{
	pin = /obj/item/firing_pin/explorer
	},
/obj/structure/closet/crate/science,
/obj/item/storage/backpack/explorer,
/obj/item/storage/backpack/messenger/explorer,
/obj/item/storage/backpack/satchel/explorer,
/obj/item/clothing/suit/hooded/explorer,
/obj/item/storage/backpack/duffelbag/explorer,
/turf/open/floor/carpet/purple,
/area/shuttle/abandoned)
"Ss" = (
/obj/machinery/atmospherics/pipe/smart/manifold/supply/hidden{
	dir = 4
	},
/obj/structure/spider/stickyweb,
/turf/open/floor/iron/smooth_half{
	dir = 1
	},
/area/shuttle/abandoned)
"SP" = (
/turf/closed/wall/mineral/titanium,
/area/shuttle/abandoned)
"Vc" = (
/obj/machinery/atmospherics/pipe/smart/simple/supply/hidden{
	dir = 1
	},
/obj/structure/blob/normal,
/turf/open/floor/iron/smooth,
/area/shuttle/abandoned)
"Wb" = (
/obj/structure/tank_dispenser/oxygen,
/obj/effect/turf_decal/stripes/line{
	dir = 1
	},
/obj/machinery/power/apc/auto_name/directional/east,
/obj/structure/cable,
/turf/open/floor/plating,
/area/shuttle/abandoned)
"WI" = (
/obj/effect/turf_decal/siding/wood{
	dir = 4
	},
/obj/structure/spacevine/xen,
/obj/structure/spacevine/xen/thick,
/turf/open/floor/wood,
/area/shuttle/abandoned)
"Xe" = (
/obj/effect/turf_decal/siding/yellow{
	dir = 4
	},
/obj/effect/turf_decal/stripes/line{
	dir = 1
	},
/obj/machinery/door/poddoor/shutters{
	id_tag = "exploshittletop"
	},
/obj/machinery/atmospherics/pipe/smart/simple/supply/hidden{
	dir = 1
	},
/turf/open/floor/iron/dark/textured_half{
	dir = 1
	},
/area/shuttle/abandoned)
"Yd" = (
/obj/machinery/light/directional/east,
/obj/machinery/atmospherics/pipe/smart/simple/supply/hidden{
	dir = 1
	},
/obj/structure/sign/poster/official/random/directional/east,
/turf/open/floor/iron/smooth,
/area/shuttle/abandoned)
"Zh" = (
/obj/machinery/button/door{
	pixel_x = -24;
	id_tag = "exploshittlebot";
	pixel_y = -5
	},
/turf/open/floor/catwalk_floor,
/area/shuttle/abandoned)
"Zo" = (
/obj/effect/decal/cleanable/blood/gibs/robot_debris,
/turf/open/floor/mineral/titanium/tiled/purple,
/area/shuttle/abandoned)
"ZN" = (
/obj/effect/turf_decal/stripes/line,
/obj/machinery/atmospherics/pipe/smart/simple/supply/hidden{
	dir = 4
	},
/obj/structure/cable,
/turf/open/floor/iron/textured_half,
/area/shuttle/abandoned)
"ZQ" = (
/obj/effect/turf_decal/siding/yellow{
	dir = 4
	},
/obj/machinery/atmospherics/pipe/smart/simple/purple/hidden{
	dir = 4
	},
/obj/effect/decal/cleanable/blood/gibs/robot_debris/old,
/turf/open/floor/iron/dark/smooth_half{
	dir = 1
	},
/area/shuttle/abandoned)
"ZZ" = (
/obj/effect/turf_decal/stripes/line{
	dir = 1
	},
/obj/effect/turf_decal/caution/stand_clear,
/obj/machinery/door/poddoor/shutters{
	id_tag = "exploshittletop"
	},
/obj/machinery/atmospherics/pipe/smart/simple/scrubbers/hidden{
	dir = 9
	},
/turf/open/floor/iron/dark/textured_half{
	dir = 1
	},
/area/shuttle/abandoned)

(1,1,1) = {"
nq
nq
nq
nq
nq
nq
nq
nq
nq
nq
nq
nq
nq
EZ
KH
es
KH
KH
nq
"}
(2,1,1) = {"
nq
nq
nq
nq
SP
Dq
yJ
ug
ug
ug
ug
yJ
ug
KH
nS
bM
Lt
hw
GZ
"}
(3,1,1) = {"
nq
SP
ug
ug
ug
Sp
cV
DX
hC
sK
eB
hI
HU
KH
NG
gt
xR
gB
Lb
"}
(4,1,1) = {"
yJ
yJ
Pp
iB
ug
IW
gC
Kb
hC
Hr
WI
tQ
yO
KH
KH
Ie
KH
KH
KH
"}
(5,1,1) = {"
yJ
KA
Zo
Mn
ug
IW
gJ
IW
bD
mH
iw
sx
iw
nh
KY
qZ
ga
he
Zh
"}
(6,1,1) = {"
yJ
PH
IF
ly
ug
AI
AI
AI
pC
Iy
RJ
GS
sR
ZZ
QT
Rk
vq
fi
Pc
"}
(7,1,1) = {"
yJ
ol
HZ
qN
Fc
mb
Gh
Hw
Iq
Ot
DR
Ss
Oc
Xe
nY
ZQ
dG
Id
PV
"}
(8,1,1) = {"
yJ
yJ
NQ
fE
ug
DQ
Vc
Yd
NC
HW
RX
eh
ma
KH
KH
Ie
KH
KH
KH
"}
(9,1,1) = {"
nq
SP
ug
ug
ug
RC
xG
ug
PY
Qs
ug
Wb
rg
KH
sy
gt
Ns
gB
Lb
"}
(10,1,1) = {"
nq
nq
nq
nq
SP
Dq
yJ
ug
te
ZN
ug
ug
ug
KH
yj
mV
lV
Nm
iK
"}
(11,1,1) = {"
nq
nq
nq
nq
nq
nq
nq
ug
ox
Qs
ug
nq
nq
EZ
KH
es
KH
KH
nq
"}
