//MAP CONVERTED BY dmm2tgm.py THIS HEADER COMMENT PREVENTS RECONVERSION, DO NOT REMOVE
"a" = (
/obj/effect/spawner/structure/window/reinforced/shuttle,
/turf/open/floor/plating,
/area/shuttle/labor)
"b" = (
/obj/effect/turf_decal/siding/dark{
	dir = 8
	},
/obj/structure/table/reinforced,
/obj/machinery/mineral/stacking_unit_console{
	pixel_y = -32
	},
/obj/item/restraints/handcuffs{
	pixel_y = 14
	},
/obj/machinery/light/small/directional/south,
/turf/open/floor/mineral/plastitanium/red,
/area/shuttle/labor)
"e" = (
/obj/effect/turf_decal/bot_white,
/obj/machinery/mineral/labor_claim_console{
	pixel_x = 30
	},
/turf/open/floor/mineral/plastitanium,
/area/shuttle/labor)
"h" = (
/obj/effect/turf_decal/stripes/line{
	dir = 9
	},
/obj/machinery/power/shuttle_engine/propulsion{
	dir = 8
	},
/turf/open/floor/plating/airless,
/area/shuttle/labor)
"k" = (
/obj/effect/turf_decal/bot_white,
/obj/structure/chair/comfy/shuttle,
/turf/open/floor/mineral/plastitanium,
/area/shuttle/labor)
"n" = (
/obj/machinery/door/airlock/titanium{
	name = "Labor Shuttle Airlock"
	},
/obj/effect/mapping_helpers/airlock/access/all/security/brig,
/turf/open/floor/iron/dark/textured_half,
/area/shuttle/labor)
"o" = (
/obj/effect/turf_decal/stripes/line{
	dir = 8
	},
/obj/machinery/power/shuttle_engine/propulsion{
	dir = 8
	},
/turf/open/floor/plating/airless,
/area/shuttle/labor)
"p" = (
/obj/structure/sign/nanotrasen,
/turf/closed/wall/mineral/titanium,
/area/shuttle/labor)
"q" = (
/turf/closed/wall/mineral/titanium,
/area/shuttle/labor)
"r" = (
/obj/machinery/mineral/stacking_machine/laborstacker{
	input_dir = 2;
	output_dir = 1
	},
/obj/structure/window/reinforced/spawner/directional/north,
/obj/machinery/light/small/directional/south,
/obj/machinery/mineral/labor_claim_console{
	pixel_y = -32
	},
/turf/open/floor/pod/light,
/area/shuttle/labor)
"s" = (
/obj/effect/turf_decal/siding/dark{
	dir = 10
	},
/obj/machinery/button/flasher{
	id = "gulagshuttleflasher";
	name = "Flash Control";
	pixel_y = 28;
	req_access = list("security")
	},
/turf/open/floor/mineral/plastitanium/red,
/area/shuttle/labor)
"u" = (
/obj/machinery/light/small/directional/south,
/obj/machinery/atmospherics/pipe/smart/simple/orange/hidden{
	dir = 9
	},
/turf/open/floor/pod/dark,
/area/shuttle/labor)
"v" = (
/obj/effect/turf_decal/siding/dark{
	dir = 8
	},
/obj/structure/table/reinforced,
/obj/machinery/recharger{
	pixel_y = 4
	},
/turf/open/floor/mineral/plastitanium/red,
/area/shuttle/labor)
"x" = (
/obj/machinery/door/airlock/external{
	name = "Mining Shuttle External Airlock"
	},
/obj/docking_port/mobile{
	id_tag = "laborcamp";
	name = "labor camp shuttle";
	port_direction = 4
	},
/turf/open/floor/iron/dark/textured_half,
/area/shuttle/labor)
"z" = (
/obj/effect/turf_decal/bot_white,
/turf/open/floor/mineral/plastitanium,
/area/shuttle/labor)
"A" = (
/obj/effect/turf_decal/siding/thinplating_new/dark{
	dir = 8
	},
/obj/effect/turf_decal/siding/thinplating_new/dark/corner,
/obj/effect/turf_decal/siding/thinplating_new/dark/corner{
	dir = 4
	},
/turf/open/floor/pod/light,
/area/shuttle/labor)
"B" = (
/obj/machinery/atmospherics/pipe/smart/simple/orange/hidden{
	dir = 1
	},
/turf/open/floor/pod/dark,
/area/shuttle/labor)
"C" = (
/obj/effect/turf_decal/stripes/line{
	dir = 10
	},
/obj/machinery/power/shuttle_engine/propulsion{
	dir = 8
	},
/turf/open/floor/plating/airless,
/area/shuttle/labor)
"E" = (
/turf/closed/wall/mineral/plastitanium,
/area/shuttle/labor)
"G" = (
/obj/effect/turf_decal/siding/thinplating_new/dark,
/obj/effect/turf_decal/siding/thinplating_new/dark{
	dir = 1
	},
/obj/machinery/door/airlock/titanium{
	name = "Labor Shuttle Airlock"
	},
/obj/effect/mapping_helpers/airlock/access/all/security/brig,
/turf/open/floor/pod/light,
/area/shuttle/labor)
"L" = (
/obj/effect/turf_decal/siding/thinplating_new/dark,
/obj/effect/turf_decal/siding/thinplating_new/dark{
	dir = 1
	},
/turf/open/floor/pod/light,
/area/shuttle/labor)
"M" = (
/obj/item/clothing/suit/hazardvest{
	desc = "A high-visibility lifejacket complete with whistle and slot for oxygen tanks.";
	name = "emergency lifejacket"
	},
/obj/item/clothing/suit/hazardvest{
	desc = "A high-visibility lifejacket complete with whistle and slot for oxygen tanks.";
	name = "emergency lifejacket"
	},
/obj/item/clothing/suit/hazardvest{
	desc = "A high-visibility lifejacket complete with whistle and slot for oxygen tanks.";
	name = "emergency lifejacket"
	},
/obj/item/clothing/suit/hazardvest{
	desc = "A high-visibility lifejacket complete with whistle and slot for oxygen tanks.";
	name = "emergency lifejacket"
	},
/obj/item/clothing/suit/hazardvest{
	desc = "A high-visibility lifejacket complete with whistle and slot for oxygen tanks.";
	name = "emergency lifejacket"
	},
/obj/item/tank/internals/emergency_oxygen{
	pixel_x = 3
	},
/obj/item/tank/internals/emergency_oxygen{
	pixel_x = 3
	},
/obj/item/tank/internals/emergency_oxygen{
	pixel_x = 3
	},
/obj/item/tank/internals/emergency_oxygen{
	pixel_x = 3
	},
/obj/item/tank/internals/emergency_oxygen{
	pixel_x = 3
	},
/obj/item/clothing/mask/breath{
	pixel_x = -3;
	pixel_y = -3
	},
/obj/item/clothing/mask/breath{
	pixel_x = -3;
	pixel_y = -3
	},
/obj/item/clothing/mask/breath{
	pixel_x = -3;
	pixel_y = -3
	},
/obj/item/clothing/mask/breath{
	pixel_x = -3;
	pixel_y = -3
	},
/obj/item/clothing/mask/breath{
	pixel_x = -3;
	pixel_y = -3
	},
/obj/item/clothing/head/utility/hardhat/orange{
	name = "protective hat";
	pixel_y = 9
	},
/obj/item/clothing/head/utility/hardhat/orange{
	name = "protective hat";
	pixel_y = 9
	},
/obj/item/clothing/head/utility/hardhat/orange{
	name = "protective hat";
	pixel_y = 9
	},
/obj/item/clothing/head/utility/hardhat/orange{
	name = "protective hat";
	pixel_y = 9
	},
/obj/item/clothing/head/utility/hardhat/orange{
	name = "protective hat";
	pixel_y = 9
	},
/obj/structure/closet/crate/internals,
/obj/effect/decal/cleanable/dirt,
/obj/effect/turf_decal/delivery,
/obj/structure/window/reinforced/spawner/directional/east,
/obj/machinery/light/small/directional/north,
/turf/open/floor/mineral/plastitanium,
/area/shuttle/labor)
"O" = (
/obj/effect/spawner/structure/window/reinforced/plasma/plastitanium,
/turf/open/floor/plating,
/area/shuttle/labor)
"Q" = (
/obj/effect/turf_decal/siding/thinplating_new/dark{
	dir = 4
	},
/obj/effect/turf_decal/siding/thinplating_new/dark{
	dir = 8
	},
/turf/open/floor/pod/light,
/area/shuttle/labor)
"R" = (
/obj/effect/turf_decal/siding/dark,
/obj/structure/chair/office{
	dir = 4
	},
/turf/open/floor/mineral/plastitanium/red,
/area/shuttle/labor)
"S" = (
/obj/structure/window/reinforced/survival_pod/spawner/directional/west,
/obj/machinery/atmospherics/pipe/smart/manifold4w/general/visible,
/turf/open/floor/plating,
/area/shuttle/labor)
"T" = (
/obj/machinery/light/small/directional/north,
/obj/machinery/atmospherics/pipe/smart/simple/orange/hidden{
	dir = 10
	},
/turf/open/floor/pod/dark,
/area/shuttle/labor)
"U" = (
/obj/effect/turf_decal/siding/dark/corner{
	dir = 8
	},
/obj/machinery/light/small/directional/north,
/obj/machinery/computer/shuttle/labor{
	dir = 8
	},
/obj/structure/reagent_dispensers/wall/peppertank/directional/north,
/turf/open/floor/mineral/plastitanium/red,
/area/shuttle/labor)
"V" = (
/turf/open/floor/pod/dark,
/area/shuttle/labor)
"Y" = (
/obj/effect/turf_decal/bot_white,
/obj/structure/closet/crate,
/obj/machinery/flasher/directional/south{
	id = "gulagshuttleflasher"
	},
/turf/open/floor/mineral/plastitanium,
/area/shuttle/labor)

(1,1,1) = {"
h
o
E
o
C
"}
(2,1,1) = {"
E
S
O
S
E
"}
(3,1,1) = {"
E
T
B
u
E
"}
(4,1,1) = {"
q
Q
A
Q
x
"}
(5,1,1) = {"
q
k
L
Y
q
"}
(6,1,1) = {"
a
z
L
e
a
"}
(7,1,1) = {"
q
M
G
r
q
"}
(8,1,1) = {"
q
s
V
V
n
"}
(9,1,1) = {"
p
R
V
V
p
"}
(10,1,1) = {"
q
U
v
b
q
"}
(11,1,1) = {"
q
a
a
a
q
"}
