//MAP CONVERTED BY dmm2tgm.py THIS HEADER COMMENT PREVENTS RECONVERSION, DO NOT REMOVE
"ak" = (
/obj/structure/toilet{
	dir = 0;
	step_y = 12
	},
/turf/open/floor/iron,
/area/shuttle/abandoned)
"am" = (
/obj/structure/sink/directional/west,
/turf/open/floor/iron,
/area/shuttle/abandoned)
"aO" = (
/obj/machinery/computer/shuttle/white_ship/miner{
	dir = 8
	},
/turf/open/floor/iron,
/area/shuttle/abandoned)
"aP" = (
/obj/machinery/smartfridge,
/turf/open/floor/iron,
/area/shuttle/abandoned)
"by" = (
/obj/structure/sign/departments/science/alt/directional/south,
/turf/open/floor/iron,
/area/shuttle/abandoned)
"bF" = (
/obj/machinery/oven/range_frontier,
/turf/open/floor/iron,
/area/shuttle/abandoned)
"ci" = (
/obj/machinery/rnd/production/circuit_imprinter,
/turf/open/floor/iron,
/area/shuttle/abandoned)
"cO" = (
/obj/structure/table/reinforced,
/obj/item/storage/toolbox/mechanical,
/obj/item/storage/toolbox/mechanical{
	step_y = 5;
	step_x = -2
	},
/obj/item/multitool,
/obj/machinery/airalarm/directional/west,
/obj/effect/mapping_helpers/airalarm/all_access,
/turf/open/floor/iron,
/area/shuttle/abandoned)
"dn" = (
/turf/open/floor/plating,
/area/shuttle/abandoned)
"es" = (
/obj/machinery/hydroponics/constructable,
/obj/machinery/light/directional/west,
/turf/open/floor/iron,
/area/shuttle/abandoned)
"eP" = (
/obj/structure/fluff/metalpole/anchor{
	dir = 1
	},
/turf/open/space,
/area/shuttle/abandoned)
"eZ" = (
/obj/machinery/computer/operating/oldstation,
/obj/machinery/light/directional/north,
/turf/open/floor/iron,
/area/shuttle/abandoned)
"fj" = (
/obj/effect/turf_decal/shuttle{
	dir = 1
	},
/turf/open/floor/plating,
/area/shuttle/abandoned)
"fA" = (
/obj/effect/turf_decal/box/blue,
/obj/machinery/portable_atmospherics/canister/air,
/turf/open/floor/plating,
/area/shuttle/abandoned)
"ht" = (
/obj/machinery/door/airlock/shuttle,
/turf/open/floor/plating,
/area/shuttle/abandoned)
"hx" = (
/turf/open/floor/iron,
/area/shuttle/abandoned)
"ia" = (
/obj/machinery/atmospherics/components/tank/oxygen,
/turf/open/floor/plating,
/area/shuttle/abandoned)
"iO" = (
/obj/machinery/rnd/production/protolathe/offstation,
/turf/open/floor/iron,
/area/shuttle/abandoned)
"jI" = (
/obj/machinery/light/small/directional/east,
/turf/open/floor/plating,
/area/shuttle/abandoned)
"jK" = (
/turf/open/floor/iron/recharge_floor,
/area/shuttle/abandoned)
"km" = (
/obj/structure/fluff/metalpole,
/turf/open/space,
/area/shuttle/abandoned)
"kv" = (
/obj/machinery/door/airlock/external/glass,
/turf/open/floor/iron,
/area/shuttle/abandoned)
"lu" = (
/obj/machinery/door/airlock/shuttle,
/turf/open/floor/iron,
/area/shuttle/abandoned)
"lQ" = (
/obj/structure/sink/directional/west,
/obj/machinery/light/small/directional/north,
/turf/open/floor/iron,
/area/shuttle/abandoned)
"lU" = (
/obj/machinery/light/directional/south,
/turf/open/floor/iron,
/area/shuttle/abandoned)
"ms" = (
/obj/machinery/seed_extractor,
/turf/open/floor/iron,
/area/shuttle/abandoned)
"mw" = (
/turf/template_noop,
/area/space)
"mI" = (
/turf/open/floor/carpet/royalblue,
/area/shuttle/abandoned)
"mM" = (
/obj/machinery/light/directional/north,
/turf/open/floor/iron,
/area/shuttle/abandoned)
"nb" = (
/obj/machinery/suit_storage_unit/mining/eva,
/turf/open/floor/iron,
/area/shuttle/abandoned)
"ne" = (
/obj/machinery/computer/rdconsole,
/turf/open/floor/iron,
/area/shuttle/abandoned)
"oM" = (
/obj/structure/tank_dispenser/oxygen,
/turf/open/floor/plating,
/area/shuttle/abandoned)
"oO" = (
/obj/machinery/door/airlock/shuttle,
/obj/effect/mapping_helpers/airlock/access/any/independent_miner/cap,
/turf/open/floor/iron,
/area/shuttle/abandoned)
"qk" = (
/obj/structure/table,
/obj/machinery/griddle/frontier_tabletop,
/turf/open/floor/iron,
/area/shuttle/abandoned)
"rk" = (
/obj/effect/mapping_helpers/airalarm/all_access,
/obj/machinery/airalarm/directional/north,
/turf/open/floor/iron,
/area/shuttle/abandoned)
"sC" = (
/obj/machinery/door/airlock/shuttle/glass,
/turf/open/floor/iron,
/area/shuttle/abandoned)
"tp" = (
/obj/machinery/light/directional/east,
/obj/machinery/vending/hydroseeds,
/turf/open/floor/iron,
/area/shuttle/abandoned)
"tx" = (
/obj/machinery/power/shuttle_engine/heater{
	dir = 8
	},
/obj/structure/window/reinforced/spawner/directional/east,
/turf/open/floor/plating,
/area/shuttle/abandoned)
"uh" = (
/obj/machinery/door/airlock/external/glass,
/turf/open/floor/plating,
/area/shuttle/abandoned)
"uE" = (
/obj/machinery/computer/camera_advanced/shuttle_docker/whiteship/miner{
	dir = 8
	},
/turf/open/floor/iron,
/area/shuttle/abandoned)
"uR" = (
/obj/structure/lattice,
/obj/structure/marker_beacon/burgundy,
/turf/open/space,
/area/shuttle/abandoned)
"vT" = (
/obj/machinery/computer/mech_bay_power_console{
	dir = 1
	},
/turf/open/floor/iron,
/area/shuttle/abandoned)
"wU" = (
/obj/structure/fluff/metalpole{
	dir = 1
	},
/turf/open/space,
/area/shuttle/abandoned)
"xN" = (
/obj/structure/rack/shelf,
/turf/open/floor/plating,
/area/shuttle/abandoned)
"xQ" = (
/obj/effect/spawner/structure/window/hollow/end{
	dir = 8
	},
/turf/open/floor/plating,
/area/shuttle/abandoned)
"yg" = (
/obj/machinery/light/small/directional/east,
/turf/open/floor/iron,
/area/shuttle/abandoned)
"yp" = (
/obj/machinery/power/shuttle_engine/propulsion{
	dir = 8
	},
/turf/open/floor/plating,
/area/shuttle/abandoned)
"yW" = (
/obj/effect/spawner/structure/window/reinforced/shuttle,
/turf/open/floor/plating,
/area/shuttle/abandoned)
"zu" = (
/obj/effect/turf_decal/shuttle,
/turf/open/floor/plating,
/area/shuttle/abandoned)
"zw" = (
/obj/structure/bed,
/obj/effect/spawner/random/bedsheet/any,
/obj/effect/mob_spawn/ghost_role/human/independent_miner{
	dir = 8
	},
/turf/open/floor/carpet/royalblue,
/area/shuttle/abandoned)
"AB" = (
/obj/structure/table,
/obj/machinery/processor,
/turf/open/floor/iron,
/area/shuttle/abandoned)
"AX" = (
/obj/structure/table,
/obj/item/reagent_containers/cup/glass/shaker,
/turf/open/floor/iron,
/area/shuttle/abandoned)
"Bh" = (
/obj/item/circuitboard/machine/ore_redemption/offstation,
/turf/open/floor/iron,
/area/shuttle/abandoned)
"BY" = (
/obj/structure/table/wood,
/obj/item/storage/dice,
/turf/open/floor/carpet/royalblue,
/area/shuttle/abandoned)
"Cn" = (
/obj/structure/table,
/obj/item/reagent_containers/condiment/saltshaker{
	step_x = -4
	},
/obj/item/reagent_containers/condiment/peppermill{
	step_x = 4
	},
/turf/open/floor/iron,
/area/shuttle/abandoned)
"CA" = (
/obj/structure/reagent_dispensers/fueltank,
/turf/open/floor/plating,
/area/shuttle/abandoned)
"De" = (
/obj/structure/dresser,
/turf/open/floor/carpet/royalblue,
/area/shuttle/abandoned)
"Dg" = (
/obj/effect/spawner/structure/window/hollow/middle,
/turf/open/floor/plating,
/area/shuttle/abandoned)
"Dt" = (
/obj/machinery/vending/hydronutrients,
/turf/open/floor/iron,
/area/shuttle/abandoned)
"Dy" = (
/obj/structure/chair/stool/directional/north,
/turf/open/floor/iron,
/area/shuttle/abandoned)
"DG" = (
/obj/item/flatpacked_machine/ore_silo,
/obj/item/flatpacked_machine,
/obj/structure/closet/crate,
/turf/open/floor/iron,
/area/shuttle/abandoned)
"DI" = (
/obj/structure/marker_beacon/cerulean,
/turf/closed/wall/mineral/titanium/nodiagonal,
/area/shuttle/abandoned)
"Eh" = (
/obj/effect/mapping_helpers/airalarm/all_access,
/obj/machinery/airalarm/directional/south,
/turf/open/floor/iron,
/area/shuttle/abandoned)
"Eq" = (
/obj/structure/table,
/obj/item/radio,
/obj/item/radio,
/turf/open/floor/iron,
/area/shuttle/abandoned)
"FO" = (
/obj/structure/fans/tiny,
/obj/machinery/door/airlock/external/glass,
/obj/docking_port/mobile{
	port_direction = 8;
	dir = 2;
	dwidth = 1;
	name = "Independent miner ship"
	},
/turf/open/floor/plating,
/area/shuttle/abandoned)
"FY" = (
/obj/structure/frame/machine/secured,
/turf/open/floor/iron,
/area/shuttle/abandoned)
"Gb" = (
/obj/structure/marker_beacon/burgundy,
/turf/closed/wall/mineral/titanium/nodiagonal,
/area/shuttle/abandoned)
"Gc" = (
/obj/effect/spawner/structure/window/reinforced/shuttle,
/turf/closed/wall/mineral/titanium,
/area/shuttle/abandoned)
"Gm" = (
/turf/closed/wall/mineral/titanium,
/area/shuttle/abandoned)
"GD" = (
/obj/machinery/door/airlock/external/glass,
/obj/structure/fans/tiny,
/turf/open/floor/plating,
/area/shuttle/abandoned)
"Hl" = (
/obj/structure/table,
/obj/item/pickaxe,
/obj/item/pickaxe,
/obj/item/storage/bag/ore,
/obj/item/storage/bag/ore,
/turf/open/floor/iron,
/area/shuttle/abandoned)
"Kc" = (
/obj/machinery/mecha_part_fabricator,
/turf/open/floor/iron,
/area/shuttle/abandoned)
"Kk" = (
/obj/machinery/hydroponics/constructable,
/turf/open/floor/iron,
/area/shuttle/abandoned)
"Kv" = (
/obj/structure/table/reinforced,
/obj/machinery/cell_charger,
/obj/machinery/light/directional/west,
/turf/open/floor/iron,
/area/shuttle/abandoned)
"KY" = (
/obj/machinery/computer/order_console/mining/golem,
/turf/open/floor/iron,
/area/shuttle/abandoned)
"Lk" = (
/obj/structure/sign/departments/cargo/directional/west,
/obj/machinery/light/directional/west,
/turf/open/floor/iron,
/area/shuttle/abandoned)
"Mb" = (
/obj/machinery/light/small/directional/north,
/turf/open/floor/plating,
/area/shuttle/abandoned)
"Nv" = (
/turf/closed/wall/mineral/plastitanium,
/area/shuttle/abandoned)
"NL" = (
/obj/machinery/mech_bay_recharge_port,
/turf/open/floor/iron,
/area/shuttle/abandoned)
"OB" = (
/obj/structure/chair/stool/directional/north,
/obj/structure/chair/stool/directional/north,
/turf/open/floor/iron,
/area/shuttle/abandoned)
"OT" = (
/obj/structure/table,
/obj/structure/table,
/obj/item/mining_scanner,
/obj/item/mining_scanner,
/turf/open/floor/iron,
/area/shuttle/abandoned)
"Pf" = (
/obj/item/defibrillator/loaded,
/obj/machinery/light/directional/north,
/obj/structure/table,
/turf/open/floor/iron,
/area/shuttle/abandoned)
"PC" = (
/obj/structure/fluff/metalpole/end/right,
/turf/open/space,
/area/shuttle/abandoned)
"PU" = (
/obj/structure/rack,
/obj/item/storage/toolbox/mechanical{
	step_y = -4
	},
/obj/item/storage/toolbox/electrical,
/obj/item/clothing/mask/gas/welding,
/turf/open/floor/plating,
/area/shuttle/abandoned)
"Qf" = (
/obj/structure/lattice,
/turf/open/space,
/area/shuttle/abandoned)
"QY" = (
/obj/structure/table,
/obj/item/stack/sheet/iron/twenty,
/obj/item/stack/sheet/glass/fifty,
/obj/item/stack/cable_coil/thirty,
/turf/open/floor/iron,
/area/shuttle/abandoned)
"Rz" = (
/obj/structure/fluff/metalpole/end/right{
	dir = 1
	},
/turf/open/space,
/area/shuttle/abandoned)
"Sr" = (
/obj/machinery/biogenerator,
/turf/open/floor/iron,
/area/shuttle/abandoned)
"UF" = (
/obj/structure/table,
/turf/open/floor/iron,
/area/shuttle/abandoned)
"WY" = (
/turf/closed/wall/mineral/titanium/nodiagonal,
/area/shuttle/abandoned)
"Xk" = (
/obj/structure/table,
/obj/machinery/microwave/frontier_printed,
/turf/open/floor/iron,
/area/shuttle/abandoned)
"Xq" = (
/obj/machinery/computer/crew{
	dir = 8
	},
/turf/open/floor/iron,
/area/shuttle/abandoned)
"XT" = (
/obj/effect/turf_decal/loading_area,
/turf/open/floor/plating,
/area/shuttle/abandoned)
"Yr" = (
/obj/effect/spawner/structure/window/hollow/end{
	dir = 4
	},
/turf/open/floor/plating,
/area/shuttle/abandoned)
"Yy" = (
/obj/effect/mob_spawn/ghost_role/human/independent_miner/captain,
/turf/open/floor/iron,
/area/shuttle/abandoned)
"Za" = (
/obj/structure/table/optable,
/turf/open/floor/iron,
/area/shuttle/abandoned)
"Ze" = (
/obj/machinery/shower/directional/east,
/obj/structure/fluff/shower_drain,
/turf/open/floor/iron,
/area/shuttle/abandoned)

(1,1,1) = {"
mw
mw
mw
mw
mw
mw
mw
mw
mw
mw
mw
mw
mw
mw
mw
mw
"}
(2,1,1) = {"
mw
mw
mw
mw
mw
mw
Gm
GD
GD
Gm
mw
mw
mw
mw
mw
mw
"}
(3,1,1) = {"
Nv
yp
yp
yp
Nv
Qf
Gm
dn
dn
Gm
Qf
Nv
yp
yp
yp
Nv
"}
(4,1,1) = {"
WY
tx
tx
tx
WY
Qf
Gm
Mb
dn
Gm
Qf
WY
tx
tx
tx
WY
"}
(5,1,1) = {"
Gm
ak
Gm
Ze
Gm
Gm
Gm
uh
uh
Gm
Gm
Gm
ia
dn
fA
Gm
"}
(6,1,1) = {"
Gm
lQ
lu
yg
lu
hx
hx
hx
hx
hx
Gm
dn
dn
dn
CA
Gm
"}
(7,1,1) = {"
Gm
Gm
Gm
Gm
Gm
hx
hx
hx
hx
hx
Gm
dn
dn
dn
PU
yW
"}
(8,1,1) = {"
yW
BY
mI
mI
lu
hx
UF
AX
OB
hx
ht
dn
dn
jI
xN
yW
"}
(9,1,1) = {"
Gm
De
mI
mI
Gm
mM
UF
Cn
Dy
lU
WY
Gm
Gm
Gm
Gm
Gm
"}
(10,1,1) = {"
Gm
mI
mI
mI
Gm
hx
UF
UF
Dy
hx
hx
hx
hx
hx
lU
Gm
"}
(11,1,1) = {"
Gm
zw
zw
zw
Gm
hx
hx
hx
hx
hx
hx
bF
qk
Xk
hx
Gm
"}
(12,1,1) = {"
Gm
Gm
Gm
WY
Gm
hx
hx
hx
hx
hx
AB
aP
WY
Gm
Gm
Gm
"}
(13,1,1) = {"
Gm
eZ
hx
hx
Gm
hx
hx
hx
hx
hx
hx
hx
es
hx
Kk
Gm
"}
(14,1,1) = {"
yW
Za
hx
hx
Gm
mM
hx
hx
hx
hx
hx
hx
Kk
hx
Kk
yW
"}
(15,1,1) = {"
yW
UF
hx
hx
sC
hx
hx
hx
hx
hx
hx
hx
hx
hx
hx
Gc
"}
(16,1,1) = {"
Gm
Pf
am
hx
Gm
hx
hx
hx
hx
hx
hx
Dt
tp
ms
Sr
Gm
"}
(17,1,1) = {"
Gm
Gm
Gm
Gm
Gm
Gm
Gm
Gm
Gm
sC
Gm
Gm
WY
WY
WY
Gm
"}
(18,1,1) = {"
Gm
dn
dn
Gm
KY
nb
nb
Gm
DG
by
Gm
iO
Kv
cO
NL
Gm
"}
(19,1,1) = {"
FO
XT
dn
kv
hx
hx
hx
Lk
hx
hx
lu
hx
hx
hx
jK
yW
"}
(20,1,1) = {"
Gm
oM
jI
Gm
rk
hx
hx
hx
hx
hx
xQ
ci
hx
hx
vT
Gm
"}
(21,1,1) = {"
WY
Gm
Gm
WY
Bh
hx
hx
hx
hx
hx
Dg
ne
hx
hx
WY
Gm
"}
(22,1,1) = {"
mw
mw
yW
FY
hx
hx
Hl
Eq
OT
QY
Yr
Kc
hx
WY
Gm
mw
"}
(23,1,1) = {"
mw
mw
WY
WY
Gm
oO
Gm
Gm
Gm
Gm
Gm
Gm
uh
Gm
mw
mw
"}
(24,1,1) = {"
mw
mw
mw
Gm
Yy
hx
Eh
Gm
WY
mw
yW
fj
zu
Gm
mw
mw
"}
(25,1,1) = {"
mw
mw
mw
Gm
hx
hx
hx
Gm
wU
mw
yW
fj
zu
Gm
mw
mw
"}
(26,1,1) = {"
mw
mw
mw
Gm
mM
hx
hx
Gm
eP
mw
WY
Gm
GD
WY
mw
mw
"}
(27,1,1) = {"
mw
mw
mw
yW
Xq
aO
uE
yW
wU
mw
mw
mw
Qf
km
mw
mw
"}
(28,1,1) = {"
mw
mw
mw
DI
yW
yW
yW
Gb
wU
mw
mw
mw
uR
km
mw
mw
"}
(29,1,1) = {"
mw
mw
mw
mw
mw
mw
mw
Rz
wU
mw
mw
mw
mw
PC
mw
mw
"}
(30,1,1) = {"
mw
mw
mw
mw
mw
mw
mw
mw
wU
mw
mw
mw
mw
mw
mw
mw
"}
(31,1,1) = {"
mw
mw
mw
mw
mw
mw
mw
mw
Rz
mw
mw
mw
mw
mw
mw
mw
"}
(32,1,1) = {"
mw
mw
mw
mw
mw
mw
mw
mw
mw
mw
mw
mw
mw
mw
mw
mw
"}
