//MAP CONVERTED BY dmm2tgm.py THIS HEADER COMMENT PREVENTS RECONVERSION, DO NOT REMOVE
"a" = (
/turf/template_noop,
/area/template_noop)
"e" = (
/turf/closed/wall/mineral/titanium/survival,
/area/shuttle/mining)
"g" = (
/obj/structure/sign/nanotrasen,
/turf/closed/wall/mineral/titanium/survival,
/area/shuttle/mining)
"i" = (
/obj/effect/turf_decal/siding/thinplating_new/dark{
	dir = 5
	},
/obj/item/storage/pod{
	pixel_x = 5;
	pixel_y = 30
	},
/obj/machinery/light/small/directional/north,
/obj/structure/chair/comfy/shuttle,
/turf/open/floor/pod/dark,
/area/shuttle/mining)
"j" = (
/obj/machinery/door/airlock/survival_pod/glass,
/obj/structure/fans/tiny,
/obj/docking_port/mobile{
	id_tag = "mining";
	name = "mining shuttle";
	port_direction = 2;
	dir = 4;
	preferred_direction = 2
	},
/turf/open/floor/pod/dark,
/area/shuttle/mining)
"k" = (
/turf/closed/wall/mineral/plastitanium/nodiagonal,
/area/shuttle/mining)
"l" = (
/obj/effect/turf_decal/siding/dark{
	dir = 10
	},
/obj/machinery/atmospherics/pipe/smart/simple/orange/hidden{
	dir = 5
	},
/turf/open/floor/pod/light,
/area/shuttle/mining)
"n" = (
/obj/effect/turf_decal/stripes/line{
	dir = 4
	},
/obj/machinery/power/shuttle_engine/propulsion/burst{
	dir = 4
	},
/turf/open/floor/plating/airless,
/area/shuttle/mining)
"r" = (
/obj/effect/turf_decal/siding/thinplating_new/dark{
	dir = 1
	},
/obj/structure/chair/comfy/shuttle,
/turf/open/floor/pod/dark,
/area/shuttle/mining)
"s" = (
/obj/effect/turf_decal/bot,
/obj/structure/ore_box,
/turf/open/floor/pod/dark,
/area/shuttle/mining)
"t" = (
/obj/effect/spawner/structure/window/reinforced/plasma/plastitanium,
/turf/open/floor/plating,
/area/shuttle/mining)
"w" = (
/obj/effect/turf_decal/siding/thinplating_new/dark{
	dir = 10
	},
/obj/effect/turf_decal/siding/thinplating_new/dark/corner{
	dir = 4
	},
/obj/machinery/light/small/directional/south,
/turf/open/floor/pod/dark,
/area/shuttle/mining)
"x" = (
/obj/effect/turf_decal/siding/dark/corner{
	dir = 8
	},
/obj/machinery/atmospherics/pipe/smart/manifold/orange/hidden{
	dir = 8
	},
/turf/open/floor/pod/light,
/area/shuttle/mining)
"D" = (
/obj/effect/turf_decal/stripes/line{
	dir = 6
	},
/obj/machinery/power/shuttle_engine/propulsion/burst{
	dir = 4
	},
/turf/open/floor/plating/airless,
/area/shuttle/mining)
"E" = (
/obj/structure/extinguisher_cabinet/directional/south,
/turf/open/floor/iron/stairs{
	dir = 4
	},
/area/shuttle/mining)
"H" = (
/obj/machinery/atmospherics/pipe/smart/manifold4w/general/hidden,
/obj/machinery/power/shuttle_engine/heater{
	dir = 4
	},
/obj/structure/window/reinforced/survival_pod/spawner/directional/west,
/turf/open/floor/catwalk_floor,
/area/shuttle/mining)
"I" = (
/obj/effect/spawner/structure/window/survival_pod,
/turf/open/floor/plating,
/area/shuttle/mining)
"J" = (
/obj/effect/turf_decal/siding/thinplating_new/dark{
	dir = 4
	},
/obj/effect/turf_decal/siding/thinplating_new/dark/corner{
	dir = 8
	},
/turf/open/floor/pod/dark,
/area/shuttle/mining)
"L" = (
/obj/effect/turf_decal/siding/dark{
	dir = 1
	},
/obj/machinery/atmospherics/pipe/smart/simple/orange/hidden{
	dir = 6
	},
/obj/structure/chair/comfy/shuttle{
	dir = 8
	},
/turf/open/floor/pod/light,
/area/shuttle/mining)
"N" = (
/obj/effect/turf_decal/stripes/line{
	dir = 5
	},
/obj/machinery/power/shuttle_engine/propulsion/burst{
	dir = 4
	},
/turf/open/floor/plating/airless,
/area/shuttle/mining)
"P" = (
/obj/effect/turf_decal/siding/thinplating_new/dark,
/turf/open/floor/pod/dark,
/area/shuttle/mining)
"Q" = (
/obj/effect/turf_decal/siding/thinplating_new/dark{
	dir = 10
	},
/turf/open/floor/pod/dark,
/area/shuttle/mining)
"S" = (
/obj/effect/turf_decal/siding/dark{
	dir = 9
	},
/obj/structure/railing{
	dir = 8
	},
/obj/item/radio/intercom/directional/north,
/obj/machinery/computer/shuttle/mining{
	dir = 4
	},
/turf/open/floor/pod/light,
/area/shuttle/mining)
"T" = (
/obj/item/clothing/suit/hazardvest{
	desc = "A high-visibility lifejacket complete with whistle and slot for oxygen tanks.";
	name = "emergency lifejacket"
	},
/obj/item/clothing/suit/hazardvest{
	desc = "A high-visibility lifejacket complete with whistle and slot for oxygen tanks.";
	name = "emergency lifejacket"
	},
/obj/item/clothing/suit/hazardvest{
	desc = "A high-visibility lifejacket complete with whistle and slot for oxygen tanks.";
	name = "emergency lifejacket"
	},
/obj/item/clothing/suit/hazardvest{
	desc = "A high-visibility lifejacket complete with whistle and slot for oxygen tanks.";
	name = "emergency lifejacket"
	},
/obj/item/clothing/suit/hazardvest{
	desc = "A high-visibility lifejacket complete with whistle and slot for oxygen tanks.";
	name = "emergency lifejacket"
	},
/obj/item/tank/internals/emergency_oxygen{
	pixel_x = 3
	},
/obj/item/tank/internals/emergency_oxygen{
	pixel_x = 3
	},
/obj/item/tank/internals/emergency_oxygen{
	pixel_x = 3
	},
/obj/item/tank/internals/emergency_oxygen{
	pixel_x = 3
	},
/obj/item/tank/internals/emergency_oxygen{
	pixel_x = 3
	},
/obj/item/clothing/mask/breath{
	pixel_x = -3;
	pixel_y = -3
	},
/obj/item/clothing/mask/breath{
	pixel_x = -3;
	pixel_y = -3
	},
/obj/item/clothing/mask/breath{
	pixel_x = -3;
	pixel_y = -3
	},
/obj/item/clothing/mask/breath{
	pixel_x = -3;
	pixel_y = -3
	},
/obj/item/clothing/mask/breath{
	pixel_x = -3;
	pixel_y = -3
	},
/obj/item/clothing/head/utility/hardhat/orange{
	name = "protective hat";
	pixel_y = 9
	},
/obj/item/clothing/head/utility/hardhat/orange{
	name = "protective hat";
	pixel_y = 9
	},
/obj/item/clothing/head/utility/hardhat/orange{
	name = "protective hat";
	pixel_y = 9
	},
/obj/item/clothing/head/utility/hardhat/orange{
	name = "protective hat";
	pixel_y = 9
	},
/obj/item/clothing/head/utility/hardhat/orange{
	name = "protective hat";
	pixel_y = 9
	},
/obj/structure/closet/crate/internals,
/obj/item/pickaxe/emergency,
/obj/item/pickaxe/emergency,
/obj/effect/turf_decal/bot,
/obj/item/storage/toolbox/emergency,
/turf/open/floor/pod/dark,
/area/shuttle/mining)
"U" = (
/obj/effect/turf_decal/siding/dark{
	dir = 10
	},
/obj/structure/railing{
	dir = 10
	},
/obj/structure/table/reinforced,
/obj/item/toy/figure/miner{
	pixel_x = -3
	},
/turf/open/floor/pod/light,
/area/shuttle/mining)
"Y" = (
/obj/effect/turf_decal/siding/thinplating_new/dark{
	dir = 9
	},
/obj/structure/chair/comfy/shuttle,
/turf/open/floor/pod/dark,
/area/shuttle/mining)

(1,1,1) = {"
e
I
j
I
e
"}
(2,1,1) = {"
e
Y
Q
s
e
"}
(3,1,1) = {"
I
r
P
T
I
"}
(4,1,1) = {"
e
i
J
w
g
"}
(5,1,1) = {"
e
S
U
E
e
"}
(6,1,1) = {"
t
L
x
l
t
"}
(7,1,1) = {"
k
H
H
H
k
"}
(8,1,1) = {"
a
N
n
D
a
"}
